area_id	subtotal_type	RSReg	RSCst	RSRej	RSOvr	RSUnd	RSTot	11:YES	12:NO
ALLPCTS	TO	503899	265563	0	54	25792	239717	130735	108982
ALLPCTS	ED	101847	72177	0	13	7195	64969	38151	26818
ALLPCTS	MV	402052	193386	0	41	18597	174748	92584	82164
PCT1101	MV	447	211	0	0	23	188	114	74
PCT1101	ED	115	60	0	0	8	52	35	17
PCT1101	TO	562	271	0	0	31	240	149	91
PCT1102	MV	771	364	0	0	26	338	162	176
PCT1102	ED	233	158	0	0	12	146	86	60
PCT1102	TO	1004	522	0	0	38	484	248	236
PCT1103	MV	748	360	0	0	20	340	190	150
PCT1103	ED	223	142	0	0	11	131	75	56
PCT1103	TO	971	502	0	0	31	471	265	206
PCT1104	MV	750	340	0	0	32	308	190	118
PCT1104	ED	268	119	0	0	6	113	74	39
PCT1104	TO	1018	459	0	0	38	421	264	157
PCT1106	MV	597	246	0	0	21	225	121	104
PCT1106	ED	174	96	0	0	7	89	46	43
PCT1106	TO	771	342	0	0	28	314	167	147
PCT1107	MV	606	281	0	0	20	261	133	128
PCT1107	ED	145	76	0	0	9	67	35	32
PCT1107	TO	751	357	0	0	29	328	168	160
PCT1108	MV	721	350	0	0	28	322	182	140
PCT1108	ED	202	114	0	0	15	99	63	36
PCT1108	TO	923	464	0	0	43	421	245	176
PCT1109	MV	650	278	0	0	21	257	135	122
PCT1109	ED	172	97	0	0	8	89	54	35
PCT1109	TO	822	375	0	0	29	346	189	157
PCT1111	MV	845	346	0	0	32	314	177	137
PCT1111	ED	201	118	0	0	10	108	72	36
PCT1111	TO	1046	464	0	0	42	422	249	173
PCT1112	MV	642	271	0	0	18	253	148	105
PCT1112	ED	160	76	0	0	5	71	50	21
PCT1112	TO	802	347	0	0	23	324	198	126
PCT1113	MV	674	280	0	0	25	255	139	116
PCT1113	ED	121	65	0	0	8	57	38	19
PCT1113	TO	795	345	0	0	33	312	177	135
PCT1114	MV	768	324	0	0	28	296	181	115
PCT1114	ED	223	97	0	0	14	83	56	27
PCT1114	TO	991	421	0	0	42	379	237	142
PCT1115	MV	741	287	0	0	24	263	150	113
PCT1115	ED	195	85	0	0	7	78	51	27
PCT1115	TO	936	372	0	0	31	341	201	140
PCT1116	MV	709	305	0	0	30	275	175	100
PCT1116	ED	222	118	0	0	10	108	76	32
PCT1116	TO	931	423	0	0	40	383	251	132
PCT1117	MV	659	250	0	0	22	228	138	90
PCT1117	ED	187	71	0	0	4	67	52	15
PCT1117	TO	846	321	0	0	26	295	190	105
PCT1118	MV	843	353	0	0	18	335	193	142
PCT1118	ED	222	100	0	0	14	86	51	35
PCT1118	TO	1065	453	0	0	32	421	244	177
PCT1119	MV	659	302	0	0	19	283	166	117
PCT1119	ED	138	73	0	0	6	67	49	18
PCT1119	TO	797	375	0	0	25	350	215	135
PCT1121	MV	556	261	0	0	30	231	131	100
PCT1121	ED	149	81	0	0	8	73	44	29
PCT1121	TO	705	342	0	0	38	304	175	129
PCT1122	MV	519	243	0	0	24	219	111	108
PCT1122	ED	118	70	0	0	8	62	35	27
PCT1122	TO	637	313	0	0	32	281	146	135
PCT1123	MV	722	254	0	0	20	234	136	98
PCT1123	ED	216	89	0	0	5	84	67	17
PCT1123	TO	938	343	0	0	25	318	203	115
PCT1124	MV	621	240	0	0	9	231	141	90
PCT1124	ED	208	72	0	0	4	68	50	18
PCT1124	TO	829	312	0	0	13	299	191	108
PCT1125	MV	916	353	0	1	44	308	184	124
PCT1125	ED	181	65	0	0	10	55	40	15
PCT1125	TO	1097	418	0	1	54	363	224	139
PCT1126	MV	811	304	0	0	26	278	162	116
PCT1126	ED	201	68	0	0	5	63	40	23
PCT1126	TO	1012	372	0	0	31	341	202	139
PCT1127	MV	742	290	0	0	19	271	133	138
PCT1127	ED	223	99	0	0	8	91	53	38
PCT1127	TO	965	389	0	0	27	362	186	176
PCT1128	MV	733	292	0	0	30	262	146	116
PCT1128	ED	146	59	0	0	7	52	37	15
PCT1128	TO	879	351	0	0	37	314	183	131
PCT1129	MV	788	310	0	1	27	282	172	110
PCT1129	ED	248	108	0	0	15	93	63	30
PCT1129	TO	1036	418	0	1	42	375	235	140
PCT1131	MV	693	276	0	1	34	241	111	130
PCT1131	ED	167	60	0	0	8	52	29	23
PCT1131	TO	860	336	0	1	42	293	140	153
PCT1132	MV	837	368	0	0	32	336	178	158
PCT1132	ED	195	59	0	0	3	56	26	30
PCT1132	TO	1032	427	0	0	35	392	204	188
PCT1133	MV	716	332	0	0	20	312	152	160
PCT1133	ED	159	74	0	0	5	69	36	33
PCT1133	TO	875	406	0	0	25	381	188	193
PCT1134	MV	584	285	0	0	20	265	125	140
PCT1134	ED	183	80	0	0	8	72	51	21
PCT1134	TO	767	365	0	0	28	337	176	161
PCT1135	MV	464	216	0	0	15	201	103	98
PCT1135	ED	92	50	0	0	4	46	24	22
PCT1135	TO	556	266	0	0	19	247	127	120
PCT1136	MV	710	335	0	0	18	317	182	135
PCT1136	ED	157	77	0	0	5	72	44	28
PCT1136	TO	867	412	0	0	23	389	226	163
PCT1141	MV	836	387	0	0	29	358	196	162
PCT1141	ED	220	123	0	0	7	116	72	44
PCT1141	TO	1056	510	0	0	36	474	268	206
PCT1142	MV	721	322	0	0	39	283	175	108
PCT1142	ED	175	87	0	0	5	82	59	23
PCT1142	TO	896	409	0	0	44	365	234	131
PCT1143	MV	823	358	0	0	39	319	201	118
PCT1143	ED	226	113	0	0	11	102	71	31
PCT1143	TO	1049	471	0	0	50	421	272	149
PCT1144	MV	727	319	0	0	23	296	169	127
PCT1144	ED	220	121	0	0	12	109	60	49
PCT1144	TO	947	440	0	0	35	405	229	176
PCT1145	MV	752	411	0	0	34	377	207	170
PCT1145	ED	153	114	0	1	10	103	73	30
PCT1145	TO	905	525	0	1	44	480	280	200
PCT1146	MV	837	359	0	0	25	334	204	130
PCT1146	ED	217	109	0	0	9	100	68	32
PCT1146	TO	1054	468	0	0	34	434	272	162
PCT1147	MV	671	303	0	0	19	284	171	113
PCT1147	ED	214	107	0	0	13	94	61	33
PCT1147	TO	885	410	0	0	32	378	232	146
PCT1148	MV	804	364	0	0	32	332	187	145
PCT1148	ED	224	116	0	0	11	105	66	39
PCT1148	TO	1028	480	0	0	43	437	253	184
PCT1149	MV	709	316	0	0	36	280	142	138
PCT1149	ED	230	118	0	0	10	108	74	34
PCT1149	TO	939	434	0	0	46	388	216	172
PCT1151	MV	0	0	0	0	0	0	0	0
PCT1151	ED	0	0	0	0	0	0	0	0
PCT1151	TO	0	0	0	0	0	0	0	0
PCT1152	MV	710	308	0	0	31	277	168	109
PCT1152	ED	180	85	0	0	8	77	46	31
PCT1152	TO	890	393	0	0	39	354	214	140
PCT1153	MV	730	283	0	0	36	247	151	96
PCT1153	ED	210	116	0	0	11	105	53	52
PCT1153	TO	940	399	0	0	47	352	204	148
PCT1154	MV	0	0	0	0	0	0	0	0
PCT1154	ED	0	0	0	0	0	0	0	0
PCT1154	TO	0	0	0	0	0	0	0	0
PCT7001	MV	632	322	0	0	25	297	150	147
PCT7001	ED	141	101	0	0	7	94	56	38
PCT7001	TO	773	423	0	0	32	391	206	185
PCT7002	MV	598	259	0	0	30	229	125	104
PCT7002	ED	116	88	0	0	6	82	50	32
PCT7002	TO	714	347	0	0	36	311	175	136
PCT7003	MV	759	427	0	0	44	383	205	178
PCT7003	ED	147	144	0	0	15	129	75	54
PCT7003	TO	906	571	0	0	59	512	280	232
PCT7004	MV	764	411	0	1	34	376	186	190
PCT7004	ED	149	142	0	0	16	126	68	58
PCT7004	TO	913	553	0	1	50	502	254	248
PCT7005	MV	697	342	0	0	30	312	164	148
PCT7005	ED	162	162	0	0	23	139	87	52
PCT7005	TO	859	504	0	0	53	451	251	200
PCT7006	MV	728	349	0	0	39	310	189	121
PCT7006	ED	204	149	0	0	10	139	101	38
PCT7006	TO	932	498	0	0	49	449	290	159
PCT7007	MV	777	427	0	0	38	389	199	190
PCT7007	ED	180	168	0	0	18	150	91	59
PCT7007	TO	957	595	0	0	56	539	290	249
PCT7008	MV	732	362	0	0	39	323	167	156
PCT7008	ED	177	189	0	0	17	172	103	69
PCT7008	TO	909	551	0	0	56	495	270	225
PCT7009	MV	752	387	0	0	29	358	200	158
PCT7009	ED	119	91	0	0	6	85	47	38
PCT7009	TO	871	478	0	0	35	443	247	196
PCT7011	MV	703	228	0	0	20	208	101	107
PCT7011	ED	270	87	0	0	4	83	49	34
PCT7011	TO	973	315	0	0	24	291	150	141
PCT7012	MV	999	479	0	0	48	431	246	185
PCT7012	ED	227	203	0	0	19	184	101	83
PCT7012	TO	1226	682	0	0	67	615	347	268
PCT7013	MV	984	271	0	0	26	245	138	107
PCT7013	ED	155	151	0	0	19	132	74	58
PCT7013	TO	1139	422	0	0	45	377	212	165
PCT7014	MV	609	295	0	1	31	263	123	140
PCT7014	ED	110	111	0	0	17	94	55	39
PCT7014	TO	719	406	0	1	48	357	178	179
PCT7015	MV	128	39	0	0	6	33	23	10
PCT7015	ED	-18	0	0	0	0	0	0	0
PCT7015	TO	110	39	0	0	6	33	23	10
PCT7016	MV	654	235	0	0	23	212	109	103
PCT7016	ED	278	75	0	0	7	68	42	26
PCT7016	TO	932	310	0	0	30	280	151	129
PCT7017	MV	543	182	0	0	27	155	93	62
PCT7017	ED	238	53	0	0	12	41	21	20
PCT7017	TO	781	235	0	0	39	196	114	82
PCT7018	MV	847	353	0	0	36	317	165	152
PCT7018	ED	200	56	0	0	5	51	37	14
PCT7018	TO	1047	409	0	0	41	368	202	166
PCT7019	MV	733	351	0	0	29	322	166	156
PCT7019	ED	167	73	0	0	8	65	40	25
PCT7019	TO	900	424	0	0	37	387	206	181
PCT7021	MV	679	268	0	0	31	237	149	88
PCT7021	ED	288	106	0	0	12	94	60	34
PCT7021	TO	967	374	0	0	43	331	209	122
PCT7022	MV	770	301	0	0	36	265	156	109
PCT7022	ED	193	54	0	0	3	51	38	13
PCT7022	TO	963	355	0	0	39	316	194	122
PCT7023	MV	687	328	0	0	29	299	171	128
PCT7023	ED	233	71	0	0	6	65	38	27
PCT7023	TO	920	399	0	0	35	364	209	155
PCT7024	MV	251	50	0	0	4	46	26	20
PCT7024	ED	190	20	0	0	4	16	12	4
PCT7024	TO	441	70	0	0	8	62	38	24
PCT7025	MV	316	93	0	0	7	86	47	39
PCT7025	ED	167	39	0	0	2	37	21	16
PCT7025	TO	483	132	0	0	9	123	68	55
PCT7026	MV	818	332	0	0	29	303	159	144
PCT7026	ED	192	72	0	0	7	65	39	26
PCT7026	TO	1010	404	0	0	36	368	198	170
PCT7027	MV	676	266	0	0	31	235	138	97
PCT7027	ED	220	96	0	0	10	86	47	39
PCT7027	TO	896	362	0	0	41	321	185	136
PCT7028	MV	585	215	0	0	16	199	122	77
PCT7028	ED	271	97	0	0	11	86	59	27
PCT7028	TO	856	312	0	0	27	285	181	104
PCT7029	MV	642	205	0	0	29	176	100	76
PCT7029	ED	267	39	0	0	1	38	16	22
PCT7029	TO	909	244	0	0	30	214	116	98
PCT7030	MV	654	274	0	0	19	255	127	128
PCT7030	ED	141	58	0	0	1	57	34	23
PCT7030	TO	795	332	0	0	20	312	161	151
PCT7031	MV	621	257	0	0	24	233	139	94
PCT7031	ED	73	48	0	0	8	40	20	20
PCT7031	TO	694	305	0	0	32	273	159	114
PCT7032	MV	642	264	0	0	26	238	129	109
PCT7032	ED	239	51	0	0	3	48	28	20
PCT7032	TO	881	315	0	0	29	286	157	129
PCT7033	MV	549	210	0	0	21	189	109	80
PCT7033	ED	229	86	0	0	9	77	49	28
PCT7033	TO	778	296	0	0	30	266	158	108
PCT7034	MV	620	136	0	0	22	114	72	42
PCT7034	ED	318	57	0	0	4	53	32	21
PCT7034	TO	938	193	0	0	26	167	104	63
PCT7035	MV	567	232	0	0	24	208	100	108
PCT7035	ED	152	52	0	0	7	45	27	18
PCT7035	TO	719	284	0	0	31	253	127	126
PCT7036	MV	780	259	0	0	31	228	125	103
PCT7036	ED	194	39	0	0	1	38	23	15
PCT7036	TO	974	298	0	0	32	266	148	118
PCT7037	MV	433	62	0	0	4	58	38	20
PCT7037	ED	313	38	0	0	6	32	22	10
PCT7037	TO	746	100	0	0	10	90	60	30
PCT7038	MV	758	304	0	0	27	277	143	134
PCT7038	ED	203	58	0	0	10	48	24	24
PCT7038	TO	961	362	0	0	37	325	167	158
PCT7039	MV	636	240	0	0	27	213	98	115
PCT7039	ED	201	104	0	0	4	100	65	35
PCT7039	TO	837	344	0	0	31	313	163	150
PCT7041	MV	70	29	0	0	7	22	13	9
PCT7041	ED	-4	0	0	0	0	0	0	0
PCT7041	TO	66	29	0	0	7	22	13	9
PCT7042	MV	514	219	0	0	18	201	115	86
PCT7042	ED	146	58	0	0	1	57	40	17
PCT7042	TO	660	277	0	0	19	258	155	103
PCT7043	MV	754	290	0	0	26	264	168	96
PCT7043	ED	224	78	0	0	4	74	47	27
PCT7043	TO	978	368	0	0	30	338	215	123
PCT7044	MV	586	133	0	0	3	130	67	63
PCT7044	ED	266	33	0	0	3	30	24	6
PCT7044	TO	852	166	0	0	6	160	91	69
PCT7045	MV	632	264	0	0	28	236	139	97
PCT7045	ED	154	53	0	0	5	48	26	22
PCT7045	TO	786	317	0	0	33	284	165	119
PCT7046	MV	334	130	0	0	13	117	63	54
PCT7046	ED	96	48	0	0	3	45	24	21
PCT7046	TO	430	178	0	0	16	162	87	75
PCT7047	MV	730	309	0	0	25	284	150	134
PCT7047	ED	153	62	0	0	6	56	36	20
PCT7047	TO	883	371	0	0	31	340	186	154
PCT7048	MV	685	263	0	0	21	242	146	96
PCT7048	ED	196	56	0	0	5	51	30	21
PCT7048	TO	881	319	0	0	26	293	176	117
PCT7049	MV	616	239	0	0	22	217	117	100
PCT7049	ED	210	70	0	0	9	61	30	31
PCT7049	TO	826	309	0	0	31	278	147	131
PCT7051	MV	715	301	0	0	23	278	141	137
PCT7051	ED	165	70	0	0	8	62	43	19
PCT7051	TO	880	371	0	0	31	340	184	156
PCT7052	MV	721	291	0	0	14	277	138	139
PCT7052	ED	185	84	0	0	6	78	41	37
PCT7052	TO	906	375	0	0	20	355	179	176
PCT7053	MV	542	226	0	0	38	188	87	101
PCT7053	ED	43	40	0	0	4	36	19	17
PCT7053	TO	585	266	0	0	42	224	106	118
PCT7054	MV	862	305	0	1	30	274	154	120
PCT7054	ED	274	105	0	0	5	100	59	41
PCT7054	TO	1136	410	0	1	35	374	213	161
PCT7055	MV	732	289	0	0	23	266	150	116
PCT7055	ED	94	76	0	0	9	67	39	28
PCT7055	TO	826	365	0	0	32	333	189	144
PCT7056	MV	618	269	0	1	28	240	114	126
PCT7056	ED	87	119	0	0	12	107	63	44
PCT7056	TO	705	388	0	1	40	347	177	170
PCT7101	MV	162	99	0	0	8	91	49	42
PCT7101	ED	-15	0	0	0	0	0	0	0
PCT7101	TO	147	99	0	0	8	91	49	42
PCT7201	MV	788	374	0	0	36	338	148	190
PCT7201	ED	147	98	0	0	14	84	38	46
PCT7201	TO	935	472	0	0	50	422	186	236
PCT7202	MV	707	303	0	0	29	274	118	156
PCT7202	ED	144	123	0	0	13	110	60	50
PCT7202	TO	851	426	0	0	42	384	178	206
PCT7203	MV	693	316	0	0	44	272	124	148
PCT7203	ED	186	148	0	0	25	123	64	59
PCT7203	TO	879	464	0	0	69	395	188	207
PCT7204	MV	773	411	0	0	52	359	152	207
PCT7204	ED	126	116	0	0	23	93	45	48
PCT7204	TO	899	527	0	0	75	452	197	255
PCT7205	MV	724	357	0	0	33	324	152	172
PCT7205	ED	147	133	0	0	18	115	55	60
PCT7205	TO	871	490	0	0	51	439	207	232
PCT7206	MV	299	127	0	0	12	115	55	60
PCT7206	ED	78	76	0	0	5	71	35	36
PCT7206	TO	377	203	0	0	17	186	90	96
PCT7207	MV	744	329	0	0	32	297	154	143
PCT7207	ED	123	117	0	0	18	99	61	38
PCT7207	TO	867	446	0	0	50	396	215	181
PCT7208	MV	492	248	0	0	33	215	100	115
PCT7208	ED	78	60	0	0	6	54	32	22
PCT7208	TO	570	308	0	0	39	269	132	137
PCT7209	MV	595	338	0	0	45	293	105	188
PCT7209	ED	52	63	0	0	6	57	23	34
PCT7209	TO	647	401	0	0	51	350	128	222
PCT7301	MV	812	312	0	0	31	281	164	117
PCT7301	ED	202	112	0	0	10	102	60	42
PCT7301	TO	1014	424	0	0	41	383	224	159
PCT7302	MV	713	345	0	0	37	308	152	156
PCT7302	ED	136	116	0	0	13	103	51	52
PCT7302	TO	849	461	0	0	50	411	203	208
PCT7303	MV	869	370	0	0	34	336	186	150
PCT7303	ED	199	141	0	0	19	122	69	53
PCT7303	TO	1068	511	0	0	53	458	255	203
PCT7304	MV	802	359	0	0	38	321	141	180
PCT7304	ED	199	163	0	0	11	152	89	63
PCT7304	TO	1001	522	0	0	49	473	230	243
PCT7305	MV	713	372	0	0	36	336	137	199
PCT7305	ED	154	141	0	0	16	125	62	63
PCT7305	TO	867	513	0	0	52	461	199	262
PCT7306	MV	801	365	0	0	51	314	143	171
PCT7306	ED	243	152	0	0	18	134	78	56
PCT7306	TO	1044	517	0	0	69	448	221	227
PCT7307	MV	605	264	0	0	17	247	127	120
PCT7307	ED	169	101	0	0	11	90	51	39
PCT7307	TO	774	365	0	0	28	337	178	159
PCT7308	MV	520	249	0	0	17	232	110	122
PCT7308	ED	105	126	0	0	15	111	49	62
PCT7308	TO	625	375	0	0	32	343	159	184
PCT7309	MV	691	317	0	0	37	280	130	150
PCT7309	ED	167	156	0	0	20	136	76	60
PCT7309	TO	858	473	0	0	57	416	206	210
PCT7311	MV	698	325	0	0	24	301	130	171
PCT7311	ED	208	169	0	0	22	147	78	69
PCT7311	TO	906	494	0	0	46	448	208	240
PCT7312	MV	699	384	0	0	42	342	144	198
PCT7312	ED	111	120	0	0	10	110	47	63
PCT7312	TO	810	504	0	0	52	452	191	261
PCT7313	MV	818	365	0	0	30	335	182	153
PCT7313	ED	185	115	0	0	15	100	62	38
PCT7313	TO	1003	480	0	0	45	435	244	191
PCT7314	MV	612	222	0	0	28	194	128	66
PCT7314	ED	147	56	0	0	7	49	34	15
PCT7314	TO	759	278	0	0	35	243	162	81
PCT7315	MV	570	202	0	0	20	182	95	87
PCT7315	ED	195	117	0	0	12	105	60	45
PCT7315	TO	765	319	0	0	32	287	155	132
PCT7316	MV	654	255	0	0	31	224	129	95
PCT7316	ED	178	100	0	0	15	85	59	26
PCT7316	TO	832	355	0	0	46	309	188	121
PCT7317	MV	744	339	0	0	30	309	143	166
PCT7317	ED	146	107	0	0	15	92	55	37
PCT7317	TO	890	446	0	0	45	401	198	203
PCT7318	MV	605	289	0	0	35	254	133	121
PCT7318	ED	118	99	0	0	17	82	41	41
PCT7318	TO	723	388	0	0	52	336	174	162
PCT7319	MV	861	340	0	0	38	302	150	152
PCT7319	ED	188	113	0	0	16	97	47	50
PCT7319	TO	1049	453	0	0	54	399	197	202
PCT7321	MV	557	200	0	0	25	175	86	89
PCT7321	ED	102	62	0	0	9	53	27	26
PCT7321	TO	659	262	0	0	34	228	113	115
PCT7322	MV	742	292	0	1	43	248	160	88
PCT7322	ED	146	25	0	0	3	22	18	4
PCT7322	TO	888	317	0	1	46	270	178	92
PCT7323	MV	789	362	0	0	51	311	140	171
PCT7323	ED	167	126	0	0	15	111	61	50
PCT7323	TO	956	488	0	0	66	422	201	221
PCT7324	MV	586	253	0	0	33	220	120	100
PCT7324	ED	151	88	0	0	13	75	37	38
PCT7324	TO	737	341	0	0	46	295	157	138
PCT7325	MV	714	315	0	0	37	278	148	130
PCT7325	ED	172	121	0	0	17	104	60	44
PCT7325	TO	886	436	0	0	54	382	208	174
PCT7326	MV	685	298	0	0	35	263	147	116
PCT7326	ED	174	116	0	0	17	99	50	49
PCT7326	TO	859	414	0	0	52	362	197	165
PCT7327	MV	561	224	0	0	32	192	117	75
PCT7327	ED	126	37	0	0	4	33	16	17
PCT7327	TO	687	261	0	0	36	225	133	92
PCT7328	MV	829	321	0	0	62	259	161	98
PCT7328	ED	173	46	0	0	7	39	28	11
PCT7328	TO	1002	367	0	0	69	298	189	109
PCT7329	MV	556	222	0	0	24	198	79	119
PCT7329	ED	95	56	0	0	4	52	20	32
PCT7329	TO	651	278	0	0	28	250	99	151
PCT7331	MV	710	358	0	0	40	318	130	188
PCT7331	ED	160	129	0	0	20	109	44	65
PCT7331	TO	870	487	0	0	60	427	174	253
PCT7332	MV	654	256	0	0	30	226	138	88
PCT7332	ED	136	113	0	0	4	109	78	31
PCT7332	TO	790	369	0	0	34	335	216	119
PCT7333	MV	822	385	0	0	35	350	199	151
PCT7333	ED	193	161	0	0	16	145	89	56
PCT7333	TO	1015	546	0	0	51	495	288	207
PCT7334	MV	686	301	0	0	22	279	168	111
PCT7334	ED	133	105	0	0	9	96	68	28
PCT7334	TO	819	406	0	0	31	375	236	139
PCT7335	MV	788	385	0	0	40	345	168	177
PCT7335	ED	146	144	0	0	16	128	72	56
PCT7335	TO	934	529	0	0	56	473	240	233
PCT7336	MV	778	396	0	0	38	358	172	186
PCT7336	ED	176	128	0	0	18	110	64	46
PCT7336	TO	954	524	0	0	56	468	236	232
PCT7337	MV	772	379	0	0	46	333	144	189
PCT7337	ED	125	84	0	0	8	76	39	37
PCT7337	TO	897	463	0	0	54	409	183	226
PCT7338	MV	769	353	0	0	37	316	181	135
PCT7338	ED	126	70	0	0	8	62	42	20
PCT7338	TO	895	423	0	0	45	378	223	155
PCT7339	MV	605	262	0	0	23	239	137	102
PCT7339	ED	150	89	0	0	6	83	48	35
PCT7339	TO	755	351	0	0	29	322	185	137
PCT7341	MV	675	288	0	1	33	254	161	93
PCT7341	ED	178	131	0	1	9	121	85	36
PCT7341	TO	853	419	0	2	42	375	246	129
PCT7342	MV	673	316	0	0	24	292	174	118
PCT7342	ED	231	200	0	0	19	181	117	64
PCT7342	TO	904	516	0	0	43	473	291	182
PCT7343	MV	554	242	0	0	21	221	134	87
PCT7343	ED	150	116	0	0	12	104	76	28
PCT7343	TO	704	358	0	0	33	325	210	115
PCT7344	MV	863	378	0	0	28	350	177	173
PCT7344	ED	201	160	0	0	15	145	85	60
PCT7344	TO	1064	538	0	0	43	495	262	233
PCT7345	MV	903	418	0	0	35	383	224	159
PCT7345	ED	211	170	0	0	20	150	91	59
PCT7345	TO	1114	588	0	0	55	533	315	218
PCT7346	MV	680	280	0	0	29	251	178	73
PCT7346	ED	209	126	0	0	14	112	85	27
PCT7346	TO	889	406	0	0	43	363	263	100
PCT7347	MV	833	356	0	0	37	319	224	95
PCT7347	ED	170	98	0	0	8	90	62	28
PCT7347	TO	1003	454	0	0	45	409	286	123
PCT7348	MV	649	268	0	0	24	244	157	87
PCT7348	ED	194	100	0	0	8	92	58	34
PCT7348	TO	843	368	0	0	32	336	215	121
PCT7349	MV	710	310	0	1	25	284	155	129
PCT7349	ED	202	104	0	0	14	90	58	32
PCT7349	TO	912	414	0	1	39	374	213	161
PCT7501	MV	456	241	0	0	35	206	81	125
PCT7501	ED	95	90	0	0	14	76	38	38
PCT7501	TO	551	331	0	0	49	282	119	163
PCT7502	MV	668	310	0	0	34	276	144	132
PCT7502	ED	121	99	0	0	15	84	55	29
PCT7502	TO	789	409	0	0	49	360	199	161
PCT7503	MV	614	281	0	0	31	250	152	98
PCT7503	ED	148	100	0	0	19	81	47	34
PCT7503	TO	762	381	0	0	50	331	199	132
PCT7504	MV	404	173	0	0	17	156	89	67
PCT7504	ED	84	52	0	0	9	43	23	20
PCT7504	TO	488	225	0	0	26	199	112	87
PCT7505	MV	729	397	0	0	42	355	155	200
PCT7505	ED	133	96	0	0	8	88	40	48
PCT7505	TO	862	493	0	0	50	443	195	248
PCT7506	MV	842	360	0	0	40	320	194	126
PCT7506	ED	158	111	0	0	9	102	76	26
PCT7506	TO	1000	471	0	0	49	422	270	152
PCT7507	MV	693	286	0	0	22	264	175	89
PCT7507	ED	263	95	0	0	6	89	59	30
PCT7507	TO	956	381	0	0	28	353	234	119
PCT7508	MV	618	370	0	0	39	331	190	141
PCT7508	ED	126	103	0	0	10	93	57	36
PCT7508	TO	744	473	0	0	49	424	247	177
PCT7509	MV	756	396	0	0	33	363	213	150
PCT7509	ED	173	145	0	0	16	129	76	53
PCT7509	TO	929	541	0	0	49	492	289	203
PCT7512	MV	475	245	0	0	28	217	109	108
PCT7512	ED	125	85	0	0	8	77	48	29
PCT7512	TO	600	330	0	0	36	294	157	137
PCT7513	MV	575	243	0	0	34	209	140	69
PCT7513	ED	231	107	0	0	17	90	72	18
PCT7513	TO	806	350	0	0	51	299	212	87
PCT7514	MV	709	238	0	0	40	198	136	62
PCT7514	ED	207	59	0	0	14	45	28	17
PCT7514	TO	916	297	0	0	54	243	164	79
PCT7515	MV	663	311	0	1	25	285	178	107
PCT7515	ED	201	90	0	0	15	75	49	26
PCT7515	TO	864	401	0	1	40	360	227	133
PCT7516	MV	773	415	0	0	34	381	211	170
PCT7516	ED	147	118	0	0	6	112	54	58
PCT7516	TO	920	533	0	0	40	493	265	228
PCT7517	MV	645	354	0	0	43	311	197	114
PCT7517	ED	223	179	0	0	17	162	104	58
PCT7517	TO	868	533	0	0	60	473	301	172
PCT7518	MV	708	381	0	0	38	343	192	151
PCT7518	ED	218	185	0	0	17	168	106	62
PCT7518	TO	926	566	0	0	55	511	298	213
PCT7519	MV	543	254	0	0	25	229	138	91
PCT7519	ED	172	136	0	0	12	124	87	37
PCT7519	TO	715	390	0	0	37	353	225	128
PCT7521	MV	597	312	0	0	25	287	178	109
PCT7521	ED	182	149	0	0	10	139	88	51
PCT7521	TO	779	461	0	0	35	426	266	160
PCT7522	MV	588	291	0	1	26	264	151	113
PCT7522	ED	171	158	0	0	22	136	92	44
PCT7522	TO	759	449	0	1	48	400	243	157
PCT7523	MV	564	282	0	0	33	249	150	99
PCT7523	ED	180	169	0	0	12	157	106	51
PCT7523	TO	744	451	0	0	45	406	256	150
PCT7524	MV	480	221	0	0	22	199	142	57
PCT7524	ED	144	102	0	0	9	93	57	36
PCT7524	TO	624	323	0	0	31	292	199	93
PCT7525	MV	594	243	0	0	34	209	133	76
PCT7525	ED	170	94	0	0	10	84	53	31
PCT7525	TO	764	337	0	0	44	293	186	107
PCT7526	MV	825	390	0	0	45	345	186	159
PCT7526	ED	163	147	0	0	15	132	84	48
PCT7526	TO	988	537	0	0	60	477	270	207
PCT7527	MV	538	291	0	0	25	266	168	98
PCT7527	ED	172	112	0	0	7	105	64	41
PCT7527	TO	710	403	0	0	32	371	232	139
PCT7529	MV	748	361	0	0	32	329	198	131
PCT7529	ED	155	185	0	0	17	168	112	56
PCT7529	TO	903	546	0	0	49	497	310	187
PCT7531	MV	714	328	0	0	24	304	199	105
PCT7531	ED	159	132	0	0	5	127	86	41
PCT7531	TO	873	460	0	0	29	431	285	146
PCT7532	MV	668	325	0	0	29	296	163	133
PCT7532	ED	167	126	0	0	12	114	76	38
PCT7532	TO	835	451	0	0	41	410	239	171
PCT7533	MV	776	395	0	0	41	354	233	121
PCT7533	ED	194	185	0	0	20	165	115	50
PCT7533	TO	970	580	0	0	61	519	348	171
PCT7534	MV	670	363	0	1	34	328	196	132
PCT7534	ED	233	177	0	0	19	158	114	44
PCT7534	TO	903	540	0	1	53	486	310	176
PCT7535	MV	606	297	0	0	32	265	174	91
PCT7535	ED	139	151	0	0	19	132	92	40
PCT7535	TO	745	448	0	0	51	397	266	131
PCT7536	MV	670	337	0	0	25	312	198	114
PCT7536	ED	163	170	0	0	15	155	86	69
PCT7536	TO	833	507	0	0	40	467	284	183
PCT7537	MV	619	294	0	0	28	266	143	123
PCT7537	ED	126	148	0	0	12	136	84	52
PCT7537	TO	745	442	0	0	40	402	227	175
PCT7538	MV	562	313	0	0	34	279	155	124
PCT7538	ED	189	172	0	0	21	151	102	49
PCT7538	TO	751	485	0	0	55	430	257	173
PCT7539	MV	696	363	0	0	33	330	172	158
PCT7539	ED	225	187	0	0	12	175	130	45
PCT7539	TO	921	550	0	0	45	505	302	203
PCT7541	MV	600	289	0	0	33	256	146	110
PCT7541	ED	170	159	0	0	19	140	99	41
PCT7541	TO	770	448	0	0	52	396	245	151
PCT7542	MV	631	315	0	0	23	292	193	99
PCT7542	ED	193	166	0	0	8	158	110	48
PCT7542	TO	824	481	0	0	31	450	303	147
PCT7543	MV	694	365	0	0	29	336	207	129
PCT7543	ED	230	138	0	0	16	122	87	35
PCT7543	TO	924	503	0	0	45	458	294	164
PCT7544	MV	731	383	0	0	46	337	198	139
PCT7544	ED	168	159	0	0	17	142	95	47
PCT7544	TO	899	542	0	0	63	479	293	186
PCT7545	MV	723	385	0	0	40	345	190	155
PCT7545	ED	172	146	0	0	16	130	86	44
PCT7545	TO	895	531	0	0	56	475	276	199
PCT7546	MV	770	413	0	0	39	374	232	142
PCT7546	ED	183	209	0	0	18	191	111	80
PCT7546	TO	953	622	0	0	57	565	343	222
PCT7547	MV	796	413	0	0	35	378	259	119
PCT7547	ED	185	172	0	0	16	156	113	43
PCT7547	TO	981	585	0	0	51	534	372	162
PCT7548	MV	802	434	0	0	29	405	230	175
PCT7548	ED	249	201	0	1	15	185	119	66
PCT7548	TO	1051	635	0	1	44	590	349	241
PCT7549	MV	660	350	0	0	38	312	190	122
PCT7549	ED	146	140	0	0	19	121	72	49
PCT7549	TO	806	490	0	0	57	433	262	171
PCT7551	MV	587	295	0	0	20	275	152	123
PCT7551	ED	136	171	0	0	16	155	90	65
PCT7551	TO	723	466	0	0	36	430	242	188
PCT7552	MV	561	282	0	0	36	246	129	117
PCT7552	ED	124	127	0	0	16	111	62	49
PCT7552	TO	685	409	0	0	52	357	191	166
PCT7553	MV	211	94	0	0	10	84	47	37
PCT7553	ED	-20	0	0	0	0	0	0	0
PCT7553	TO	191	94	0	0	10	84	47	37
PCT7554	MV	653	372	0	0	36	336	158	178
PCT7554	ED	168	177	0	0	15	162	75	87
PCT7554	TO	821	549	0	0	51	498	233	265
PCT7555	MV	662	407	0	0	48	359	193	166
PCT7555	ED	210	210	0	0	21	189	102	87
PCT7555	TO	872	617	0	0	69	548	295	253
PCT7556	MV	813	505	0	0	40	465	222	243
PCT7556	ED	153	165	0	0	20	145	69	76
PCT7556	TO	966	670	0	0	60	610	291	319
PCT7601	MV	485	205	0	0	20	185	124	61
PCT7601	ED	192	89	0	0	13	76	55	21
PCT7601	TO	677	294	0	0	33	261	179	82
PCT7602	MV	654	271	0	0	25	246	168	78
PCT7602	ED	232	103	0	0	11	92	68	24
PCT7602	TO	886	374	0	0	36	338	236	102
PCT7603	MV	612	285	0	0	29	256	180	76
PCT7603	ED	203	167	0	0	13	154	114	40
PCT7603	TO	815	452	0	0	42	410	294	116
PCT7604	MV	685	261	0	0	20	241	185	56
PCT7604	ED	259	133	0	0	23	110	86	24
PCT7604	TO	944	394	0	0	43	351	271	80
PCT7605	MV	468	184	0	0	22	162	108	54
PCT7605	ED	193	62	0	0	5	57	46	11
PCT7605	TO	661	246	0	0	27	219	154	65
PCT7606	MV	673	263	0	0	33	230	155	75
PCT7606	ED	210	79	0	0	5	74	58	16
PCT7606	TO	883	342	0	0	38	304	213	91
PCT7607	MV	712	282	0	0	20	262	176	86
PCT7607	ED	207	100	0	0	6	94	63	31
PCT7607	TO	919	382	0	0	26	356	239	117
PCT7608	MV	279	96	0	0	11	85	57	28
PCT7608	ED	101	19	0	0	1	18	13	5
PCT7608	TO	380	115	0	0	12	103	70	33
PCT7609	MV	699	280	0	0	37	243	172	71
PCT7609	ED	185	49	0	0	8	41	33	8
PCT7609	TO	884	329	0	0	45	284	205	79
PCT7611	MV	586	230	0	0	21	209	161	48
PCT7611	ED	202	43	0	0	2	41	35	6
PCT7611	TO	788	273	0	0	23	250	196	54
PCT7612	MV	452	213	0	1	16	196	117	79
PCT7612	ED	105	29	0	0	2	27	17	10
PCT7612	TO	557	242	0	1	18	223	134	89
PCT7613	MV	634	236	0	0	22	214	148	66
PCT7613	ED	249	86	0	0	7	79	64	15
PCT7613	TO	883	322	0	0	29	293	212	81
PCT7614	MV	712	244	0	0	29	215	142	73
PCT7614	ED	204	78	0	0	7	71	49	22
PCT7614	TO	916	322	0	0	36	286	191	95
PCT7615	MV	510	162	0	0	16	146	101	45
PCT7615	ED	240	58	0	0	4	54	46	8
PCT7615	TO	750	220	0	0	20	200	147	53
PCT7616	MV	754	325	0	1	39	285	113	172
PCT7616	ED	82	86	0	0	12	74	36	38
PCT7616	TO	836	411	0	1	51	359	149	210
PCT7617	MV	583	218	0	0	31	187	136	51
PCT7617	ED	169	42	0	0	9	33	26	7
PCT7617	TO	752	260	0	0	40	220	162	58
PCT7618	MV	763	360	0	0	22	338	194	144
PCT7618	ED	151	84	0	0	10	74	37	37
PCT7618	TO	914	444	0	0	32	412	231	181
PCT7619	MV	937	432	0	0	37	395	213	182
PCT7619	ED	170	117	0	0	14	103	63	40
PCT7619	TO	1107	549	0	0	51	498	276	222
PCT7621	MV	1006	437	0	0	36	401	218	183
PCT7621	ED	149	103	0	0	13	90	54	36
PCT7621	TO	1155	540	0	0	49	491	272	219
PCT7622	MV	697	213	0	0	16	197	127	70
PCT7622	ED	263	73	0	0	10	63	46	17
PCT7622	TO	960	286	0	0	26	260	173	87
PCT7623	MV	767	255	0	1	25	229	155	74
PCT7623	ED	237	98	0	0	10	88	69	19
PCT7623	TO	1004	353	0	1	35	317	224	93
PCT7624	MV	651	205	0	0	21	184	113	71
PCT7624	ED	224	72	0	0	10	62	46	16
PCT7624	TO	875	277	0	0	31	246	159	87
PCT7625	MV	749	386	0	0	61	325	208	117
PCT7625	ED	73	34	0	0	1	33	24	9
PCT7625	TO	822	420	0	0	62	358	232	126
PCT7626	MV	944	396	0	0	48	348	126	222
PCT7626	ED	129	105	0	0	6	99	47	52
PCT7626	TO	1073	501	0	0	54	447	173	274
PCT7627	MV	456	194	0	0	20	174	59	115
PCT7627	ED	68	57	0	0	9	48	20	28
PCT7627	TO	524	251	0	0	29	222	79	143
PCT7628	MV	718	324	0	0	24	300	189	111
PCT7628	ED	220	110	0	0	8	102	68	34
PCT7628	TO	938	434	0	0	32	402	257	145
PCT7629	MV	691	266	0	0	23	243	150	93
PCT7629	ED	162	86	0	0	9	77	50	27
PCT7629	TO	853	352	0	0	32	320	200	120
PCT7631	MV	1009	433	0	1	39	393	208	185
PCT7631	ED	210	110	0	0	6	104	61	43
PCT7631	TO	1219	543	0	1	45	497	269	228
PCT7632	MV	1002	411	0	1	29	381	221	160
PCT7632	ED	169	128	0	0	8	120	71	49
PCT7632	TO	1171	539	0	1	37	501	292	209
PCT7633	MV	609	278	0	0	26	252	145	107
PCT7633	ED	126	96	0	0	13	83	42	41
PCT7633	TO	735	374	0	0	39	335	187	148
PCT7634	MV	704	338	0	0	46	292	175	117
PCT7634	ED	186	101	0	0	18	83	50	33
PCT7634	TO	890	439	0	0	64	375	225	150
PCT7635	MV	665	267	0	0	19	248	112	136
PCT7635	ED	188	62	0	0	5	57	27	30
PCT7635	TO	853	329	0	0	24	305	139	166
PCT7636	MV	797	321	0	0	31	290	137	153
PCT7636	ED	162	107	0	0	10	97	54	43
PCT7636	TO	959	428	0	0	41	387	191	196
PCT7637	MV	747	340	0	0	39	301	111	190
PCT7637	ED	121	98	0	0	12	86	33	53
PCT7637	TO	868	438	0	0	51	387	144	243
PCT7638	MV	806	370	0	0	48	322	119	203
PCT7638	ED	83	87	0	0	10	77	20	57
PCT7638	TO	889	457	0	0	58	399	139	260
PCT7639	MV	889	390	0	0	40	350	144	206
PCT7639	ED	133	132	0	0	28	104	45	59
PCT7639	TO	1022	522	0	0	68	454	189	265
PCT7641	MV	817	397	0	0	29	368	157	211
PCT7641	ED	134	92	0	0	4	88	47	41
PCT7641	TO	951	489	0	0	33	456	204	252
PCT7642	MV	647	305	0	0	44	261	140	121
PCT7642	ED	118	79	0	1	18	60	38	22
PCT7642	TO	765	384	0	1	62	321	178	143
PCT7643	MV	810	429	0	0	33	396	222	174
PCT7643	ED	131	105	0	0	15	90	46	44
PCT7643	TO	941	534	0	0	48	486	268	218
PCT7644	MV	1014	397	0	0	48	349	158	191
PCT7644	ED	162	142	0	0	12	130	93	37
PCT7644	TO	1176	539	0	0	60	479	251	228
PCT7645	MV	595	282	0	0	24	258	96	162
PCT7645	ED	61	56	0	0	9	47	26	21
PCT7645	TO	656	338	0	0	33	305	122	183
PCT7646	MV	1032	480	0	0	53	427	190	237
PCT7646	ED	121	133	0	0	24	109	67	42
PCT7646	TO	1153	613	0	0	77	536	257	279
PCT7647	MV	724	206	0	0	9	197	150	47
PCT7647	ED	263	79	0	0	4	75	59	16
PCT7647	TO	987	285	0	0	13	272	209	63
PCT7648	MV	2	1	0	0	1	0	0	0
PCT7648	ED	0	0	0	0	0	0	0	0
PCT7648	TO	2	1	0	0	1	0	0	0
PCT7649	MV	722	284	0	0	18	266	141	125
PCT7649	ED	178	78	0	0	9	69	44	25
PCT7649	TO	900	362	0	0	27	335	185	150
PCT7651	MV	834	323	0	0	36	287	124	163
PCT7651	ED	113	72	0	0	7	65	21	44
PCT7651	TO	947	395	0	0	43	352	145	207
PCT7652	MV	534	200	0	0	22	178	86	92
PCT7652	ED	101	86	0	0	9	77	46	31
PCT7652	TO	635	286	0	0	31	255	132	123
PCT7653	MV	750	322	0	0	45	277	129	148
PCT7653	ED	89	79	0	1	8	70	31	39
PCT7653	TO	839	401	0	1	53	347	160	187
PCT7654	MV	413	188	0	0	12	176	90	86
PCT7654	ED	53	83	0	0	15	68	41	27
PCT7654	TO	466	271	0	0	27	244	131	113
PCT7655	MV	582	211	0	0	18	193	86	107
PCT7655	ED	97	59	0	0	13	46	21	25
PCT7655	TO	679	270	0	0	31	239	107	132
PCT7656	MV	603	302	0	0	37	265	64	201
PCT7656	ED	35	40	0	0	6	34	8	26
PCT7656	TO	638	342	0	0	43	299	72	227
PCT7657	MV	561	265	0	1	30	234	74	160
PCT7657	ED	37	61	0	0	7	54	22	32
PCT7657	TO	598	326	0	1	37	288	96	192
PCT7701	MV	868	474	0	0	55	419	243	176
PCT7701	ED	196	173	0	0	20	153	90	63
PCT7701	TO	1064	647	0	0	75	572	333	239
PCT7702	MV	623	369	0	0	29	340	144	196
PCT7702	ED	133	103	0	0	6	97	50	47
PCT7702	TO	756	472	0	0	35	437	194	243
PCT7703	MV	187	71	0	0	7	64	51	13
PCT7703	ED	-13	0	0	0	0	0	0	0
PCT7703	TO	174	71	0	0	7	64	51	13
PCT7704	MV	798	485	0	0	47	438	184	254
PCT7704	ED	204	173	0	0	10	163	65	98
PCT7704	TO	1002	658	0	0	57	601	249	352
PCT7705	MV	470	281	0	0	19	262	104	158
PCT7705	ED	125	110	0	0	13	97	40	57
PCT7705	TO	595	391	0	0	32	359	144	215
PCT7706	MV	686	446	0	0	40	406	195	211
PCT7706	ED	180	162	0	0	15	147	58	89
PCT7706	TO	866	608	0	0	55	553	253	300
PCT7707	MV	683	424	0	0	39	385	178	207
PCT7707	ED	189	179	0	0	12	167	76	91
PCT7707	TO	872	603	0	0	51	552	254	298
PCT7708	MV	710	455	0	0	51	404	185	219
PCT7708	ED	165	152	0	0	17	135	69	66
PCT7708	TO	875	607	0	0	68	539	254	285
PCT7709	MV	322	191	0	0	13	178	98	80
PCT7709	ED	84	90	0	0	6	84	53	31
PCT7709	TO	406	281	0	0	19	262	151	111
PCT7711	MV	658	372	0	0	39	333	164	169
PCT7711	ED	153	125	0	0	9	116	69	47
PCT7711	TO	811	497	0	0	48	449	233	216
PCT7712	MV	423	254	0	0	16	238	136	102
PCT7712	ED	109	106	0	0	9	97	57	40
PCT7712	TO	532	360	0	0	25	335	193	142
PCT7801	MV	823	469	0	0	40	429	210	219
PCT7801	ED	151	190	0	0	17	173	90	83
PCT7801	TO	974	659	0	0	57	602	300	302
PCT7802	MV	646	393	0	0	36	357	188	169
PCT7802	ED	152	157	0	0	15	142	84	58
PCT7802	TO	798	550	0	0	51	499	272	227
PCT7803	MV	718	470	0	0	39	431	204	227
PCT7803	ED	113	128	0	0	16	112	64	48
PCT7803	TO	831	598	0	0	55	543	268	275
PCT7804	MV	733	459	0	0	59	400	207	193
PCT7804	ED	152	180	0	0	25	155	76	79
PCT7804	TO	885	639	0	0	84	555	283	272
PCT7805	MV	644	389	0	0	41	348	181	167
PCT7805	ED	156	155	0	0	15	140	97	43
PCT7805	TO	800	544	0	0	56	488	278	210
PCT7806	MV	602	353	0	1	35	317	165	152
PCT7806	ED	153	152	0	0	15	137	86	51
PCT7806	TO	755	505	0	1	50	454	251	203
PCT7807	MV	642	353	0	0	28	325	188	137
PCT7807	ED	185	174	0	0	20	154	103	51
PCT7807	TO	827	527	0	0	48	479	291	188
PCT7808	MV	525	288	0	0	30	258	150	108
PCT7808	ED	129	129	0	0	17	112	69	43
PCT7808	TO	654	417	0	0	47	370	219	151
PCT7809	MV	624	348	0	0	25	323	206	117
PCT7809	ED	140	135	0	0	9	126	84	42
PCT7809	TO	764	483	0	0	34	449	290	159
PCT7811	MV	582	303	0	0	29	274	168	106
PCT7811	ED	176	155	0	0	8	147	97	50
PCT7811	TO	758	458	0	0	37	421	265	156
PCT7812	MV	680	364	0	0	37	327	181	146
PCT7812	ED	217	163	0	0	19	144	95	49
PCT7812	TO	897	527	0	0	56	471	276	195
PCT7813	MV	842	478	0	0	29	449	289	160
PCT7813	ED	226	214	0	0	24	190	139	51
PCT7813	TO	1068	692	0	0	53	639	428	211
PCT7814	MV	660	274	0	0	24	250	172	78
PCT7814	ED	241	118	0	0	15	103	80	23
PCT7814	TO	901	392	0	0	39	353	252	101
PCT7815	MV	749	460	0	0	53	407	222	185
PCT7815	ED	168	176	0	0	13	163	104	59
PCT7815	TO	917	636	0	0	66	570	326	244
PCT7816	MV	724	466	0	0	42	424	217	207
PCT7816	ED	148	149	0	0	9	140	75	65
PCT7816	TO	872	615	0	0	51	564	292	272
PCT7817	MV	652	386	0	0	25	361	207	154
PCT7817	ED	186	182	0	0	15	167	105	62
PCT7817	TO	838	568	0	0	40	528	312	216
PCT7818	MV	668	389	0	0	26	363	203	160
PCT7818	ED	171	149	0	0	12	137	85	52
PCT7818	TO	839	538	0	0	38	500	288	212
PCT7819	MV	635	346	0	0	30	316	188	128
PCT7819	ED	139	89	0	0	8	81	54	27
PCT7819	TO	774	435	0	0	38	397	242	155
PCT7821	MV	806	513	0	0	35	478	255	223
PCT7821	ED	170	189	0	0	12	177	94	83
PCT7821	TO	976	702	0	0	47	655	349	306
PCT7822	MV	673	390	0	0	32	358	204	154
PCT7822	ED	219	222	0	0	28	194	118	76
PCT7822	TO	892	612	0	0	60	552	322	230
PCT7823	MV	706	398	0	0	33	365	206	159
PCT7823	ED	177	188	0	0	6	182	130	52
PCT7823	TO	883	586	0	0	39	547	336	211
PCT7824	MV	614	324	0	0	34	290	148	142
PCT7824	ED	154	158	0	0	19	139	90	49
PCT7824	TO	768	482	0	0	53	429	238	191
PCT7825	MV	457	248	0	0	22	226	134	92
PCT7825	ED	151	130	0	0	6	124	81	43
PCT7825	TO	608	378	0	0	28	350	215	135
PCT7826	MV	486	256	0	0	17	239	138	101
PCT7826	ED	204	162	0	0	15	147	98	49
PCT7826	TO	690	418	0	0	32	386	236	150
PCT7827	MV	607	312	0	0	24	288	175	113
PCT7827	ED	219	145	0	0	14	131	97	34
PCT7827	TO	826	457	0	0	38	419	272	147
PCT7828	MV	857	469	0	1	46	422	238	184
PCT7828	ED	171	177	0	0	21	156	90	66
PCT7828	TO	1028	646	0	1	67	578	328	250
PCT7829	MV	742	456	0	0	43	413	219	194
PCT7829	ED	149	151	0	0	8	143	87	56
PCT7829	TO	891	607	0	0	51	556	306	250
PCT7831	MV	763	478	0	0	50	428	205	223
PCT7831	ED	139	137	0	0	11	126	73	53
PCT7831	TO	902	615	0	0	61	554	278	276
PCT7832	MV	663	401	0	0	39	362	201	161
PCT7832	ED	118	127	0	0	9	118	70	48
PCT7832	TO	781	528	0	0	48	480	271	209
PCT7833	MV	587	339	0	0	28	311	174	137
PCT7833	ED	146	145	0	0	19	126	74	52
PCT7833	TO	733	484	0	0	47	437	248	189
PCT7834	MV	700	363	0	0	37	326	181	145
PCT7834	ED	194	175	0	0	22	153	101	52
PCT7834	TO	894	538	0	0	59	479	282	197
PCT7835	MV	721	423	0	0	30	393	218	175
PCT7835	ED	142	147	0	0	14	133	84	49
PCT7835	TO	863	570	0	0	44	526	302	224
PCT7836	MV	850	503	0	0	40	463	280	183
PCT7836	ED	193	169	0	0	10	159	95	64
PCT7836	TO	1043	672	0	0	50	622	375	247
PCT7837	MV	717	416	0	0	53	363	158	205
PCT7837	ED	206	198	0	0	22	176	95	81
PCT7837	TO	923	614	0	0	75	539	253	286
PCT7838	MV	752	484	0	0	47	437	213	224
PCT7838	ED	143	155	0	0	18	137	83	54
PCT7838	TO	895	639	0	0	65	574	296	278
PCT7839	MV	731	445	0	0	43	402	190	212
PCT7839	ED	130	136	0	0	14	122	61	61
PCT7839	TO	861	581	0	0	57	524	251	273
PCT7841	MV	752	449	0	0	39	410	223	187
PCT7841	ED	198	207	0	0	15	192	105	87
PCT7841	TO	950	656	0	0	54	602	328	274
PCT7842	MV	702	382	0	0	33	349	218	131
PCT7842	ED	177	154	0	0	9	145	86	59
PCT7842	TO	879	536	0	0	42	494	304	190
PCT7843	MV	546	289	0	0	21	268	159	109
PCT7843	ED	183	163	0	0	14	149	99	50
PCT7843	TO	729	452	0	0	35	417	258	159
PCT7844	MV	499	276	0	0	22	254	157	97
PCT7844	ED	152	136	0	0	14	122	85	37
PCT7844	TO	651	412	0	0	36	376	242	134
PCT7845	MV	676	393	0	0	36	357	185	172
PCT7845	ED	204	177	0	0	15	162	80	82
PCT7845	TO	880	570	0	0	51	519	265	254
PCT7846	MV	736	454	0	0	44	410	189	221
PCT7846	ED	172	166	0	0	20	146	77	69
PCT7846	TO	908	620	0	0	64	556	266	290
PCT7847	MV	698	421	0	0	59	362	211	151
PCT7847	ED	193	181	0	0	9	172	96	76
PCT7847	TO	891	602	0	0	68	534	307	227
PCT7848	MV	665	427	0	0	29	398	196	202
PCT7848	ED	182	168	0	0	23	145	77	68
PCT7848	TO	847	595	0	0	52	543	273	270
PCT7849	MV	729	427	0	1	37	389	193	196
PCT7849	ED	172	186	0	0	19	167	101	66
PCT7849	TO	901	613	0	1	56	556	294	262
PCT7851	MV	414	266	0	0	26	240	82	158
PCT7851	ED	112	84	0	0	14	70	14	56
PCT7851	TO	526	350	0	0	40	310	96	214
PCT7852	MV	533	347	0	0	40	307	155	152
PCT7852	ED	111	103	0	0	11	92	46	46
PCT7852	TO	644	450	0	0	51	399	201	198
PCT7853	MV	694	382	0	0	41	341	173	168
PCT7853	ED	161	137	0	0	10	127	60	67
PCT7853	TO	855	519	0	0	51	468	233	235
PCT7854	MV	703	422	0	1	44	377	180	197
PCT7854	ED	175	172	0	0	13	159	84	75
PCT7854	TO	878	594	0	1	57	536	264	272
PCT7855	MV	763	440	0	0	46	394	187	207
PCT7855	ED	211	202	0	0	23	179	95	84
PCT7855	TO	974	642	0	0	69	573	282	291
PCT7856	MV	643	362	0	0	23	339	178	161
PCT7856	ED	204	193	0	0	18	175	105	70
PCT7856	TO	847	555	0	0	41	514	283	231
PCT7857	MV	748	427	0	1	40	386	200	186
PCT7857	ED	158	153	0	0	13	140	81	59
PCT7857	TO	906	580	0	1	53	526	281	245
PCT7858	MV	622	345	0	0	34	311	187	124
PCT7858	ED	157	147	0	0	12	135	91	44
PCT7858	TO	779	492	0	0	46	446	278	168
PCT7859	MV	747	457	0	0	44	413	197	216
PCT7859	ED	152	165	0	0	21	144	81	63
PCT7859	TO	899	622	0	0	65	557	278	279
PCT7861	MV	699	424	0	1	31	392	199	193
PCT7861	ED	164	171	0	0	10	161	101	60
PCT7861	TO	863	595	0	1	41	553	300	253
PCT7862	MV	669	397	0	0	30	367	174	193
PCT7862	ED	195	197	0	0	14	183	100	83
PCT7862	TO	864	594	0	0	44	550	274	276
PCT7863	MV	692	361	0	0	32	329	195	134
PCT7863	ED	209	205	0	0	16	189	112	77
PCT7863	TO	901	566	0	0	48	518	307	211
PCT7864	MV	661	365	0	0	46	319	167	152
PCT7864	ED	153	157	0	0	17	140	87	53
PCT7864	TO	814	522	0	0	63	459	254	205
PCT7865	MV	677	402	0	1	46	355	193	162
PCT7865	ED	163	157	0	0	12	145	93	52
PCT7865	TO	840	559	0	1	58	500	286	214
PCT7866	MV	690	444	0	0	41	403	204	199
PCT7866	ED	158	141	0	0	13	128	62	66
PCT7866	TO	848	585	0	0	54	531	266	265
PCT7867	MV	766	462	0	0	41	421	227	194
PCT7867	ED	212	182	0	0	20	162	91	71
PCT7867	TO	978	644	0	0	61	583	318	265
PCT7868	MV	659	368	0	0	28	340	171	169
PCT7868	ED	217	161	0	0	22	139	83	56
PCT7868	TO	876	529	0	0	50	479	254	225
PCT7869	MV	682	436	0	0	31	405	209	196
PCT7869	ED	179	189	0	0	21	168	103	65
PCT7869	TO	861	625	0	0	52	573	312	261
PCT7871	MV	702	456	0	0	47	409	214	195
PCT7871	ED	200	157	0	0	12	145	70	75
PCT7871	TO	902	613	0	0	59	554	284	270
PCT7872	MV	675	410	0	0	35	375	179	196
PCT7872	ED	199	185	0	0	15	170	77	93
PCT7872	TO	874	595	0	0	50	545	256	289
PCT7873	MV	688	437	0	0	36	401	221	180
PCT7873	ED	203	212	0	0	19	193	117	76
PCT7873	TO	891	649	0	0	55	594	338	256
PCT7874	MV	370	187	0	0	17	170	98	72
PCT7874	ED	119	107	0	0	11	96	52	44
PCT7874	TO	489	294	0	0	28	266	150	116
PCT7875	MV	500	247	0	0	22	225	137	88
PCT7875	ED	147	114	0	0	6	108	68	40
PCT7875	TO	647	361	0	0	28	333	205	128
PCT7876	MV	462	250	0	0	32	218	127	91
PCT7876	ED	106	91	0	0	14	77	44	33
PCT7876	TO	568	341	0	0	46	295	171	124
PCT7901	MV	399	191	0	0	14	177	120	57
PCT7901	ED	150	65	0	0	1	64	45	19
PCT7901	TO	549	256	0	0	15	241	165	76
PCT7902	MV	680	286	0	0	17	269	169	100
PCT7902	ED	232	139	0	1	10	128	91	37
PCT7902	TO	912	425	0	1	27	397	260	137
PCT7903	MV	622	278	0	0	22	256	174	82
PCT7903	ED	230	123	0	0	9	114	84	30
PCT7903	TO	852	401	0	0	31	370	258	112
PCT7904	MV	678	289	0	0	24	265	173	92
PCT7904	ED	159	115	0	1	7	107	73	34
PCT7904	TO	837	404	0	1	31	372	246	126
PCT7905	MV	684	354	0	0	23	331	191	140
PCT7905	ED	191	183	0	0	11	172	111	61
PCT7905	TO	875	537	0	0	34	503	302	201
PCT7906	MV	599	276	0	0	16	260	155	105
PCT7906	ED	187	115	0	0	13	102	81	21
PCT7906	TO	786	391	0	0	29	362	236	126
PCT7907	MV	704	339	0	0	22	317	213	104
PCT7907	ED	238	163	0	0	15	148	104	44
PCT7907	TO	942	502	0	0	37	465	317	148
PCT7908	MV	752	359	0	0	27	332	207	125
PCT7908	ED	240	169	0	0	20	149	104	45
PCT7908	TO	992	528	0	0	47	481	311	170
PCT7909	MV	558	308	0	0	22	286	186	100
PCT7909	ED	185	140	0	0	5	135	95	40
PCT7909	TO	743	448	0	0	27	421	281	140
PCT7911	MV	666	315	0	0	27	288	174	114
PCT7911	ED	205	129	0	0	10	119	76	43
PCT7911	TO	871	444	0	0	37	407	250	157
PCT7912	MV	800	368	0	0	26	342	213	129
PCT7912	ED	259	176	0	0	23	153	107	46
PCT7912	TO	1059	544	0	0	49	495	320	175
PCT7913	MV	659	345	0	0	15	330	208	122
PCT7913	ED	264	212	0	0	11	201	133	68
PCT7913	TO	923	557	0	0	26	531	341	190
PCT7914	MV	715	381	0	0	38	343	220	123
PCT7914	ED	187	140	0	0	15	125	90	35
PCT7914	TO	902	521	0	0	53	468	310	158
PCT7915	MV	605	279	0	0	20	259	159	100
PCT7915	ED	238	181	0	0	7	174	130	44
PCT7915	TO	843	460	0	0	27	433	289	144
PCT7916	MV	639	321	0	0	22	299	180	119
PCT7916	ED	219	160	0	0	10	150	108	42
PCT7916	TO	858	481	0	0	32	449	288	161
PCT7917	MV	716	353	0	0	25	328	212	116
PCT7917	ED	271	187	0	0	6	181	142	39
PCT7917	TO	987	540	0	0	31	509	354	155
PCT7918	MV	597	296	0	0	20	276	175	101
PCT7918	ED	227	143	0	0	10	133	94	39
PCT7918	TO	824	439	0	0	30	409	269	140
PCT7919	MV	608	305	0	0	24	281	184	97
PCT7919	ED	258	175	0	0	11	164	123	41
PCT7919	TO	866	480	0	0	35	445	307	138
PCT7921	MV	682	302	0	0	18	284	189	95
PCT7921	ED	229	101	0	0	8	93	59	34
PCT7921	TO	911	403	0	0	26	377	248	129
PCT7922	MV	648	309	0	0	16	293	194	99
PCT7922	ED	210	155	0	0	14	141	104	37
PCT7922	TO	858	464	0	0	30	434	298	136
PCT7923	MV	666	331	0	0	18	313	194	119
PCT7923	ED	214	170	0	0	10	160	121	39
PCT7923	TO	880	501	0	0	28	473	315	158
PCT7924	MV	649	294	0	0	11	283	181	102
PCT7924	ED	202	124	0	0	8	116	80	36
PCT7924	TO	851	418	0	0	19	399	261	138
PCT7925	MV	434	222	0	0	18	204	120	84
PCT7925	ED	110	89	0	0	5	84	61	23
PCT7925	TO	544	311	0	0	23	288	181	107
PCT7926	MV	610	328	0	1	24	303	187	116
PCT7926	ED	178	150	0	0	16	134	80	54
PCT7926	TO	788	478	0	1	40	437	267	170
PCT7927	MV	580	325	0	0	32	293	172	121
PCT7927	ED	162	152	0	1	8	143	88	55
PCT7927	TO	742	477	0	1	40	436	260	176
PCT7928	MV	700	389	0	0	26	363	230	133
PCT7928	ED	217	208	0	0	13	195	126	69
PCT7928	TO	917	597	0	0	39	558	356	202
PCT7929	MV	678	419	0	0	34	385	219	166
PCT7929	ED	169	170	0	0	17	153	95	58
PCT7929	TO	847	589	0	0	51	538	314	224
PCT7931	MV	610	368	0	0	43	325	184	141
PCT7931	ED	141	149	0	0	15	134	78	56
PCT7931	TO	751	517	0	0	58	459	262	197
PCT7932	MV	443	276	0	0	27	249	135	114
PCT7932	ED	118	95	0	0	12	83	50	33
PCT7932	TO	561	371	0	0	39	332	185	147
PCT7933	MV	9	6	0	0	0	6	4	2
PCT7933	ED	-1	0	0	0	0	0	0	0
PCT7933	TO	8	6	0	0	0	6	4	2
PCT7934	MV	702	398	0	0	33	365	243	122
PCT7934	ED	182	154	0	0	21	133	105	28
PCT7934	TO	884	552	0	0	54	498	348	150
PCT7935	MV	715	429	0	0	37	392	237	155
PCT7935	ED	228	225	0	0	20	205	141	64
PCT7935	TO	943	654	0	0	57	597	378	219
PCT7936	MV	620	365	0	1	33	331	209	122
PCT7936	ED	236	220	0	0	15	205	131	74
PCT7936	TO	856	585	0	1	48	536	340	196
PCT7937	MV	698	404	0	0	40	364	239	125
PCT7937	ED	202	171	0	0	13	158	124	34
PCT7937	TO	900	575	0	0	53	522	363	159
PCT7938	MV	536	297	0	0	18	279	168	111
PCT7938	ED	215	120	0	0	9	111	80	31
PCT7938	TO	751	417	0	0	27	390	248	142
PCT7939	MV	481	279	0	0	21	258	167	91
PCT7939	ED	205	191	0	0	16	175	112	63
PCT7939	TO	686	470	0	0	37	433	279	154
PCT7941	MV	575	298	0	0	26	272	190	82
PCT7941	ED	197	170	0	0	16	154	83	71
PCT7941	TO	772	468	0	0	42	426	273	153
PCT7942	MV	658	324	0	0	24	300	188	112
PCT7942	ED	274	141	0	0	8	133	90	43
PCT7942	TO	932	465	0	0	32	433	278	155
PCT7943	MV	687	361	0	0	27	334	200	134
PCT7943	ED	213	156	0	0	14	142	84	58
PCT7943	TO	900	517	0	0	41	476	284	192
PCT7944	MV	584	332	0	0	37	295	178	117
PCT7944	ED	230	196	0	0	18	178	107	71
PCT7944	TO	814	528	0	0	55	473	285	188
PCT7945	MV	726	331	0	0	32	299	175	124
PCT7945	ED	228	82	0	0	9	73	53	20
PCT7945	TO	954	413	0	0	41	372	228	144
PCT7946	MV	779	361	0	0	25	336	175	161
PCT7946	ED	206	114	0	0	13	101	70	31
PCT7946	TO	985	475	0	0	38	437	245	192
PCT7947	MV	791	329	0	0	30	299	173	126
PCT7947	ED	195	93	0	0	6	87	56	31
PCT7947	TO	986	422	0	0	36	386	229	157
PCT7948	MV	730	364	0	0	32	332	181	151
PCT7948	ED	200	119	0	0	7	112	68	44
PCT7948	TO	930	483	0	0	39	444	249	195
PCT7949	MV	484	230	0	0	17	213	84	129
PCT7949	ED	106	56	0	0	9	47	26	21
PCT7949	TO	590	286	0	0	26	260	110	150
PCT7951	MV	730	363	0	0	31	332	151	181
PCT7951	ED	157	90	0	0	8	82	48	34
PCT7951	TO	887	453	0	0	39	414	199	215
PCT7952	MV	730	290	0	0	23	267	142	125
PCT7952	ED	182	86	0	0	12	74	42	32
PCT7952	TO	912	376	0	0	35	341	184	157
PCT7953	MV	669	327	0	0	33	294	130	164
PCT7953	ED	161	106	0	0	8	98	51	47
PCT7953	TO	830	433	0	0	41	392	181	211
PCT7954	MV	0	0	0	0	0	0	0	0
PCT7954	ED	0	0	0	0	0	0	0	0
PCT7954	TO	0	0	0	0	0	0	0	0
PCT7955	MV	774	341	0	0	35	306	155	151
PCT7955	ED	173	97	0	0	12	85	42	43
PCT7955	TO	947	438	0	0	47	391	197	194
PCT7956	MV	699	260	0	0	19	241	143	98
PCT7956	ED	170	39	0	0	2	37	22	15
PCT7956	TO	869	299	0	0	21	278	165	113
PCT7957	MV	538	256	0	1	22	233	150	83
PCT7957	ED	135	83	0	0	10	73	44	29
PCT7957	TO	673	339	0	1	32	306	194	112
PCT7958	MV	320	103	0	0	6	97	57	40
PCT7958	ED	-23	0	0	0	0	0	0	0
PCT7958	TO	297	103	0	0	6	97	57	40
PCT7959	MV	541	226	0	0	23	203	129	74
PCT7959	ED	145	65	0	0	8	57	41	16
PCT7959	TO	686	291	0	0	31	260	170	90
PCT9001	MV	314	99	0	0	3	96	58	38
PCT9001	ED	-30	0	0	0	0	0	0	0
PCT9001	TO	284	99	0	0	3	96	58	38
PCT9101	MV	712	372	0	0	31	341	193	148
PCT9101	ED	201	150	0	0	11	139	85	54
PCT9101	TO	913	522	0	0	42	480	278	202
PCT9102	MV	787	388	0	0	37	351	197	154
PCT9102	ED	205	126	0	0	9	117	60	57
PCT9102	TO	992	514	0	0	46	468	257	211
PCT9103	MV	718	377	0	0	37	340	181	159
PCT9103	ED	239	153	0	0	20	133	69	64
PCT9103	TO	957	530	0	0	57	473	250	223
PCT9104	MV	810	381	0	0	39	342	199	143
PCT9104	ED	220	152	0	0	15	137	91	46
PCT9104	TO	1030	533	0	0	54	479	290	189
PCT9105	MV	719	410	0	0	33	377	191	186
PCT9105	ED	199	173	0	0	19	154	85	69
PCT9105	TO	918	583	0	0	52	531	276	255
PCT9106	MV	746	384	0	0	43	341	166	175
PCT9106	ED	200	178	0	0	18	160	90	70
PCT9106	TO	946	562	0	0	61	501	256	245
PCT9107	MV	635	300	0	0	33	267	169	98
PCT9107	ED	209	118	0	0	11	107	68	39
PCT9107	TO	844	418	0	0	44	374	237	137
PCT9108	MV	610	332	0	0	43	289	171	118
PCT9108	ED	200	136	0	0	11	125	79	46
PCT9108	TO	810	468	0	0	54	414	250	164
PCT9109	MV	672	293	0	0	33	260	137	123
PCT9109	ED	211	162	0	0	13	149	81	68
PCT9109	TO	883	455	0	0	46	409	218	191
PCT9111	MV	638	315	0	0	30	285	170	115
PCT9111	ED	196	134	0	0	21	113	72	41
PCT9111	TO	834	449	0	0	51	398	242	156
PCT9112	MV	742	346	0	0	43	303	176	127
PCT9112	ED	219	160	0	0	15	145	87	58
PCT9112	TO	961	506	0	0	58	448	263	185
PCT9113	MV	795	365	0	0	39	326	177	149
PCT9113	ED	209	180	0	0	18	162	88	74
PCT9113	TO	1004	545	0	0	57	488	265	223
PCT9114	MV	659	289	0	0	25	264	164	100
PCT9114	ED	231	147	0	0	20	127	87	40
PCT9114	TO	890	436	0	0	45	391	251	140
PCT9115	MV	699	319	0	0	30	289	183	106
PCT9115	ED	182	155	0	0	23	132	97	35
PCT9115	TO	881	474	0	0	53	421	280	141
PCT9116	MV	782	342	0	0	24	318	187	131
PCT9116	ED	179	148	0	0	19	129	87	42
PCT9116	TO	961	490	0	0	43	447	274	173
PCT9117	MV	629	325	0	0	33	292	146	146
PCT9117	ED	171	158	0	0	12	146	80	66
PCT9117	TO	800	483	0	0	45	438	226	212
PCT9118	MV	738	338	0	0	34	304	167	137
PCT9118	ED	246	165	0	0	17	148	97	51
PCT9118	TO	984	503	0	0	51	452	264	188
PCT9119	MV	703	383	0	0	33	350	178	172
PCT9119	ED	197	120	0	0	15	105	63	42
PCT9119	TO	900	503	0	0	48	455	241	214
PCT9121	MV	734	326	0	0	32	294	146	148
PCT9121	ED	219	141	0	0	13	128	73	55
PCT9121	TO	953	467	0	0	45	422	219	203
PCT9122	MV	774	362	0	0	31	331	180	151
PCT9122	ED	193	122	0	0	15	107	60	47
PCT9122	TO	967	484	0	0	46	438	240	198
PCT9123	MV	661	319	0	0	23	296	160	136
PCT9123	ED	191	139	0	0	17	122	70	52
PCT9123	TO	852	458	0	0	40	418	230	188
PCT9124	MV	735	347	0	0	20	327	178	149
PCT9124	ED	168	118	0	0	8	110	77	33
PCT9124	TO	903	465	0	0	28	437	255	182
PCT9125	MV	680	350	0	0	29	321	176	145
PCT9125	ED	189	124	0	0	10	114	67	47
PCT9125	TO	869	474	0	0	39	435	243	192
PCT9126	MV	819	379	0	0	44	335	163	172
PCT9126	ED	194	152	0	0	13	139	80	59
PCT9126	TO	1013	531	0	0	57	474	243	231
PCT9127	MV	748	375	0	0	50	325	170	155
PCT9127	ED	223	184	0	0	17	167	92	75
PCT9127	TO	971	559	0	0	67	492	262	230
PCT9128	MV	628	330	0	0	31	299	130	169
PCT9128	ED	190	166	0	0	17	149	85	64
PCT9128	TO	818	496	0	0	48	448	215	233
PCT9129	MV	587	268	0	0	22	246	149	97
PCT9129	ED	151	129	0	0	7	122	77	45
PCT9129	TO	738	397	0	0	29	368	226	142
PCT9131	MV	596	280	0	0	24	256	127	129
PCT9131	ED	138	111	0	0	14	97	61	36
PCT9131	TO	734	391	0	0	38	353	188	165
PCT9132	MV	627	258	0	0	37	221	140	81
PCT9132	ED	194	130	0	0	12	118	82	36
PCT9132	TO	821	388	0	0	49	339	222	117
PCT9133	MV	808	373	0	0	39	334	185	149
PCT9133	ED	209	157	0	0	12	145	80	65
PCT9133	TO	1017	530	0	0	51	479	265	214
PCT9134	MV	736	254	0	0	20	234	119	115
PCT9134	ED	155	102	0	0	12	90	53	37
PCT9134	TO	891	356	0	0	32	324	172	152
PCT9135	MV	640	301	0	0	26	275	159	116
PCT9135	ED	182	125	0	0	12	113	54	59
PCT9135	TO	822	426	0	0	38	388	213	175
PCT9136	MV	706	360	0	0	43	317	180	137
PCT9136	ED	212	139	0	0	13	126	85	41
PCT9136	TO	918	499	0	0	56	443	265	178
PCT9137	MV	804	381	0	0	40	341	201	140
PCT9137	ED	211	133	0	0	9	124	83	41
PCT9137	TO	1015	514	0	0	49	465	284	181
PCT9138	MV	770	396	0	0	33	363	192	171
PCT9138	ED	175	119	0	0	10	109	77	32
PCT9138	TO	945	515	0	0	43	472	269	203
PCT9139	MV	828	415	0	0	36	379	178	201
PCT9139	ED	190	141	0	0	15	126	68	58
PCT9139	TO	1018	556	0	0	51	505	246	259
PCT9141	MV	789	413	0	0	56	357	199	158
PCT9141	ED	184	144	0	0	12	132	77	55
PCT9141	TO	973	557	0	0	68	489	276	213
PCT9142	MV	747	360	0	0	28	332	204	128
PCT9142	ED	239	162	0	0	14	148	89	59
PCT9142	TO	986	522	0	0	42	480	293	187
PCT9143	MV	705	357	0	0	31	326	160	166
PCT9143	ED	209	150	0	0	8	142	74	68
PCT9143	TO	914	507	0	0	39	468	234	234
PCT9144	MV	766	371	0	0	34	337	190	147
PCT9144	ED	204	177	0	0	16	161	107	54
PCT9144	TO	970	548	0	0	50	498	297	201
PCT9145	MV	681	329	0	0	27	302	155	147
PCT9145	ED	194	157	0	0	14	143	75	68
PCT9145	TO	875	486	0	0	41	445	230	215
PCT9146	MV	725	350	0	0	38	312	193	119
PCT9146	ED	160	143	0	0	16	127	73	54
PCT9146	TO	885	493	0	0	54	439	266	173
PCT9147	MV	765	368	0	0	30	338	185	153
PCT9147	ED	225	161	0	0	14	147	89	58
PCT9147	TO	990	529	0	0	44	485	274	211
PCT9148	MV	778	389	0	0	33	356	186	170
PCT9148	ED	236	177	0	0	19	158	86	72
PCT9148	TO	1014	566	0	0	52	514	272	242
PCT9149	MV	812	372	0	0	28	344	188	156
PCT9149	ED	179	240	0	0	23	217	142	75
PCT9149	TO	991	612	0	0	51	561	330	231
PCT9151	MV	693	342	0	0	42	300	178	122
PCT9151	ED	168	111	0	0	7	104	55	49
PCT9151	TO	861	453	0	0	49	404	233	171
PCT9152	MV	550	196	0	0	18	178	113	65
PCT9152	ED	187	124	0	1	14	109	81	28
PCT9152	TO	737	320	0	1	32	287	194	93
PCT9201	MV	784	347	0	0	42	305	203	102
PCT9201	ED	187	166	0	0	17	149	100	49
PCT9201	TO	971	513	0	0	59	454	303	151
PCT9202	MV	819	361	0	1	50	310	158	152
PCT9202	ED	177	164	0	0	18	146	66	80
PCT9202	TO	996	525	0	1	68	456	224	232
PCT9203	MV	847	366	0	0	61	305	106	199
PCT9203	ED	155	120	0	0	16	104	44	60
PCT9203	TO	1002	486	0	0	77	409	150	259
PCT9204	MV	686	302	0	0	43	259	82	177
PCT9204	ED	176	138	0	0	18	120	39	81
PCT9204	TO	862	440	0	0	61	379	121	258
PCT9205	MV	621	278	0	0	39	239	102	137
PCT9205	ED	115	92	0	0	17	75	38	37
PCT9205	TO	736	370	0	0	56	314	140	174
PCT9206	MV	741	349	0	0	42	307	105	202
PCT9206	ED	188	149	0	0	26	123	49	74
PCT9206	TO	929	498	0	0	68	430	154	276
PCT9207	MV	824	366	0	0	37	329	147	182
PCT9207	ED	165	130	0	0	16	114	47	67
PCT9207	TO	989	496	0	0	53	443	194	249
PCT9208	MV	808	348	0	1	47	300	122	178
PCT9208	ED	179	127	0	0	15	112	51	61
PCT9208	TO	987	475	0	1	62	412	173	239
PCT9209	MV	615	274	0	0	30	244	89	155
PCT9209	ED	156	119	0	1	19	99	43	56
PCT9209	TO	771	393	0	1	49	343	132	211
PCT9211	MV	730	308	0	0	41	267	121	146
PCT9211	ED	161	132	0	0	19	113	39	74
PCT9211	TO	891	440	0	0	60	380	160	220
PCT9212	MV	671	278	0	1	35	242	95	147
PCT9212	ED	137	114	0	0	23	91	39	52
PCT9212	TO	808	392	0	1	58	333	134	199
PCT9213	MV	776	342	0	0	42	300	142	158
PCT9213	ED	161	130	0	0	20	110	60	50
PCT9213	TO	937	472	0	0	62	410	202	208
PCT9214	MV	517	232	0	0	22	210	96	114
PCT9214	ED	110	103	0	0	20	83	24	59
PCT9214	TO	627	335	0	0	42	293	120	173
PCT9215	MV	524	240	0	0	22	218	91	127
PCT9215	ED	120	100	0	0	15	85	24	61
PCT9215	TO	644	340	0	0	37	303	115	188
PCT9216	MV	669	260	0	0	42	218	83	135
PCT9216	ED	155	125	0	0	14	111	59	52
PCT9216	TO	824	385	0	0	56	329	142	187
PCT9217	MV	587	263	0	0	22	241	109	132
PCT9217	ED	118	87	0	0	7	80	38	42
PCT9217	TO	705	350	0	0	29	321	147	174
PCT9218	MV	652	275	0	0	34	241	110	131
PCT9218	ED	164	112	0	0	10	102	40	62
PCT9218	TO	816	387	0	0	44	343	150	193
PCT9219	MV	646	285	0	0	41	244	127	117
PCT9219	ED	144	116	0	0	11	105	56	49
PCT9219	TO	790	401	0	0	52	349	183	166
PCT9221	MV	562	318	0	0	26	292	84	208
PCT9221	ED	89	99	0	0	13	86	21	65
PCT9221	TO	651	417	0	0	39	378	105	273
PCT9222	MV	773	365	0	0	39	326	107	219
PCT9222	ED	137	116	0	0	12	104	40	64
PCT9222	TO	910	481	0	0	51	430	147	283
PCT9223	MV	558	264	0	0	28	236	77	159
PCT9223	ED	109	59	0	0	9	50	17	33
PCT9223	TO	667	323	0	0	37	286	94	192
PCT9224	MV	768	376	0	0	34	342	134	208
PCT9224	ED	181	151	0	0	24	127	54	73
PCT9224	TO	949	527	0	0	58	469	188	281
PCT9225	MV	757	301	0	0	37	264	121	143
PCT9225	ED	169	156	0	0	24	132	59	73
PCT9225	TO	926	457	0	0	61	396	180	216
PCT9226	MV	741	350	0	0	48	302	111	191
PCT9226	ED	155	143	0	0	14	129	61	68
PCT9226	TO	896	493	0	0	62	431	172	259
PCT9227	MV	605	363	0	0	41	322	108	214
PCT9227	ED	124	114	0	0	7	107	39	68
PCT9227	TO	729	477	0	0	48	429	147	282
PCT9228	MV	577	306	0	0	27	279	89	190
PCT9228	ED	161	141	0	0	19	122	43	79
PCT9228	TO	738	447	0	0	46	401	132	269
PCT9229	MV	460	252	0	0	33	219	87	132
PCT9229	ED	119	106	0	0	10	96	36	60
PCT9229	TO	579	358	0	0	43	315	123	192
PCT9231	MV	726	340	0	0	31	309	134	175
PCT9231	ED	236	208	0	0	28	180	94	86
PCT9231	TO	962	548	0	0	59	489	228	261
PCT9232	MV	608	288	0	0	33	255	91	164
PCT9232	ED	126	140	0	0	15	125	59	66
PCT9232	TO	734	428	0	0	48	380	150	230
PCT9233	MV	668	317	0	0	41	276	76	200
PCT9233	ED	150	141	0	0	18	123	43	80
PCT9233	TO	818	458	0	0	59	399	119	280
PCT9234	MV	643	306	0	0	27	279	117	162
PCT9234	ED	91	112	0	0	17	95	39	56
PCT9234	TO	734	418	0	0	44	374	156	218
PCT9235	MV	703	356	0	1	35	320	88	232
PCT9235	ED	160	140	0	0	14	126	40	86
PCT9235	TO	863	496	0	1	49	446	128	318
PCT9236	MV	537	274	0	0	27	247	104	143
PCT9236	ED	136	101	0	0	14	87	32	55
PCT9236	TO	673	375	0	0	41	334	136	198
PCT9237	MV	779	388	0	2	42	344	124	220
PCT9237	ED	118	134	0	0	18	116	56	60
PCT9237	TO	897	522	0	2	60	460	180	280
PCT9238	MV	687	325	0	0	40	285	99	186
PCT9238	ED	118	118	0	0	17	101	45	56
PCT9238	TO	805	443	0	0	57	386	144	242
PCT9239	MV	740	383	0	0	55	328	123	205
PCT9239	ED	124	117	0	0	16	101	34	67
PCT9239	TO	864	500	0	0	71	429	157	272
PCT9241	MV	819	394	0	0	38	356	144	212
PCT9241	ED	141	139	0	0	16	123	53	70
PCT9241	TO	960	533	0	0	54	479	197	282
PCT9242	MV	771	341	0	0	45	296	128	168
PCT9242	ED	172	155	0	0	20	135	77	58
PCT9242	TO	943	496	0	0	65	431	205	226
PCT9243	MV	480	239	0	0	31	208	88	120
PCT9243	ED	123	113	0	0	16	97	53	44
PCT9243	TO	603	352	0	0	47	305	141	164
PCT9244	MV	755	390	0	0	56	334	143	191
PCT9244	ED	155	121	0	0	12	109	60	49
PCT9244	TO	910	511	0	0	68	443	203	240
PCT9245	MV	616	292	0	0	43	249	108	141
PCT9245	ED	98	91	0	0	9	82	38	44
PCT9245	TO	714	383	0	0	52	331	146	185
PCT9246	MV	815	425	0	0	41	384	166	218
PCT9246	ED	155	140	0	0	26	114	54	60
PCT9246	TO	970	565	0	0	67	498	220	278
PCT9247	MV	764	376	0	0	37	339	156	183
PCT9247	ED	148	156	0	0	25	131	68	63
PCT9247	TO	912	532	0	0	62	470	224	246
PCT9248	MV	757	354	0	0	41	313	162	151
PCT9248	ED	150	145	0	0	17	128	78	50
PCT9248	TO	907	499	0	0	58	441	240	201
PCT9249	MV	724	369	0	0	45	324	156	168
PCT9249	ED	191	171	0	0	19	152	72	80
PCT9249	TO	915	540	0	0	64	476	228	248
PCT9251	MV	792	389	0	0	47	342	161	181
PCT9251	ED	174	179	0	0	18	161	77	84
PCT9251	TO	966	568	0	0	65	503	238	265
PCT9252	MV	810	374	0	0	43	331	160	171
PCT9252	ED	143	127	0	0	7	120	58	62
PCT9252	TO	953	501	0	0	50	451	218	233
PCT9253	MV	599	295	0	0	26	269	112	157
PCT9253	ED	162	116	0	0	13	103	64	39
PCT9253	TO	761	411	0	0	39	372	176	196
PCT9254	MV	758	403	0	0	36	367	162	205
PCT9254	ED	163	155	0	0	24	131	70	61
PCT9254	TO	921	558	0	0	60	498	232	266
PCT9255	MV	436	194	0	0	30	164	87	77
PCT9255	ED	114	112	0	0	17	95	53	42
PCT9255	TO	550	306	0	0	47	259	140	119
PCT9256	MV	367	166	0	0	17	149	74	75
PCT9256	ED	95	74	0	0	9	65	34	31
PCT9256	TO	462	240	0	0	26	214	108	106
PCT9257	MV	359	157	0	0	21	136	93	43
PCT9257	ED	-39	0	0	0	0	0	0	0
PCT9257	TO	320	157	0	0	21	136	93	43
PCT9258	MV	583	301	0	0	32	269	135	134
PCT9258	ED	120	103	0	0	13	90	47	43
PCT9258	TO	703	404	0	0	45	359	182	177
PCT9401	MV	794	354	0	0	27	327	217	110
PCT9401	ED	244	176	0	0	14	162	124	38
PCT9401	TO	1038	530	0	0	41	489	341	148
PCT9402	MV	774	369	0	0	37	332	208	124
PCT9402	ED	243	159	0	0	12	147	95	52
PCT9402	TO	1017	528	0	0	49	479	303	176
PCT9403	MV	731	338	0	0	20	318	187	131
PCT9403	ED	190	123	0	0	12	111	79	32
PCT9403	TO	921	461	0	0	32	429	266	163
PCT9404	MV	752	344	0	0	28	316	171	145
PCT9404	ED	192	154	0	0	18	136	85	51
PCT9404	TO	944	498	0	0	46	452	256	196
PCT9405	MV	628	275	0	1	34	240	127	113
PCT9405	ED	152	104	0	0	5	99	58	41
PCT9405	TO	780	379	0	1	39	339	185	154
PCT9406	MV	694	323	0	0	31	292	163	129
PCT9406	ED	189	150	0	0	11	139	70	69
PCT9406	TO	883	473	0	0	42	431	233	198
PCT9407	MV	712	363	0	0	32	331	179	152
PCT9407	ED	201	131	0	0	23	108	61	47
PCT9407	TO	913	494	0	0	55	439	240	199
PCT9408	MV	709	310	0	0	36	274	177	97
PCT9408	ED	154	125	0	0	10	115	77	38
PCT9408	TO	863	435	0	0	46	389	254	135
PCT9409	MV	443	220	0	0	21	199	118	81
PCT9409	ED	158	127	0	0	9	118	83	35
PCT9409	TO	601	347	0	0	30	317	201	116
PCT9411	MV	816	364	0	0	33	331	218	113
PCT9411	ED	191	135	0	0	10	125	85	40
PCT9411	TO	1007	499	0	0	43	456	303	153
PCT9412	MV	668	335	0	0	31	304	160	144
PCT9412	ED	202	138	0	0	14	124	75	49
PCT9412	TO	870	473	0	0	45	428	235	193
PCT9413	MV	757	366	0	0	48	318	176	142
PCT9413	ED	179	127	0	0	11	116	76	40
PCT9413	TO	936	493	0	0	59	434	252	182
PCT9414	MV	734	358	0	0	43	315	163	152
PCT9414	ED	186	107	0	0	10	97	49	48
PCT9414	TO	920	465	0	0	53	412	212	200
PCT9415	MV	634	307	0	0	24	283	139	144
PCT9415	ED	154	96	0	0	8	88	53	35
PCT9415	TO	788	403	0	0	32	371	192	179
PCT9416	MV	768	382	0	0	55	327	160	167
PCT9416	ED	231	143	0	0	13	130	70	60
PCT9416	TO	999	525	0	0	68	457	230	227
PCT9417	MV	628	317	0	0	34	283	146	137
PCT9417	ED	146	110	0	0	7	103	60	43
PCT9417	TO	774	427	0	0	41	386	206	180
PCT9418	MV	627	304	0	0	34	270	116	154
PCT9418	ED	192	122	0	0	10	112	71	41
PCT9418	TO	819	426	0	0	44	382	187	195
PCT9419	MV	736	363	0	0	38	325	135	190
PCT9419	ED	173	107	0	0	10	97	43	54
PCT9419	TO	909	470	0	0	48	422	178	244
PCT9421	MV	752	330	0	0	33	297	137	160
PCT9421	ED	173	112	0	0	9	103	54	49
PCT9421	TO	925	442	0	0	42	400	191	209
PCT9422	MV	831	406	0	0	40	366	192	174
PCT9422	ED	270	145	0	0	17	128	77	51
PCT9422	TO	1101	551	0	0	57	494	269	225
PCT9423	MV	711	309	0	0	33	276	139	137
PCT9423	ED	193	121	0	0	11	110	62	48
PCT9423	TO	904	430	0	0	44	386	201	185
PCT9424	MV	797	379	0	0	37	342	170	172
PCT9424	ED	212	114	0	0	12	102	60	42
PCT9424	TO	1009	493	0	0	49	444	230	214
PCT9425	MV	789	339	0	0	47	292	154	138
PCT9425	ED	187	114	0	0	14	100	63	37
PCT9425	TO	976	453	0	0	61	392	217	175
PCT9426	MV	696	317	0	0	31	286	136	150
PCT9426	ED	157	104	0	0	17	87	40	47
PCT9426	TO	853	421	0	0	48	373	176	197
PCT9427	MV	797	377	0	0	32	345	147	198
PCT9427	ED	190	115	0	0	19	96	51	45
PCT9427	TO	987	492	0	0	51	441	198	243
PCT9428	MV	809	343	0	0	34	309	156	153
PCT9428	ED	181	113	0	0	13	100	59	41
PCT9428	TO	990	456	0	0	47	409	215	194
PCT9429	MV	707	339	0	0	34	305	139	166
PCT9429	ED	199	124	0	0	18	106	53	53
PCT9429	TO	906	463	0	0	52	411	192	219
PCT9431	MV	831	408	0	0	45	363	147	216
PCT9431	ED	205	125	0	0	9	116	66	50
PCT9431	TO	1036	533	0	0	54	479	213	266
PCT9432	MV	742	352	0	0	44	308	157	151
PCT9432	ED	216	117	0	0	13	104	53	51
PCT9432	TO	958	469	0	0	57	412	210	202
PCT9433	MV	792	372	0	0	44	328	156	172
PCT9433	ED	166	93	0	0	9	84	34	50
PCT9433	TO	958	465	0	0	53	412	190	222
PCT9434	MV	780	384	0	0	38	346	171	175
PCT9434	ED	232	162	0	0	21	141	81	60
PCT9434	TO	1012	546	0	0	59	487	252	235
PCT9435	MV	776	364	0	0	38	326	154	172
PCT9435	ED	228	157	0	0	10	147	97	50
PCT9435	TO	1004	521	0	0	48	473	251	222
PCT9436	MV	840	379	0	0	27	352	149	203
PCT9436	ED	228	129	0	0	15	114	53	61
PCT9436	TO	1068	508	0	0	42	466	202	264
PCT9437	MV	735	369	0	0	33	336	156	180
PCT9437	ED	192	130	0	0	9	121	75	46
PCT9437	TO	927	499	0	0	42	457	231	226
PCT9438	MV	836	410	0	0	37	373	163	210
PCT9438	ED	153	83	0	0	6	77	41	36
PCT9438	TO	989	493	0	0	43	450	204	246
PCT9439	MV	718	337	0	0	25	312	131	181
PCT9439	ED	199	111	0	0	15	96	52	44
PCT9439	TO	917	448	0	0	40	408	183	225
PCT9441	MV	773	390	0	0	42	348	203	145
PCT9441	ED	198	125	0	0	18	107	67	40
PCT9441	TO	971	515	0	0	60	455	270	185
PCT9442	MV	827	370	0	0	44	326	184	142
PCT9442	ED	213	156	0	0	14	142	79	63
PCT9442	TO	1040	526	0	0	58	468	263	205
PCT9443	MV	759	353	0	0	35	318	173	145
PCT9443	ED	196	109	0	1	10	98	58	40
PCT9443	TO	955	462	0	1	45	416	231	185
PCT9444	MV	764	332	0	0	22	310	144	166
PCT9444	ED	201	94	0	0	12	82	45	37
PCT9444	TO	965	426	0	0	34	392	189	203
PCT9445	MV	824	399	0	0	38	361	174	187
PCT9445	ED	172	113	0	0	10	103	58	45
PCT9445	TO	996	512	0	0	48	464	232	232
PCT9446	MV	900	461	0	0	50	411	196	215
PCT9446	ED	216	145	0	0	16	129	71	58
PCT9446	TO	1116	606	0	0	66	540	267	273
PCT9447	MV	728	387	0	0	28	359	161	198
PCT9447	ED	193	143	0	0	13	130	64	66
PCT9447	TO	921	530	0	0	41	489	225	264
PCT9448	MV	740	338	0	0	31	307	152	155
PCT9448	ED	200	127	0	0	12	115	72	43
PCT9448	TO	940	465	0	0	43	422	224	198
PCT9449	MV	717	337	0	1	37	299	144	155
PCT9449	ED	164	96	0	1	9	86	45	41
PCT9449	TO	881	433	0	2	46	385	189	196
PCT9451	MV	353	176	0	0	17	159	73	86
PCT9451	ED	88	54	0	0	5	49	29	20
PCT9451	TO	441	230	0	0	22	208	102	106
PCT9452	MV	647	327	0	0	32	295	143	152
PCT9452	ED	195	134	0	0	14	120	54	66
PCT9452	TO	842	461	0	0	46	415	197	218
PCT9453	MV	409	216	0	0	19	197	83	114
PCT9453	ED	115	70	0	0	7	63	27	36
PCT9453	TO	524	286	0	0	26	260	110	150
PCT9501	MV	158	92	0	1	12	79	49	30
PCT9501	ED	-8	0	0	0	0	0	0	0
PCT9501	TO	150	92	0	1	12	79	49	30
PCT9502	MV	294	133	0	0	19	114	69	45
PCT9502	ED	-43	0	0	0	0	0	0	0
PCT9502	TO	251	133	0	0	19	114	69	45
PCT9503	MV	550	259	0	0	38	221	125	96
PCT9503	ED	150	82	0	0	7	75	47	28
PCT9503	TO	700	341	0	0	45	296	172	124
PCT9505	MV	589	291	0	0	33	258	174	84
PCT9505	ED	176	110	0	0	10	100	57	43
PCT9505	TO	765	401	0	0	43	358	231	127
PCT9506	MV	547	229	0	0	17	212	116	96
PCT9506	ED	207	128	0	0	16	112	81	31
PCT9506	TO	754	357	0	0	33	324	197	127
PCT9507	MV	556	301	0	1	28	272	160	112
PCT9507	ED	160	152	0	0	17	135	79	56
PCT9507	TO	716	453	0	1	45	407	239	168
PCT9508	MV	632	306	0	0	22	284	190	94
PCT9508	ED	148	132	0	0	10	122	80	42
PCT9508	TO	780	438	0	0	32	406	270	136
PCT9509	MV	585	294	0	0	22	272	146	126
PCT9509	ED	142	121	0	0	8	113	80	33
PCT9509	TO	727	415	0	0	30	385	226	159
PCT9511	MV	457	235	0	0	17	218	128	90
PCT9511	ED	177	120	0	0	10	110	66	44
PCT9511	TO	634	355	0	0	27	328	194	134
PCT9512	MV	617	319	0	0	32	287	175	112
PCT9512	ED	160	132	0	0	10	122	80	42
PCT9512	TO	777	451	0	0	42	409	255	154
PCT9513	MV	686	323	0	0	35	288	184	104
PCT9513	ED	191	126	0	0	11	115	84	31
PCT9513	TO	877	449	0	0	46	403	268	135
PCT9514	MV	713	347	0	0	40	307	171	136
PCT9514	ED	183	167	0	0	19	148	104	44
PCT9514	TO	896	514	0	0	59	455	275	180
PCT9515	MV	542	293	0	0	28	265	142	123
PCT9515	ED	170	133	0	0	14	119	68	51
PCT9515	TO	712	426	0	0	42	384	210	174
PCT9516	MV	705	357	0	0	30	327	201	126
PCT9516	ED	184	157	0	0	13	144	83	61
PCT9516	TO	889	514	0	0	43	471	284	187
PCT9517	MV	625	333	0	0	23	310	178	132
PCT9517	ED	163	135	0	0	22	113	82	31
PCT9517	TO	788	468	0	0	45	423	260	163
PCT9518	MV	641	312	0	0	28	284	179	105
PCT9518	ED	147	146	0	0	10	136	91	45
PCT9518	TO	788	458	0	0	38	420	270	150
PCT9519	MV	693	361	0	0	29	332	198	134
PCT9519	ED	198	170	0	0	14	156	98	58
PCT9519	TO	891	531	0	0	43	488	296	192
PCT9521	MV	687	348	0	0	28	320	186	134
PCT9521	ED	214	190	0	0	19	171	108	63
PCT9521	TO	901	538	0	0	47	491	294	197
PCT9701	MV	498	266	0	0	25	241	141	100
PCT9701	ED	156	135	0	0	9	126	80	46
PCT9701	TO	654	401	0	0	34	367	221	146
PCT9702	MV	553	296	0	0	25	271	141	130
PCT9702	ED	167	143	0	0	10	133	82	51
PCT9702	TO	720	439	0	0	35	404	223	181
PCT9703	MV	808	398	0	0	47	351	181	170
PCT9703	ED	183	142	0	0	13	129	72	57
PCT9703	TO	991	540	0	0	60	480	253	227
PCT9704	MV	759	417	0	0	44	373	169	204
PCT9704	ED	200	196	0	0	20	176	109	67
PCT9704	TO	959	613	0	0	64	549	278	271
PCT9705	MV	753	403	0	0	38	365	180	185
PCT9705	ED	176	142	0	0	14	128	76	52
PCT9705	TO	929	545	0	0	52	493	256	237
PCT9706	MV	57	33	0	0	1	32	16	16
PCT9706	ED	-8	0	0	0	0	0	0	0
PCT9706	TO	49	33	0	0	1	32	16	16
PCT9707	MV	687	352	0	0	25	327	133	194
PCT9707	ED	139	101	0	0	11	90	42	48
PCT9707	TO	826	453	0	0	36	417	175	242
PCT9708	MV	786	425	0	0	55	370	203	167
PCT9708	ED	175	157	0	0	15	142	85	57
PCT9708	TO	961	582	0	0	70	512	288	224
PCT9709	MV	831	418	0	0	44	374	163	211
PCT9709	ED	209	178	0	0	14	164	89	75
PCT9709	TO	1040	596	0	0	58	538	252	286
PCT9711	MV	502	306	0	0	34	272	133	139
PCT9711	ED	144	138	0	0	14	124	57	67
PCT9711	TO	646	444	0	0	48	396	190	206
PCT9712	MV	534	327	0	0	33	294	112	182
PCT9712	ED	127	116	0	0	7	109	51	58
PCT9712	TO	661	443	0	0	40	403	163	240
PCT9713	MV	746	384	0	0	31	353	156	197
PCT9713	ED	204	137	0	0	14	123	68	55
PCT9713	TO	950	521	0	0	45	476	224	252
PCT9714	MV	795	436	0	0	41	395	148	247
PCT9714	ED	156	133	0	0	8	125	58	67
PCT9714	TO	951	569	0	0	49	520	206	314
PCT9715	MV	449	237	0	0	27	210	62	148
PCT9715	ED	130	134	0	0	8	126	42	84
PCT9715	TO	579	371	0	0	35	336	104	232
PCT9716	MV	744	394	0	0	40	354	157	197
PCT9716	ED	222	164	0	0	18	146	73	73
PCT9716	TO	966	558	0	0	58	500	230	270
PCT9717	MV	753	424	0	0	36	388	144	244
PCT9717	ED	224	144	0	0	15	129	58	71
PCT9717	TO	977	568	0	0	51	517	202	315
PCT9718	MV	742	443	0	0	35	408	178	230
PCT9718	ED	159	144	0	0	12	132	56	76
PCT9718	TO	901	587	0	0	47	540	234	306
PCT9719	MV	747	451	0	0	41	410	154	256
PCT9719	ED	173	150	0	0	8	142	59	83
PCT9719	TO	920	601	0	0	49	552	213	339
PCT9721	MV	498	284	0	0	28	256	95	161
PCT9721	ED	164	133	0	0	8	125	46	79
PCT9721	TO	662	417	0	0	36	381	141	240
PCT9722	MV	513	311	0	0	25	286	125	161
PCT9722	ED	84	76	0	0	9	67	29	38
PCT9722	TO	597	387	0	0	34	353	154	199
PCT9723	MV	434	219	0	0	15	204	56	148
PCT9723	ED	74	44	0	0	4	40	10	30
PCT9723	TO	508	263	0	0	19	244	66	178
PCT9724	MV	848	450	0	0	38	412	125	287
PCT9724	ED	172	99	0	0	7	92	39	53
PCT9724	TO	1020	549	0	0	45	504	164	340
PCT9725	MV	806	431	0	0	35	396	158	238
PCT9725	ED	165	95	0	0	11	84	25	59
PCT9725	TO	971	526	0	0	46	480	183	297
PCT9726	MV	565	214	0	0	26	188	125	63
PCT9726	ED	51	102	0	0	9	93	59	34
PCT9726	TO	616	316	0	0	35	281	184	97
PCT9727	MV	403	220	0	2	19	199	70	129
PCT9727	ED	57	33	0	0	5	28	8	20
PCT9727	TO	460	253	0	2	24	227	78	149
PCT9728	MV	750	441	0	0	34	407	114	293
PCT9728	ED	213	137	0	0	16	121	45	76
PCT9728	TO	963	578	0	0	50	528	159	369
PCT9729	MV	654	331	0	0	27	304	81	223
PCT9729	ED	164	128	0	0	6	122	38	84
PCT9729	TO	818	459	0	0	33	426	119	307
PCT9731	MV	436	238	0	0	23	215	70	145
PCT9731	ED	143	111	0	0	7	104	32	72
PCT9731	TO	579	349	0	0	30	319	102	217
PCT9732	MV	78	47	0	0	4	43	17	26
PCT9732	ED	-5	0	0	0	0	0	0	0
PCT9732	TO	73	47	0	0	4	43	17	26
PCT9733	MV	261	154	0	0	7	147	75	72
PCT9733	ED	-21	0	0	0	0	0	0	0
PCT9733	TO	240	154	0	0	7	147	75	72
PCT9734	MV	473	283	0	0	21	262	97	165
PCT9734	ED	131	109	0	0	9	100	34	66
PCT9734	TO	604	392	0	0	30	362	131	231
PCT9735	MV	650	384	0	0	32	352	139	213
PCT9735	ED	170	132	0	0	16	116	46	70
PCT9735	TO	820	516	0	0	48	468	185	283
PCT9736	MV	586	318	0	0	26	292	114	178
PCT9736	ED	150	151	0	0	13	138	63	75
PCT9736	TO	736	469	0	0	39	430	177	253
PCT9737	MV	636	383	0	0	37	346	160	186
PCT9737	ED	155	135	0	1	7	127	64	63
PCT9737	TO	791	518	0	1	44	473	224	249
PCT9738	MV	687	311	0	0	32	279	175	104
PCT9738	ED	151	64	0	0	5	59	30	29
PCT9738	TO	838	375	0	0	37	338	205	133
PCT9739	MV	639	263	0	0	15	248	176	72
PCT9739	ED	150	88	0	0	6	82	70	12
PCT9739	TO	789	351	0	0	21	330	246	84
PCT9741	MV	508	168	0	0	22	146	123	23
PCT9741	ED	-67	10	0	0	2	8	6	2
PCT9741	TO	441	178	0	0	24	154	129	25
PCT9742	MV	529	222	0	0	12	210	79	131
PCT9742	ED	166	98	0	0	9	89	39	50
PCT9742	TO	695	320	0	0	21	299	118	181
PCT9743	MV	898	393	0	0	31	362	220	142
PCT9743	ED	242	170	0	0	19	151	114	37
PCT9743	TO	1140	563	0	0	50	513	334	179
PCT9744	MV	752	328	0	0	40	288	188	100
PCT9744	ED	191	121	0	0	16	105	73	32
PCT9744	TO	943	449	0	0	56	393	261	132
PCT9745	MV	755	313	0	0	34	279	194	85
PCT9745	ED	237	128	0	0	12	116	80	36
PCT9745	TO	992	441	0	0	46	395	274	121
PCT9746	MV	712	365	0	0	16	349	144	205
PCT9746	ED	191	118	0	0	11	107	44	63
PCT9746	TO	903	483	0	0	27	456	188	268
PCT9747	MV	768	393	0	0	35	358	185	173
PCT9747	ED	208	145	0	0	13	132	68	64
PCT9747	TO	976	538	0	0	48	490	253	237
PCT9748	MV	746	420	0	0	38	382	177	205
PCT9748	ED	167	116	0	0	11	105	54	51
PCT9748	TO	913	536	0	0	49	487	231	256
PCT9749	MV	749	281	0	0	18	263	166	97
PCT9749	ED	189	108	0	0	9	99	63	36
PCT9749	TO	938	389	0	0	27	362	229	133
PCT9751	MV	856	463	0	0	46	417	186	231
PCT9751	ED	215	151	0	0	17	134	65	69
PCT9751	TO	1071	614	0	0	63	551	251	300
PCT9752	MV	563	323	0	0	25	298	139	159
PCT9752	ED	134	108	0	0	9	99	51	48
PCT9752	TO	697	431	0	0	34	397	190	207
PCT9753	MV	617	293	0	0	22	271	151	120
PCT9753	ED	145	123	0	0	3	120	67	53
PCT9753	TO	762	416	0	0	25	391	218	173
PCT9754	MV	544	316	0	0	25	291	180	111
PCT9754	ED	163	113	0	0	9	104	62	42
PCT9754	TO	707	429	0	0	34	395	242	153
PCT9755	MV	441	238	0	0	25	213	117	96
PCT9755	ED	139	99	0	0	7	92	42	50
PCT9755	TO	580	337	0	0	32	305	159	146
PCT9756	MV	801	362	0	0	33	329	165	164
PCT9756	ED	166	106	0	0	10	96	57	39
PCT9756	TO	967	468	0	0	43	425	222	203
PCT9801	MV	320	158	0	0	17	141	81	60
PCT9801	ED	88	52	0	0	5	47	24	23
PCT9801	TO	408	210	0	0	22	188	105	83
PCT9900	MV	0	0	0	0	0	0	0	0
PCT9900	ED	0	0	0	0	0	0	0	0
PCT9900	TO	0	0	0	0	0	0	0	0
PCT9901	MV	0	0	0	0	0	0	0	0
PCT9901	ED	0	0	0	0	0	0	0	0
PCT9901	TO	0	0	0	0	0	0	0	0
PCT9902	MV	0	0	0	0	0	0	0	0
PCT9902	ED	0	0	0	0	0	0	0	0
PCT9902	TO	0	0	0	0	0	0	0	0
CONG12	MV	355422	171399	0	36	16744	154619	82478	72141
CONG12	ED	90426	65251	0	12	6588	58651	34709	23942
CONG12	TO	445848	236650	0	48	23332	213270	117187	96083
CONG14	MV	46630	21987	0	5	1853	20129	10106	10023
CONG14	ED	11421	6926	0	1	607	6318	3442	2876
CONG14	TO	58051	28913	0	6	2460	26447	13548	12899
ASSM17	MV	232714	112342	0	26	10650	101666	56079	45587
ASSM17	ED	59708	41964	0	8	4113	37843	23141	14702
ASSM17	TO	292422	154306	0	34	14763	139509	79220	60289
ASSM19	MV	169338	81044	0	15	7947	73082	36505	36577
ASSM19	ED	42139	30213	0	5	3082	27126	15010	12116
ASSM19	TO	211477	111257	0	20	11029	100208	51515	48693
SUPV1	MV	33848	16279	0	0	1573	14706	8085	6621
SUPV1	ED	9268	6893	0	1	670	6222	3738	2484
SUPV1	TO	43116	23172	0	1	2243	20928	11823	9105
SUPV2	MV	41429	19608	0	6	2281	17321	7305	10016
SUPV2	ED	8617	7551	0	1	979	6571	3037	3534
SUPV2	TO	50046	27159	0	7	3260	23892	10342	13550
SUPV3	MV	31930	14092	0	3	1485	12604	6703	5901
SUPV3	ED	7447	5109	0	1	575	4533	2646	1887
SUPV3	TO	39377	19201	0	4	2060	17137	9349	7788
SUPV4	MV	34985	16592	0	2	1653	14937	7544	7393
SUPV4	ED	9109	5869	0	2	584	5283	3054	2229
SUPV4	TO	44094	22461	0	4	2237	20220	10598	9622
SUPV5	MV	41957	21096	0	5	2065	19026	11150	7876
SUPV5	ED	10943	8955	0	1	891	8063	5138	2925
SUPV5	TO	52900	30051	0	6	2956	27089	16288	10801
SUPV6	MV	35745	14963	0	6	1500	13457	7274	6183
SUPV6	ED	7950	4327	0	2	498	3827	2346	1481
SUPV6	TO	43695	19290	0	8	1998	17284	9620	7664
SUPV7	MV	38328	20392	0	2	1843	18547	8639	9908
SUPV7	ED	9115	7178	0	1	622	6555	3307	3248
SUPV7	TO	47443	27570	0	3	2465	25102	11946	13156
SUPV8	MV	46363	26976	0	7	2471	24498	13149	11349
SUPV8	ED	11814	11078	0	0	1040	10038	5955	4083
SUPV8	TO	58177	38054	0	7	3511	34536	19104	15432
SUPV9	MV	33157	16480	0	3	1295	15182	9186	5996
SUPV9	ED	10106	7052	0	3	574	6475	4353	2122
SUPV9	TO	43263	23532	0	6	1869	21657	13539	8118
SUPV10	MV	33748	13671	0	4	1313	12354	6717	5637
SUPV10	ED	9365	4180	0	0	398	3782	2272	1510
SUPV10	TO	43113	17851	0	4	1711	16136	8989	7147
SUPV11	MV	30562	13237	0	3	1118	12116	6832	5284
SUPV11	ED	8113	3985	0	1	364	3620	2305	1315
SUPV11	TO	38675	17222	0	4	1482	15736	9137	6599
NEIG1	MV	15456	5842	0	1	580	5261	2918	2343
NEIG1	ED	5029	1543	0	0	142	1401	850	551
NEIG1	TO	20485	7385	0	1	722	6662	3768	2894
NEIG2	MV	14025	6157	0	1	713	5443	2793	2650
NEIG2	ED	3242	2161	0	0	270	1891	1051	840
NEIG2	TO	17267	8318	0	1	983	7334	3844	3490
NEIG3	MV	22038	9268	0	4	935	8329	5083	3246
NEIG3	ED	5981	3247	0	1	338	2908	1959	949
NEIG3	TO	28019	12515	0	5	1273	11237	7042	4195
NEIG4	MV	5628	3436	0	0	324	3112	1559	1553
NEIG4	ED	1432	1236	0	0	132	1104	564	540
NEIG4	TO	7060	4672	0	0	456	4216	2123	2093
NEIG5	MV	22668	9994	0	3	886	9105	5083	4022
NEIG5	ED	5925	2958	0	1	275	2682	1670	1012
NEIG5	TO	28593	12952	0	4	1161	11787	6753	5034
NEIG6	MV	11525	5835	0	1	546	5288	3115	2173
NEIG6	ED	2337	2735	0	1	263	2471	1542	929
NEIG6	TO	13862	8570	0	2	809	7759	4657	3102
NEIG7	MV	9764	4044	0	0	300	3744	2161	1583
NEIG7	ED	2631	1293	0	0	113	1180	779	401
NEIG7	TO	12395	5337	0	0	413	4924	2940	1984
NEIG8	MV	7624	3949	0	0	361	3588	2050	1538
NEIG8	ED	2034	1820	0	0	173	1647	1026	621
NEIG8	TO	9658	5769	0	0	534	5235	3076	2159
NEIG9	MV	6892	3090	0	0	288	2802	1540	1262
NEIG9	ED	1366	921	0	0	91	830	506	324
NEIG9	TO	8258	4011	0	0	379	3632	2046	1586
NEIG10	MV	8170	3814	0	1	400	3413	1784	1629
NEIG10	ED	1852	1658	0	1	168	1489	861	628
NEIG10	TO	10022	5472	0	2	568	4902	2645	2257
NEIG11	MV	33505	15264	0	5	1816	13443	5752	7691
NEIG11	ED	5935	5701	0	1	779	4921	2309	2612
NEIG11	TO	39440	20965	0	6	2595	18364	8061	10303
NEIG12	MV	23568	11636	0	0	873	10763	6642	4121
NEIG12	ED	7437	5267	0	2	428	4837	3346	1491
NEIG12	TO	31005	16903	0	2	1301	15600	9988	5612
NEIG14	MV	6790	3923	0	2	347	3574	2175	1399
NEIG14	ED	1943	1783	0	1	155	1627	1079	548
NEIG14	TO	8733	5706	0	3	502	5201	3254	1947
NEIG15	MV	5778	2610	0	0	240	2370	1160	1210
NEIG15	ED	1310	1007	0	0	110	897	486	411
NEIG15	TO	7088	3617	0	0	350	3267	1646	1621
NEIG13	MV	13551	7997	0	5	752	7240	3739	3501
NEIG13	ED	3437	3361	0	0	301	3060	1751	1309
NEIG13	TO	16988	11358	0	5	1053	10300	5490	4810
NEIG26	MV	7828	3472	0	1	298	3173	1669	1504
NEIG26	ED	1804	941	0	0	88	853	509	344
NEIG26	TO	9632	4413	0	1	386	4026	2178	1848
NEIG16	MV	14619	6688	0	4	668	6016	3080	2936
NEIG16	ED	2737	2400	0	1	257	2142	1262	880
NEIG16	TO	17356	9088	0	5	925	8158	4342	3816
NEIG17	MV	29430	14222	0	0	1381	12841	7081	5760
NEIG17	ED	8195	5965	0	0	577	5388	3232	2156
NEIG17	TO	37625	20187	0	0	1958	18229	10313	7916
NEIG19	MV	7162	3939	0	0	326	3613	2110	1503
NEIG19	ED	2409	1863	0	0	162	1701	1026	675
NEIG19	TO	9571	5802	0	0	488	5314	3136	2178
NEIG18	MV	6455	3322	0	1	344	2977	1147	1830
NEIG18	ED	1566	1453	0	0	165	1288	568	720
NEIG18	TO	8021	4775	0	1	509	4265	1715	2550
NEIG20	MV	20904	8767	0	3	866	7898	3974	3924
NEIG20	ED	4173	2417	0	1	279	2137	1200	937
NEIG20	TO	25077	11184	0	4	1145	10035	5174	4861
NEIG21	MV	34542	16372	0	2	1632	14738	7426	7312
NEIG21	ED	8951	5742	0	2	575	5165	2971	2194
NEIG21	TO	43493	22114	0	4	2207	19903	10397	9506
NEIG22	MV	15378	9122	0	1	825	8296	4466	3830
NEIG22	ED	3515	3598	0	0	332	3266	1985	1281
NEIG22	TO	18893	12720	0	1	1157	11562	6451	5111
NEIG23	MV	6633	2470	0	0	224	2246	1218	1028
NEIG23	ED	1855	598	0	0	57	541	323	218
NEIG23	TO	8488	3068	0	0	281	2787	1541	1246
NEIG24	MV	28412	15843	0	2	1438	14403	6350	8053
NEIG24	ED	6962	5659	0	1	484	5174	2462	2712
NEIG24	TO	35374	21502	0	3	1922	19577	8812	10765
NEIG25	MV	23707	12310	0	4	1234	11072	6509	4563
NEIG25	ED	7789	4850	0	0	481	4369	2834	1535
NEIG25	TO	31496	17160	0	4	1715	15441	9343	6098
