area_id	subtotal_type	RSReg	RSCst	RSRej	RSOvr	RSUnd	RSTot	11:YES	12:NO
ALLPCTS	TO	503899	144603	0	22	13444	131137	72613	58524
ALLPCTS	ED	102888	72177	0	13	7195	64969	38151	26818
ALLPCTS	MV	401011	72426	0	9	6249	66168	34462	31706
PCT1101	MV	446	89	0	0	13	76	45	31
PCT1101	ED	116	60	0	0	8	52	35	17
PCT1101	TO	562	149	0	0	21	128	80	48
PCT1102	MV	767	120	0	0	6	114	49	65
PCT1102	ED	237	158	0	0	12	146	86	60
PCT1102	TO	1004	278	0	0	18	260	135	125
PCT1103	MV	747	147	0	0	2	145	85	60
PCT1103	ED	224	142	0	0	11	131	75	56
PCT1103	TO	971	289	0	0	13	276	160	116
PCT1104	MV	750	122	0	0	5	117	70	47
PCT1104	ED	268	119	0	0	6	113	74	39
PCT1104	TO	1018	241	0	0	11	230	144	86
PCT1106	MV	595	93	0	0	7	86	44	42
PCT1106	ED	176	96	0	0	7	89	46	43
PCT1106	TO	771	189	0	0	14	175	90	85
PCT1107	MV	602	100	0	0	8	92	37	55
PCT1107	ED	149	76	0	0	9	67	35	32
PCT1107	TO	751	176	0	0	17	159	72	87
PCT1108	MV	718	117	0	0	10	107	59	48
PCT1108	ED	205	114	0	0	15	99	63	36
PCT1108	TO	923	231	0	0	25	206	122	84
PCT1109	MV	649	108	0	0	11	97	49	48
PCT1109	ED	173	97	0	0	8	89	54	35
PCT1109	TO	822	205	0	0	19	186	103	83
PCT1111	MV	841	150	0	0	13	137	80	57
PCT1111	ED	205	118	0	0	10	108	72	36
PCT1111	TO	1046	268	0	0	23	245	152	93
PCT1112	MV	641	100	0	0	6	94	51	43
PCT1112	ED	161	76	0	0	5	71	50	21
PCT1112	TO	802	176	0	0	11	165	101	64
PCT1113	MV	674	102	0	0	13	89	44	45
PCT1113	ED	121	65	0	0	8	57	38	19
PCT1113	TO	795	167	0	0	21	146	82	64
PCT1114	MV	766	102	0	0	4	98	61	37
PCT1114	ED	225	97	0	0	14	83	56	27
PCT1114	TO	991	199	0	0	18	181	117	64
PCT1115	MV	739	114	0	0	8	106	55	51
PCT1115	ED	197	85	0	0	7	78	51	27
PCT1115	TO	936	199	0	0	15	184	106	78
PCT1116	MV	702	141	0	0	12	129	81	48
PCT1116	ED	229	118	0	0	10	108	76	32
PCT1116	TO	931	259	0	0	22	237	157	80
PCT1117	MV	654	103	0	0	4	99	44	55
PCT1117	ED	192	71	0	0	4	67	52	15
PCT1117	TO	846	174	0	0	8	166	96	70
PCT1118	MV	841	123	0	0	8	115	62	53
PCT1118	ED	224	100	0	0	14	86	51	35
PCT1118	TO	1065	223	0	0	22	201	113	88
PCT1119	MV	658	114	0	0	6	108	62	46
PCT1119	ED	139	73	0	0	6	67	49	18
PCT1119	TO	797	187	0	0	12	175	111	64
PCT1121	MV	556	115	0	0	10	105	51	54
PCT1121	ED	149	81	0	0	8	73	44	29
PCT1121	TO	705	196	0	0	18	178	95	83
PCT1122	MV	518	67	0	0	7	60	30	30
PCT1122	ED	119	70	0	0	8	62	35	27
PCT1122	TO	637	137	0	0	15	122	65	57
PCT1123	MV	720	77	0	0	4	73	33	40
PCT1123	ED	218	89	0	0	5	84	67	17
PCT1123	TO	938	166	0	0	9	157	100	57
PCT1124	MV	616	96	0	0	5	91	47	44
PCT1124	ED	213	72	0	0	4	68	50	18
PCT1124	TO	829	168	0	0	9	159	97	62
PCT1125	MV	913	154	0	0	21	133	84	49
PCT1125	ED	184	65	0	0	10	55	40	15
PCT1125	TO	1097	219	0	0	31	188	124	64
PCT1126	MV	811	149	0	0	10	139	73	66
PCT1126	ED	201	68	0	0	5	63	40	23
PCT1126	TO	1012	217	0	0	15	202	113	89
PCT1127	MV	742	123	0	0	10	113	59	54
PCT1127	ED	223	99	0	0	8	91	53	38
PCT1127	TO	965	222	0	0	18	204	112	92
PCT1128	MV	733	111	0	0	9	102	56	46
PCT1128	ED	146	59	0	0	7	52	37	15
PCT1128	TO	879	170	0	0	16	154	93	61
PCT1129	MV	786	129	0	0	4	125	85	40
PCT1129	ED	250	108	0	0	15	93	63	30
PCT1129	TO	1036	237	0	0	19	218	148	70
PCT1131	MV	693	103	0	0	12	91	46	45
PCT1131	ED	167	60	0	0	8	52	29	23
PCT1131	TO	860	163	0	0	20	143	75	68
PCT1132	MV	835	152	0	0	10	142	69	73
PCT1132	ED	197	59	0	0	3	56	26	30
PCT1132	TO	1032	211	0	0	13	198	95	103
PCT1133	MV	715	140	0	0	3	137	55	82
PCT1133	ED	160	74	0	0	5	69	36	33
PCT1133	TO	875	214	0	0	8	206	91	115
PCT1134	MV	584	122	0	0	11	111	53	58
PCT1134	ED	183	80	0	0	8	72	51	21
PCT1134	TO	767	202	0	0	19	183	104	79
PCT1135	MV	464	83	0	0	6	77	35	42
PCT1135	ED	92	50	0	0	4	46	24	22
PCT1135	TO	556	133	0	0	10	123	59	64
PCT1136	MV	709	152	0	0	11	141	68	73
PCT1136	ED	158	77	0	0	5	72	44	28
PCT1136	TO	867	229	0	0	16	213	112	101
PCT1141	MV	834	144	0	0	5	139	73	66
PCT1141	ED	222	123	0	0	7	116	72	44
PCT1141	TO	1056	267	0	0	12	255	145	110
PCT1142	MV	721	111	0	0	12	99	61	38
PCT1142	ED	175	87	0	0	5	82	59	23
PCT1142	TO	896	198	0	0	17	181	120	61
PCT1143	MV	822	152	0	0	13	139	95	44
PCT1143	ED	227	113	0	0	11	102	71	31
PCT1143	TO	1049	265	0	0	24	241	166	75
PCT1144	MV	725	110	0	0	9	101	48	53
PCT1144	ED	222	121	0	0	12	109	60	49
PCT1144	TO	947	231	0	0	21	210	108	102
PCT1145	MV	752	146	0	0	12	134	75	59
PCT1145	ED	153	114	0	1	10	103	73	30
PCT1145	TO	905	260	0	1	22	237	148	89
PCT1146	MV	837	143	0	0	12	131	73	58
PCT1146	ED	217	109	0	0	9	100	68	32
PCT1146	TO	1054	252	0	0	21	231	141	90
PCT1147	MV	671	100	0	0	3	97	58	39
PCT1147	ED	214	107	0	0	13	94	61	33
PCT1147	TO	885	207	0	0	16	191	119	72
PCT1148	MV	802	148	0	0	8	140	81	59
PCT1148	ED	226	116	0	0	11	105	66	39
PCT1148	TO	1028	264	0	0	19	245	147	98
PCT1149	MV	708	107	0	0	9	98	43	55
PCT1149	ED	231	118	0	0	10	108	74	34
PCT1149	TO	939	225	0	0	19	206	117	89
PCT1151	MV	0	0	0	0	0	0	0	0
PCT1151	ED	0	0	0	0	0	0	0	0
PCT1151	TO	0	0	0	0	0	0	0	0
PCT1152	MV	710	112	0	0	10	102	67	35
PCT1152	ED	180	85	0	0	8	77	46	31
PCT1152	TO	890	197	0	0	18	179	113	66
PCT1153	MV	730	114	0	0	16	98	47	51
PCT1153	ED	210	116	0	0	11	105	53	52
PCT1153	TO	940	230	0	0	27	203	100	103
PCT1154	MV	0	0	0	0	0	0	0	0
PCT1154	ED	0	0	0	0	0	0	0	0
PCT1154	TO	0	0	0	0	0	0	0	0
PCT7001	MV	630	112	0	0	8	104	59	45
PCT7001	ED	143	101	0	0	7	94	56	38
PCT7001	TO	773	213	0	0	15	198	115	83
PCT7002	MV	595	81	0	0	14	67	37	30
PCT7002	ED	119	88	0	0	6	82	50	32
PCT7002	TO	714	169	0	0	20	149	87	62
PCT7003	MV	759	147	0	0	9	138	69	69
PCT7003	ED	147	144	0	0	15	129	75	54
PCT7003	TO	906	291	0	0	24	267	144	123
PCT7004	MV	763	146	0	0	13	133	66	67
PCT7004	ED	150	142	0	0	16	126	68	58
PCT7004	TO	913	288	0	0	29	259	134	125
PCT7005	MV	696	142	0	0	9	133	72	61
PCT7005	ED	163	162	0	0	23	139	87	52
PCT7005	TO	859	304	0	0	32	272	159	113
PCT7006	MV	726	119	0	0	11	108	67	41
PCT7006	ED	206	149	0	0	10	139	101	38
PCT7006	TO	932	268	0	0	21	247	168	79
PCT7007	MV	775	145	0	0	8	137	63	74
PCT7007	ED	182	168	0	0	18	150	91	59
PCT7007	TO	957	313	0	0	26	287	154	133
PCT7008	MV	732	154	0	0	14	140	76	64
PCT7008	ED	177	189	0	0	17	172	103	69
PCT7008	TO	909	343	0	0	31	312	179	133
PCT7009	MV	749	141	0	0	11	130	66	64
PCT7009	ED	122	91	0	0	6	85	47	38
PCT7009	TO	871	232	0	0	17	215	113	102
PCT7011	MV	703	66	0	0	7	59	28	31
PCT7011	ED	270	87	0	0	4	83	49	34
PCT7011	TO	973	153	0	0	11	142	77	65
PCT7012	MV	996	192	0	0	17	175	97	78
PCT7012	ED	230	203	0	0	19	184	101	83
PCT7012	TO	1226	395	0	0	36	359	198	161
PCT7013	MV	983	122	0	0	5	117	68	49
PCT7013	ED	156	151	0	0	19	132	74	58
PCT7013	TO	1139	273	0	0	24	249	142	107
PCT7014	MV	608	90	0	1	5	84	40	44
PCT7014	ED	111	111	0	0	17	94	55	39
PCT7014	TO	719	201	0	1	22	178	95	83
PCT7015	MV	128	13	0	0	3	10	7	3
PCT7015	ED	-18	0	0	0	0	0	0	0
PCT7015	TO	110	13	0	0	3	10	7	3
PCT7016	MV	654	85	0	0	5	80	42	38
PCT7016	ED	278	75	0	0	7	68	42	26
PCT7016	TO	932	160	0	0	12	148	84	64
PCT7017	MV	539	52	0	0	8	44	21	23
PCT7017	ED	242	53	0	0	12	41	21	20
PCT7017	TO	781	105	0	0	20	85	42	43
PCT7018	MV	846	130	0	0	11	119	54	65
PCT7018	ED	201	56	0	0	5	51	37	14
PCT7018	TO	1047	186	0	0	16	170	91	79
PCT7019	MV	733	130	0	0	13	117	56	61
PCT7019	ED	167	73	0	0	8	65	40	25
PCT7019	TO	900	203	0	0	21	182	96	86
PCT7021	MV	674	78	0	0	10	68	44	24
PCT7021	ED	293	106	0	0	12	94	60	34
PCT7021	TO	967	184	0	0	22	162	104	58
PCT7022	MV	766	109	0	0	9	100	64	36
PCT7022	ED	197	54	0	0	3	51	38	13
PCT7022	TO	963	163	0	0	12	151	102	49
PCT7023	MV	684	142	0	0	8	134	72	62
PCT7023	ED	236	71	0	0	6	65	38	27
PCT7023	TO	920	213	0	0	14	199	110	89
PCT7024	MV	251	25	0	0	1	24	10	14
PCT7024	ED	190	20	0	0	4	16	12	4
PCT7024	TO	441	45	0	0	5	40	22	18
PCT7025	MV	316	41	0	0	2	39	22	17
PCT7025	ED	167	39	0	0	2	37	21	16
PCT7025	TO	483	80	0	0	4	76	43	33
PCT7026	MV	815	137	0	0	14	123	71	52
PCT7026	ED	195	72	0	0	7	65	39	26
PCT7026	TO	1010	209	0	0	21	188	110	78
PCT7027	MV	675	96	0	0	11	85	44	41
PCT7027	ED	221	96	0	0	10	86	47	39
PCT7027	TO	896	192	0	0	21	171	91	80
PCT7028	MV	584	85	0	0	6	79	45	34
PCT7028	ED	272	97	0	0	11	86	59	27
PCT7028	TO	856	182	0	0	17	165	104	61
PCT7029	MV	641	80	0	0	6	74	43	31
PCT7029	ED	268	39	0	0	1	38	16	22
PCT7029	TO	909	119	0	0	7	112	59	53
PCT7030	MV	654	128	0	0	8	120	58	62
PCT7030	ED	141	58	0	0	1	57	34	23
PCT7030	TO	795	186	0	0	9	177	92	85
PCT7031	MV	619	119	0	0	12	107	61	46
PCT7031	ED	75	48	0	0	8	40	20	20
PCT7031	TO	694	167	0	0	20	147	81	66
PCT7032	MV	639	112	0	0	12	100	53	47
PCT7032	ED	242	51	0	0	3	48	28	20
PCT7032	TO	881	163	0	0	15	148	81	67
PCT7033	MV	546	96	0	0	5	91	49	42
PCT7033	ED	232	86	0	0	9	77	49	28
PCT7033	TO	778	182	0	0	14	168	98	70
PCT7034	MV	618	52	0	0	8	44	31	13
PCT7034	ED	320	57	0	0	4	53	32	21
PCT7034	TO	938	109	0	0	12	97	63	34
PCT7035	MV	567	86	0	0	8	78	35	43
PCT7035	ED	152	52	0	0	7	45	27	18
PCT7035	TO	719	138	0	0	15	123	62	61
PCT7036	MV	780	108	0	0	10	98	46	52
PCT7036	ED	194	39	0	0	1	38	23	15
PCT7036	TO	974	147	0	0	11	136	69	67
PCT7037	MV	431	31	0	0	3	28	19	9
PCT7037	ED	315	38	0	0	6	32	22	10
PCT7037	TO	746	69	0	0	9	60	41	19
PCT7038	MV	757	145	0	0	10	135	67	68
PCT7038	ED	204	58	0	0	10	48	24	24
PCT7038	TO	961	203	0	0	20	183	91	92
PCT7039	MV	636	106	0	0	16	90	47	43
PCT7039	ED	201	104	0	0	4	100	65	35
PCT7039	TO	837	210	0	0	20	190	112	78
PCT7041	MV	70	13	0	0	4	9	3	6
PCT7041	ED	-4	0	0	0	0	0	0	0
PCT7041	TO	66	13	0	0	4	9	3	6
PCT7042	MV	514	88	0	0	8	80	44	36
PCT7042	ED	146	58	0	0	1	57	40	17
PCT7042	TO	660	146	0	0	9	137	84	53
PCT7043	MV	753	116	0	0	7	109	59	50
PCT7043	ED	225	78	0	0	4	74	47	27
PCT7043	TO	978	194	0	0	11	183	106	77
PCT7044	MV	584	67	0	0	1	66	36	30
PCT7044	ED	268	33	0	0	3	30	24	6
PCT7044	TO	852	100	0	0	4	96	60	36
PCT7045	MV	632	120	0	0	14	106	63	43
PCT7045	ED	154	53	0	0	5	48	26	22
PCT7045	TO	786	173	0	0	19	154	89	65
PCT7046	MV	334	45	0	0	5	40	23	17
PCT7046	ED	96	48	0	0	3	45	24	21
PCT7046	TO	430	93	0	0	8	85	47	38
PCT7047	MV	730	135	0	0	10	125	58	67
PCT7047	ED	153	62	0	0	6	56	36	20
PCT7047	TO	883	197	0	0	16	181	94	87
PCT7048	MV	684	108	0	0	8	100	58	42
PCT7048	ED	197	56	0	0	5	51	30	21
PCT7048	TO	881	164	0	0	13	151	88	63
PCT7049	MV	615	105	0	0	7	98	58	40
PCT7049	ED	211	70	0	0	9	61	30	31
PCT7049	TO	826	175	0	0	16	159	88	71
PCT7051	MV	715	129	0	0	9	120	50	70
PCT7051	ED	165	70	0	0	8	62	43	19
PCT7051	TO	880	199	0	0	17	182	93	89
PCT7052	MV	720	121	0	0	7	114	50	64
PCT7052	ED	186	84	0	0	6	78	41	37
PCT7052	TO	906	205	0	0	13	192	91	101
PCT7053	MV	542	102	0	0	18	84	35	49
PCT7053	ED	43	40	0	0	4	36	19	17
PCT7053	TO	585	142	0	0	22	120	54	66
PCT7054	MV	860	98	0	0	11	87	46	41
PCT7054	ED	276	105	0	0	5	100	59	41
PCT7054	TO	1136	203	0	0	16	187	105	82
PCT7055	MV	728	120	0	0	8	112	55	57
PCT7055	ED	98	76	0	0	9	67	39	28
PCT7055	TO	826	196	0	0	17	179	94	85
PCT7056	MV	617	85	0	0	8	77	41	36
PCT7056	ED	88	119	0	0	12	107	63	44
PCT7056	TO	705	204	0	0	20	184	104	80
PCT7101	MV	161	31	0	0	1	30	19	11
PCT7101	ED	-14	0	0	0	0	0	0	0
PCT7101	TO	147	31	0	0	1	30	19	11
PCT7201	MV	787	145	0	0	15	130	50	80
PCT7201	ED	148	98	0	0	14	84	38	46
PCT7201	TO	935	243	0	0	29	214	88	126
PCT7202	MV	706	136	0	0	12	124	46	78
PCT7202	ED	145	123	0	0	13	110	60	50
PCT7202	TO	851	259	0	0	25	234	106	128
PCT7203	MV	693	116	0	0	17	99	39	60
PCT7203	ED	186	148	0	0	25	123	64	59
PCT7203	TO	879	264	0	0	42	222	103	119
PCT7204	MV	771	164	0	0	20	144	64	80
PCT7204	ED	128	116	0	0	23	93	45	48
PCT7204	TO	899	280	0	0	43	237	109	128
PCT7205	MV	723	132	0	0	14	118	54	64
PCT7205	ED	148	133	0	0	18	115	55	60
PCT7205	TO	871	265	0	0	32	233	109	124
PCT7206	MV	298	41	0	0	5	36	17	19
PCT7206	ED	79	76	0	0	5	71	35	36
PCT7206	TO	377	117	0	0	10	107	52	55
PCT7207	MV	742	119	0	0	7	112	59	53
PCT7207	ED	125	117	0	0	18	99	61	38
PCT7207	TO	867	236	0	0	25	211	120	91
PCT7208	MV	491	92	0	0	16	76	34	42
PCT7208	ED	79	60	0	0	6	54	32	22
PCT7208	TO	570	152	0	0	22	130	66	64
PCT7209	MV	595	199	0	0	26	173	60	113
PCT7209	ED	52	63	0	0	6	57	23	34
PCT7209	TO	647	262	0	0	32	230	83	147
PCT7301	MV	810	129	0	0	15	114	68	46
PCT7301	ED	204	112	0	0	10	102	60	42
PCT7301	TO	1014	241	0	0	25	216	128	88
PCT7302	MV	713	175	0	0	17	158	72	86
PCT7302	ED	136	116	0	0	13	103	51	52
PCT7302	TO	849	291	0	0	30	261	123	138
PCT7303	MV	864	148	0	0	12	136	73	63
PCT7303	ED	204	141	0	0	19	122	69	53
PCT7303	TO	1068	289	0	0	31	258	142	116
PCT7304	MV	802	137	0	0	13	124	49	75
PCT7304	ED	199	163	0	0	11	152	89	63
PCT7304	TO	1001	300	0	0	24	276	138	138
PCT7305	MV	710	162	0	0	16	146	53	93
PCT7305	ED	157	141	0	0	16	125	62	63
PCT7305	TO	867	303	0	0	32	271	115	156
PCT7306	MV	800	122	0	0	13	109	53	56
PCT7306	ED	244	152	0	0	18	134	78	56
PCT7306	TO	1044	274	0	0	31	243	131	112
PCT7307	MV	604	96	0	0	10	86	44	42
PCT7307	ED	170	101	0	0	11	90	51	39
PCT7307	TO	774	197	0	0	21	176	95	81
PCT7308	MV	516	106	0	0	5	101	56	45
PCT7308	ED	109	126	0	0	15	111	49	62
PCT7308	TO	625	232	0	0	20	212	105	107
PCT7309	MV	690	116	0	0	11	105	47	58
PCT7309	ED	168	156	0	0	20	136	76	60
PCT7309	TO	858	272	0	0	31	241	123	118
PCT7311	MV	698	107	0	0	6	101	43	58
PCT7311	ED	208	169	0	0	22	147	78	69
PCT7311	TO	906	276	0	0	28	248	121	127
PCT7312	MV	697	150	0	0	14	136	57	79
PCT7312	ED	113	120	0	0	10	110	47	63
PCT7312	TO	810	270	0	0	24	246	104	142
PCT7313	MV	818	173	0	0	15	158	84	74
PCT7313	ED	185	115	0	0	15	100	62	38
PCT7313	TO	1003	288	0	0	30	258	146	112
PCT7314	MV	612	124	0	0	13	111	76	35
PCT7314	ED	147	56	0	0	7	49	34	15
PCT7314	TO	759	180	0	0	20	160	110	50
PCT7315	MV	568	82	0	0	10	72	38	34
PCT7315	ED	197	117	0	0	12	105	60	45
PCT7315	TO	765	199	0	0	22	177	98	79
PCT7316	MV	654	119	0	0	15	104	61	43
PCT7316	ED	178	100	0	0	15	85	59	26
PCT7316	TO	832	219	0	0	30	189	120	69
PCT7317	MV	744	146	0	0	10	136	66	70
PCT7317	ED	146	107	0	0	15	92	55	37
PCT7317	TO	890	253	0	0	25	228	121	107
PCT7318	MV	604	142	0	0	17	125	71	54
PCT7318	ED	119	99	0	0	17	82	41	41
PCT7318	TO	723	241	0	0	34	207	112	95
PCT7319	MV	858	111	0	0	7	104	45	59
PCT7319	ED	191	113	0	0	16	97	47	50
PCT7319	TO	1049	224	0	0	23	201	92	109
PCT7321	MV	557	86	0	0	13	73	28	45
PCT7321	ED	102	62	0	0	9	53	27	26
PCT7321	TO	659	148	0	0	22	126	55	71
PCT7322	MV	740	164	0	0	24	140	90	50
PCT7322	ED	148	25	0	0	3	22	18	4
PCT7322	TO	888	189	0	0	27	162	108	54
PCT7323	MV	788	128	0	0	13	115	52	63
PCT7323	ED	168	126	0	0	15	111	61	50
PCT7323	TO	956	254	0	0	28	226	113	113
PCT7324	MV	585	89	0	0	8	81	42	39
PCT7324	ED	152	88	0	0	13	75	37	38
PCT7324	TO	737	177	0	0	21	156	79	77
PCT7325	MV	712	115	0	0	11	104	54	50
PCT7325	ED	174	121	0	0	17	104	60	44
PCT7325	TO	886	236	0	0	28	208	114	94
PCT7326	MV	684	105	0	0	12	93	55	38
PCT7326	ED	175	116	0	0	17	99	50	49
PCT7326	TO	859	221	0	0	29	192	105	87
PCT7327	MV	561	130	0	0	22	108	66	42
PCT7327	ED	126	37	0	0	4	33	16	17
PCT7327	TO	687	167	0	0	26	141	82	59
PCT7328	MV	829	188	0	0	40	148	83	65
PCT7328	ED	173	46	0	0	7	39	28	11
PCT7328	TO	1002	234	0	0	47	187	111	76
PCT7329	MV	552	125	0	0	18	107	42	65
PCT7329	ED	99	56	0	0	4	52	20	32
PCT7329	TO	651	181	0	0	22	159	62	97
PCT7331	MV	710	171	0	0	15	156	61	95
PCT7331	ED	160	129	0	0	20	109	44	65
PCT7331	TO	870	300	0	0	35	265	105	160
PCT7332	MV	652	101	0	0	11	90	57	33
PCT7332	ED	138	113	0	0	4	109	78	31
PCT7332	TO	790	214	0	0	15	199	135	64
PCT7333	MV	821	143	0	0	20	123	75	48
PCT7333	ED	194	161	0	0	16	145	89	56
PCT7333	TO	1015	304	0	0	36	268	164	104
PCT7334	MV	684	117	0	0	6	111	72	39
PCT7334	ED	135	105	0	0	9	96	68	28
PCT7334	TO	819	222	0	0	15	207	140	67
PCT7335	MV	786	145	0	0	9	136	64	72
PCT7335	ED	148	144	0	0	16	128	72	56
PCT7335	TO	934	289	0	0	25	264	136	128
PCT7336	MV	779	147	0	0	14	133	60	73
PCT7336	ED	175	128	0	0	18	110	64	46
PCT7336	TO	954	275	0	0	32	243	124	119
PCT7337	MV	772	167	0	0	18	149	56	93
PCT7337	ED	125	84	0	0	8	76	39	37
PCT7337	TO	897	251	0	0	26	225	95	130
PCT7338	MV	768	189	0	0	15	174	96	78
PCT7338	ED	127	70	0	0	8	62	42	20
PCT7338	TO	895	259	0	0	23	236	138	98
PCT7339	MV	603	116	0	0	7	109	63	46
PCT7339	ED	152	89	0	0	6	83	48	35
PCT7339	TO	755	205	0	0	13	192	111	81
PCT7341	MV	673	100	0	0	10	90	56	34
PCT7341	ED	180	131	0	1	9	121	85	36
PCT7341	TO	853	231	0	1	19	211	141	70
PCT7342	MV	672	117	0	0	11	106	57	49
PCT7342	ED	232	200	0	0	19	181	117	64
PCT7342	TO	904	317	0	0	30	287	174	113
PCT7343	MV	553	88	0	0	5	83	43	40
PCT7343	ED	151	116	0	0	12	104	76	28
PCT7343	TO	704	204	0	0	17	187	119	68
PCT7344	MV	862	151	0	0	10	141	72	69
PCT7344	ED	202	160	0	0	15	145	85	60
PCT7344	TO	1064	311	0	0	25	286	157	129
PCT7345	MV	900	159	0	0	13	146	86	60
PCT7345	ED	214	170	0	0	20	150	91	59
PCT7345	TO	1114	329	0	0	33	296	177	119
PCT7346	MV	677	111	0	0	5	106	77	29
PCT7346	ED	212	126	0	0	14	112	85	27
PCT7346	TO	889	237	0	0	19	218	162	56
PCT7347	MV	827	152	0	0	14	138	90	48
PCT7347	ED	176	98	0	0	8	90	62	28
PCT7347	TO	1003	250	0	0	22	228	152	76
PCT7348	MV	644	122	0	0	7	115	74	41
PCT7348	ED	199	100	0	0	8	92	58	34
PCT7348	TO	843	222	0	0	15	207	132	75
PCT7349	MV	709	158	0	0	10	148	79	69
PCT7349	ED	203	104	0	0	14	90	58	32
PCT7349	TO	912	262	0	0	24	238	137	101
PCT7501	MV	455	75	0	0	6	69	27	42
PCT7501	ED	96	90	0	0	14	76	38	38
PCT7501	TO	551	165	0	0	20	145	65	80
PCT7502	MV	668	107	0	0	10	97	52	45
PCT7502	ED	121	99	0	0	15	84	55	29
PCT7502	TO	789	206	0	0	25	181	107	74
PCT7503	MV	610	112	0	0	13	99	58	41
PCT7503	ED	152	100	0	0	19	81	47	34
PCT7503	TO	762	212	0	0	32	180	105	75
PCT7504	MV	404	72	0	0	8	64	37	27
PCT7504	ED	84	52	0	0	9	43	23	20
PCT7504	TO	488	124	0	0	17	107	60	47
PCT7505	MV	729	198	0	0	16	182	92	90
PCT7505	ED	133	96	0	0	8	88	40	48
PCT7505	TO	862	294	0	0	24	270	132	138
PCT7506	MV	837	122	0	0	15	107	65	42
PCT7506	ED	163	111	0	0	9	102	76	26
PCT7506	TO	1000	233	0	0	24	209	141	68
PCT7507	MV	690	120	0	0	8	112	77	35
PCT7507	ED	266	95	0	0	6	89	59	30
PCT7507	TO	956	215	0	0	14	201	136	65
PCT7508	MV	617	164	0	0	19	145	85	60
PCT7508	ED	127	103	0	0	10	93	57	36
PCT7508	TO	744	267	0	0	29	238	142	96
PCT7509	MV	755	180	0	0	13	167	98	69
PCT7509	ED	174	145	0	0	16	129	76	53
PCT7509	TO	929	325	0	0	29	296	174	122
PCT7512	MV	473	102	0	0	11	91	48	43
PCT7512	ED	127	85	0	0	8	77	48	29
PCT7512	TO	600	187	0	0	19	168	96	72
PCT7513	MV	573	100	0	0	15	85	55	30
PCT7513	ED	233	107	0	0	17	90	72	18
PCT7513	TO	806	207	0	0	32	175	127	48
PCT7514	MV	707	110	0	0	11	99	65	34
PCT7514	ED	209	59	0	0	14	45	28	17
PCT7514	TO	916	169	0	0	25	144	93	51
PCT7515	MV	660	83	0	0	4	79	46	33
PCT7515	ED	204	90	0	0	15	75	49	26
PCT7515	TO	864	173	0	0	19	154	95	59
PCT7516	MV	771	175	0	0	12	163	93	70
PCT7516	ED	149	118	0	0	6	112	54	58
PCT7516	TO	920	293	0	0	18	275	147	128
PCT7517	MV	644	128	0	0	10	118	78	40
PCT7517	ED	224	179	0	0	17	162	104	58
PCT7517	TO	868	307	0	0	27	280	182	98
PCT7518	MV	707	105	0	0	8	97	61	36
PCT7518	ED	219	185	0	0	17	168	106	62
PCT7518	TO	926	290	0	0	25	265	167	98
PCT7519	MV	541	66	0	0	6	60	33	27
PCT7519	ED	174	136	0	0	12	124	87	37
PCT7519	TO	715	202	0	0	18	184	120	64
PCT7521	MV	595	100	0	0	7	93	61	32
PCT7521	ED	184	149	0	0	10	139	88	51
PCT7521	TO	779	249	0	0	17	232	149	83
PCT7522	MV	586	88	0	0	8	80	51	29
PCT7522	ED	173	158	0	0	22	136	92	44
PCT7522	TO	759	246	0	0	30	216	143	73
PCT7523	MV	561	79	0	0	13	66	42	24
PCT7523	ED	183	169	0	0	12	157	106	51
PCT7523	TO	744	248	0	0	25	223	148	75
PCT7524	MV	476	75	0	0	9	66	50	16
PCT7524	ED	148	102	0	0	9	93	57	36
PCT7524	TO	624	177	0	0	18	159	107	52
PCT7525	MV	592	74	0	0	11	63	41	22
PCT7525	ED	172	94	0	0	10	84	53	31
PCT7525	TO	764	168	0	0	21	147	94	53
PCT7526	MV	818	134	0	0	14	120	64	56
PCT7526	ED	170	147	0	0	15	132	84	48
PCT7526	TO	988	281	0	0	29	252	148	104
PCT7527	MV	536	93	0	0	6	87	58	29
PCT7527	ED	174	112	0	0	7	105	64	41
PCT7527	TO	710	205	0	0	13	192	122	70
PCT7529	MV	747	103	0	0	7	96	60	36
PCT7529	ED	156	185	0	0	17	168	112	56
PCT7529	TO	903	288	0	0	24	264	172	92
PCT7531	MV	713	80	0	0	8	72	45	27
PCT7531	ED	160	132	0	0	5	127	86	41
PCT7531	TO	873	212	0	0	13	199	131	68
PCT7532	MV	665	100	0	0	5	95	51	44
PCT7532	ED	170	126	0	0	12	114	76	38
PCT7532	TO	835	226	0	0	17	209	127	82
PCT7533	MV	774	117	0	0	11	106	74	32
PCT7533	ED	196	185	0	0	20	165	115	50
PCT7533	TO	970	302	0	0	31	271	189	82
PCT7534	MV	667	104	0	1	7	96	61	35
PCT7534	ED	236	177	0	0	19	158	114	44
PCT7534	TO	903	281	0	1	26	254	175	79
PCT7535	MV	604	91	0	0	9	82	60	22
PCT7535	ED	141	151	0	0	19	132	92	40
PCT7535	TO	745	242	0	0	28	214	152	62
PCT7536	MV	669	91	0	0	8	83	56	27
PCT7536	ED	164	170	0	0	15	155	86	69
PCT7536	TO	833	261	0	0	23	238	142	96
PCT7537	MV	616	78	0	0	10	68	36	32
PCT7537	ED	129	148	0	0	12	136	84	52
PCT7537	TO	745	226	0	0	22	204	120	84
PCT7538	MV	561	100	0	0	14	86	42	44
PCT7538	ED	190	172	0	0	21	151	102	49
PCT7538	TO	751	272	0	0	35	237	144	93
PCT7539	MV	694	92	0	0	10	82	45	37
PCT7539	ED	227	187	0	0	12	175	130	45
PCT7539	TO	921	279	0	0	22	257	175	82
PCT7541	MV	597	82	0	0	8	74	43	31
PCT7541	ED	173	159	0	0	19	140	99	41
PCT7541	TO	770	241	0	0	27	214	142	72
PCT7542	MV	630	86	0	0	6	80	54	26
PCT7542	ED	194	166	0	0	8	158	110	48
PCT7542	TO	824	252	0	0	14	238	164	74
PCT7543	MV	692	108	0	0	5	103	64	39
PCT7543	ED	232	138	0	0	16	122	87	35
PCT7543	TO	924	246	0	0	21	225	151	74
PCT7544	MV	731	128	0	0	16	112	72	40
PCT7544	ED	168	159	0	0	17	142	95	47
PCT7544	TO	899	287	0	0	33	254	167	87
PCT7545	MV	720	134	0	0	11	123	74	49
PCT7545	ED	175	146	0	0	16	130	86	44
PCT7545	TO	895	280	0	0	27	253	160	93
PCT7546	MV	769	105	0	0	11	94	58	36
PCT7546	ED	184	209	0	0	18	191	111	80
PCT7546	TO	953	314	0	0	29	285	169	116
PCT7547	MV	791	131	0	0	10	121	88	33
PCT7547	ED	190	172	0	0	16	156	113	43
PCT7547	TO	981	303	0	0	26	277	201	76
PCT7548	MV	801	150	0	0	7	143	79	64
PCT7548	ED	250	201	0	1	15	185	119	66
PCT7548	TO	1051	351	0	1	22	328	198	130
PCT7549	MV	659	137	0	0	12	125	77	48
PCT7549	ED	147	140	0	0	19	121	72	49
PCT7549	TO	806	277	0	0	31	246	149	97
PCT7551	MV	586	76	0	0	5	71	39	32
PCT7551	ED	137	171	0	0	16	155	90	65
PCT7551	TO	723	247	0	0	21	226	129	97
PCT7552	MV	561	94	0	0	9	85	41	44
PCT7552	ED	124	127	0	0	16	111	62	49
PCT7552	TO	685	221	0	0	25	196	103	93
PCT7553	MV	210	38	0	0	0	38	18	20
PCT7553	ED	-19	0	0	0	0	0	0	0
PCT7553	TO	191	38	0	0	0	38	18	20
PCT7554	MV	653	106	0	0	10	96	55	41
PCT7554	ED	168	177	0	0	15	162	75	87
PCT7554	TO	821	283	0	0	25	258	130	128
PCT7555	MV	662	126	0	0	14	112	64	48
PCT7555	ED	210	210	0	0	21	189	102	87
PCT7555	TO	872	336	0	0	35	301	166	135
PCT7556	MV	813	158	0	0	8	150	72	78
PCT7556	ED	153	165	0	0	20	145	69	76
PCT7556	TO	966	323	0	0	28	295	141	154
PCT7601	MV	484	94	0	0	6	88	55	33
PCT7601	ED	193	89	0	0	13	76	55	21
PCT7601	TO	677	183	0	0	19	164	110	54
PCT7602	MV	653	120	0	0	13	107	71	36
PCT7602	ED	233	103	0	0	11	92	68	24
PCT7602	TO	886	223	0	0	24	199	139	60
PCT7603	MV	610	119	0	0	9	110	78	32
PCT7603	ED	205	167	0	0	13	154	114	40
PCT7603	TO	815	286	0	0	22	264	192	72
PCT7604	MV	684	116	0	0	9	107	78	29
PCT7604	ED	260	133	0	0	23	110	86	24
PCT7604	TO	944	249	0	0	32	217	164	53
PCT7605	MV	466	94	0	0	10	84	53	31
PCT7605	ED	195	62	0	0	5	57	46	11
PCT7605	TO	661	156	0	0	15	141	99	42
PCT7606	MV	671	114	0	0	15	99	67	32
PCT7606	ED	212	79	0	0	5	74	58	16
PCT7606	TO	883	193	0	0	20	173	125	48
PCT7607	MV	707	119	0	0	9	110	71	39
PCT7607	ED	212	100	0	0	6	94	63	31
PCT7607	TO	919	219	0	0	15	204	134	70
PCT7608	MV	279	67	0	0	9	58	38	20
PCT7608	ED	101	19	0	0	1	18	13	5
PCT7608	TO	380	86	0	0	10	76	51	25
PCT7609	MV	698	178	0	0	23	155	107	48
PCT7609	ED	186	49	0	0	8	41	33	8
PCT7609	TO	884	227	0	0	31	196	140	56
PCT7611	MV	586	126	0	0	12	114	88	26
PCT7611	ED	202	43	0	0	2	41	35	6
PCT7611	TO	788	169	0	0	14	155	123	32
PCT7612	MV	452	95	0	1	6	88	52	36
PCT7612	ED	105	29	0	0	2	27	17	10
PCT7612	TO	557	124	0	1	8	115	69	46
PCT7613	MV	629	100	0	0	7	93	55	38
PCT7613	ED	254	86	0	0	7	79	64	15
PCT7613	TO	883	186	0	0	14	172	119	53
PCT7614	MV	708	109	0	0	12	97	64	33
PCT7614	ED	208	78	0	0	7	71	49	22
PCT7614	TO	916	187	0	0	19	168	113	55
PCT7615	MV	510	75	0	0	10	65	46	19
PCT7615	ED	240	58	0	0	4	54	46	8
PCT7615	TO	750	133	0	0	14	119	92	27
PCT7616	MV	750	77	0	0	6	71	37	34
PCT7616	ED	86	86	0	0	12	74	36	38
PCT7616	TO	836	163	0	0	18	145	73	72
PCT7617	MV	583	113	0	0	18	95	65	30
PCT7617	ED	169	42	0	0	9	33	26	7
PCT7617	TO	752	155	0	0	27	128	91	37
PCT7618	MV	762	133	0	0	4	129	82	47
PCT7618	ED	152	84	0	0	10	74	37	37
PCT7618	TO	914	217	0	0	14	203	119	84
PCT7619	MV	932	158	0	0	15	143	76	67
PCT7619	ED	175	117	0	0	14	103	63	40
PCT7619	TO	1107	275	0	0	29	246	139	107
PCT7621	MV	1000	177	0	0	17	160	86	74
PCT7621	ED	155	103	0	0	13	90	54	36
PCT7621	TO	1155	280	0	0	30	250	140	110
PCT7622	MV	695	100	0	0	10	90	67	23
PCT7622	ED	265	73	0	0	10	63	46	17
PCT7622	TO	960	173	0	0	20	153	113	40
PCT7623	MV	762	99	0	1	9	89	61	28
PCT7623	ED	242	98	0	0	10	88	69	19
PCT7623	TO	1004	197	0	1	19	177	130	47
PCT7624	MV	649	118	0	0	8	110	63	47
PCT7624	ED	226	72	0	0	10	62	46	16
PCT7624	TO	875	190	0	0	18	172	109	63
PCT7625	MV	747	265	0	0	43	222	145	77
PCT7625	ED	75	34	0	0	1	33	24	9
PCT7625	TO	822	299	0	0	44	255	169	86
PCT7626	MV	944	158	0	0	16	142	57	85
PCT7626	ED	129	105	0	0	6	99	47	52
PCT7626	TO	1073	263	0	0	22	241	104	137
PCT7627	MV	456	81	0	0	6	75	24	51
PCT7627	ED	68	57	0	0	9	48	20	28
PCT7627	TO	524	138	0	0	15	123	44	79
PCT7628	MV	716	116	0	0	7	109	65	44
PCT7628	ED	222	110	0	0	8	102	68	34
PCT7628	TO	938	226	0	0	15	211	133	78
PCT7629	MV	685	100	0	0	11	89	57	32
PCT7629	ED	168	86	0	0	9	77	50	27
PCT7629	TO	853	186	0	0	20	166	107	59
PCT7631	MV	1007	164	0	0	10	154	86	68
PCT7631	ED	212	110	0	0	6	104	61	43
PCT7631	TO	1219	274	0	0	16	258	147	111
PCT7632	MV	995	154	0	0	8	146	86	60
PCT7632	ED	176	128	0	0	8	120	71	49
PCT7632	TO	1171	282	0	0	16	266	157	109
PCT7633	MV	608	134	0	0	13	121	78	43
PCT7633	ED	127	96	0	0	13	83	42	41
PCT7633	TO	735	230	0	0	26	204	120	84
PCT7634	MV	704	162	0	0	19	143	94	49
PCT7634	ED	186	101	0	0	18	83	50	33
PCT7634	TO	890	263	0	0	37	226	144	82
PCT7635	MV	662	103	0	0	7	96	48	48
PCT7635	ED	191	62	0	0	5	57	27	30
PCT7635	TO	853	165	0	0	12	153	75	78
PCT7636	MV	797	130	0	0	8	122	56	66
PCT7636	ED	162	107	0	0	10	97	54	43
PCT7636	TO	959	237	0	0	18	219	110	109
PCT7637	MV	746	143	0	0	14	129	50	79
PCT7637	ED	122	98	0	0	12	86	33	53
PCT7637	TO	868	241	0	0	26	215	83	132
PCT7638	MV	806	156	0	0	14	142	50	92
PCT7638	ED	83	87	0	0	10	77	20	57
PCT7638	TO	889	243	0	0	24	219	70	149
PCT7639	MV	888	138	0	0	11	127	51	76
PCT7639	ED	134	132	0	0	28	104	45	59
PCT7639	TO	1022	270	0	0	39	231	96	135
PCT7641	MV	817	182	0	0	14	168	75	93
PCT7641	ED	134	92	0	0	4	88	47	41
PCT7641	TO	951	274	0	0	18	256	122	134
PCT7642	MV	646	92	0	0	8	84	33	51
PCT7642	ED	119	79	0	1	18	60	38	22
PCT7642	TO	765	171	0	1	26	144	71	73
PCT7643	MV	808	177	0	0	12	165	98	67
PCT7643	ED	133	105	0	0	15	90	46	44
PCT7643	TO	941	282	0	0	27	255	144	111
PCT7644	MV	1013	141	0	0	13	128	53	75
PCT7644	ED	163	142	0	0	12	130	93	37
PCT7644	TO	1176	283	0	0	25	258	146	112
PCT7645	MV	595	127	0	0	9	118	49	69
PCT7645	ED	61	56	0	0	9	47	26	21
PCT7645	TO	656	183	0	0	18	165	75	90
PCT7646	MV	1029	157	0	0	15	142	61	81
PCT7646	ED	124	133	0	0	24	109	67	42
PCT7646	TO	1153	290	0	0	39	251	128	123
PCT7647	MV	721	85	0	0	6	79	58	21
PCT7647	ED	266	79	0	0	4	75	59	16
PCT7647	TO	987	164	0	0	10	154	117	37
PCT7648	MV	2	0	0	0	0	0	0	0
PCT7648	ED	0	0	0	0	0	0	0	0
PCT7648	TO	2	0	0	0	0	0	0	0
PCT7649	MV	714	127	0	0	7	120	58	62
PCT7649	ED	186	78	0	0	9	69	44	25
PCT7649	TO	900	205	0	0	16	189	102	87
PCT7651	MV	833	124	0	0	10	114	50	64
PCT7651	ED	114	72	0	0	7	65	21	44
PCT7651	TO	947	196	0	0	17	179	71	108
PCT7652	MV	530	77	0	0	5	72	38	34
PCT7652	ED	105	86	0	0	9	77	46	31
PCT7652	TO	635	163	0	0	14	149	84	65
PCT7653	MV	749	107	0	0	19	88	37	51
PCT7653	ED	90	79	0	1	8	70	31	39
PCT7653	TO	839	186	0	1	27	158	68	90
PCT7654	MV	407	66	0	0	6	60	35	25
PCT7654	ED	59	83	0	0	15	68	41	27
PCT7654	TO	466	149	0	0	21	128	76	52
PCT7655	MV	578	92	0	0	6	86	43	43
PCT7655	ED	101	59	0	0	13	46	21	25
PCT7655	TO	679	151	0	0	19	132	64	68
PCT7656	MV	603	130	0	0	13	117	24	93
PCT7656	ED	35	40	0	0	6	34	8	26
PCT7656	TO	638	170	0	0	19	151	32	119
PCT7657	MV	559	75	0	0	6	69	20	49
PCT7657	ED	39	61	0	0	7	54	22	32
PCT7657	TO	598	136	0	0	13	123	42	81
PCT7701	MV	868	190	0	0	19	171	92	79
PCT7701	ED	196	173	0	0	20	153	90	63
PCT7701	TO	1064	363	0	0	39	324	182	142
PCT7702	MV	623	125	0	0	11	114	51	63
PCT7702	ED	133	103	0	0	6	97	50	47
PCT7702	TO	756	228	0	0	17	211	101	110
PCT7703	MV	187	42	0	0	5	37	27	10
PCT7703	ED	-13	0	0	0	0	0	0	0
PCT7703	TO	174	42	0	0	5	37	27	10
PCT7704	MV	798	186	0	0	16	170	67	103
PCT7704	ED	204	173	0	0	10	163	65	98
PCT7704	TO	1002	359	0	0	26	333	132	201
PCT7705	MV	467	119	0	0	8	111	39	72
PCT7705	ED	128	110	0	0	13	97	40	57
PCT7705	TO	595	229	0	0	21	208	79	129
PCT7706	MV	686	177	0	0	19	158	72	86
PCT7706	ED	180	162	0	0	15	147	58	89
PCT7706	TO	866	339	0	0	34	305	130	175
PCT7707	MV	683	148	0	0	12	136	52	84
PCT7707	ED	189	179	0	0	12	167	76	91
PCT7707	TO	872	327	0	0	24	303	128	175
PCT7708	MV	710	182	0	0	18	164	72	92
PCT7708	ED	165	152	0	0	17	135	69	66
PCT7708	TO	875	334	0	0	35	299	141	158
PCT7709	MV	322	67	0	0	2	65	37	28
PCT7709	ED	84	90	0	0	6	84	53	31
PCT7709	TO	406	157	0	0	8	149	90	59
PCT7711	MV	657	127	0	0	12	115	56	59
PCT7711	ED	154	125	0	0	9	116	69	47
PCT7711	TO	811	252	0	0	21	231	125	106
PCT7712	MV	423	81	0	0	5	76	37	39
PCT7712	ED	109	106	0	0	9	97	57	40
PCT7712	TO	532	187	0	0	14	173	94	79
PCT7801	MV	821	162	0	0	8	154	73	81
PCT7801	ED	153	190	0	0	17	173	90	83
PCT7801	TO	974	352	0	0	25	327	163	164
PCT7802	MV	646	154	0	0	13	141	78	63
PCT7802	ED	152	157	0	0	15	142	84	58
PCT7802	TO	798	311	0	0	28	283	162	121
PCT7803	MV	717	166	0	0	8	158	77	81
PCT7803	ED	114	128	0	0	16	112	64	48
PCT7803	TO	831	294	0	0	24	270	141	129
PCT7804	MV	729	148	0	0	10	138	83	55
PCT7804	ED	156	180	0	0	25	155	76	79
PCT7804	TO	885	328	0	0	35	293	159	134
PCT7805	MV	641	142	0	0	15	127	69	58
PCT7805	ED	159	155	0	0	15	140	97	43
PCT7805	TO	800	297	0	0	30	267	166	101
PCT7806	MV	601	99	0	0	6	93	49	44
PCT7806	ED	154	152	0	0	15	137	86	51
PCT7806	TO	755	251	0	0	21	230	135	95
PCT7807	MV	642	137	0	0	11	126	70	56
PCT7807	ED	185	174	0	0	20	154	103	51
PCT7807	TO	827	311	0	0	31	280	173	107
PCT7808	MV	525	91	0	0	5	86	51	35
PCT7808	ED	129	129	0	0	17	112	69	43
PCT7808	TO	654	220	0	0	22	198	120	78
PCT7809	MV	624	132	0	0	8	124	84	40
PCT7809	ED	140	135	0	0	9	126	84	42
PCT7809	TO	764	267	0	0	17	250	168	82
PCT7811	MV	575	94	0	0	10	84	48	36
PCT7811	ED	183	155	0	0	8	147	97	50
PCT7811	TO	758	249	0	0	18	231	145	86
PCT7812	MV	680	146	0	0	13	133	88	45
PCT7812	ED	217	163	0	0	19	144	95	49
PCT7812	TO	897	309	0	0	32	277	183	94
PCT7813	MV	836	171	0	0	13	158	104	54
PCT7813	ED	232	214	0	0	24	190	139	51
PCT7813	TO	1068	385	0	0	37	348	243	105
PCT7814	MV	660	99	0	0	6	93	73	20
PCT7814	ED	241	118	0	0	15	103	80	23
PCT7814	TO	901	217	0	0	21	196	153	43
PCT7815	MV	749	167	0	0	21	146	83	63
PCT7815	ED	168	176	0	0	13	163	104	59
PCT7815	TO	917	343	0	0	34	309	187	122
PCT7816	MV	721	164	0	0	18	146	82	64
PCT7816	ED	151	149	0	0	9	140	75	65
PCT7816	TO	872	313	0	0	27	286	157	129
PCT7817	MV	648	149	0	0	11	138	88	50
PCT7817	ED	190	182	0	0	15	167	105	62
PCT7817	TO	838	331	0	0	26	305	193	112
PCT7818	MV	667	126	0	0	6	120	70	50
PCT7818	ED	172	149	0	0	12	137	85	52
PCT7818	TO	839	275	0	0	18	257	155	102
PCT7819	MV	632	120	0	0	12	108	63	45
PCT7819	ED	142	89	0	0	8	81	54	27
PCT7819	TO	774	209	0	0	20	189	117	72
PCT7821	MV	806	155	0	0	10	145	74	71
PCT7821	ED	170	189	0	0	12	177	94	83
PCT7821	TO	976	344	0	0	22	322	168	154
PCT7822	MV	673	140	0	0	11	129	82	47
PCT7822	ED	219	222	0	0	28	194	118	76
PCT7822	TO	892	362	0	0	39	323	200	123
PCT7823	MV	703	159	0	0	10	149	87	62
PCT7823	ED	180	188	0	0	6	182	130	52
PCT7823	TO	883	347	0	0	16	331	217	114
PCT7824	MV	613	104	0	0	8	96	55	41
PCT7824	ED	155	158	0	0	19	139	90	49
PCT7824	TO	768	262	0	0	27	235	145	90
PCT7825	MV	457	82	0	0	7	75	46	29
PCT7825	ED	151	130	0	0	6	124	81	43
PCT7825	TO	608	212	0	0	13	199	127	72
PCT7826	MV	485	82	0	0	5	77	44	33
PCT7826	ED	205	162	0	0	15	147	98	49
PCT7826	TO	690	244	0	0	20	224	142	82
PCT7827	MV	601	80	0	0	5	75	49	26
PCT7827	ED	225	145	0	0	14	131	97	34
PCT7827	TO	826	225	0	0	19	206	146	60
PCT7828	MV	855	178	0	0	18	160	85	75
PCT7828	ED	173	177	0	0	21	156	90	66
PCT7828	TO	1028	355	0	0	39	316	175	141
PCT7829	MV	740	151	0	0	12	139	71	68
PCT7829	ED	151	151	0	0	8	143	87	56
PCT7829	TO	891	302	0	0	20	282	158	124
PCT7831	MV	762	174	0	0	14	160	83	77
PCT7831	ED	140	137	0	0	11	126	73	53
PCT7831	TO	902	311	0	0	25	286	156	130
PCT7832	MV	662	154	0	0	16	138	75	63
PCT7832	ED	119	127	0	0	9	118	70	48
PCT7832	TO	781	281	0	0	25	256	145	111
PCT7833	MV	585	102	0	0	8	94	47	47
PCT7833	ED	148	145	0	0	19	126	74	52
PCT7833	TO	733	247	0	0	27	220	121	99
PCT7834	MV	696	109	0	0	10	99	58	41
PCT7834	ED	198	175	0	0	22	153	101	52
PCT7834	TO	894	284	0	0	32	252	159	93
PCT7835	MV	720	158	0	0	12	146	85	61
PCT7835	ED	143	147	0	0	14	133	84	49
PCT7835	TO	863	305	0	0	26	279	169	110
PCT7836	MV	849	209	0	0	15	194	120	74
PCT7836	ED	194	169	0	0	10	159	95	64
PCT7836	TO	1043	378	0	0	25	353	215	138
PCT7837	MV	717	140	0	0	15	125	58	67
PCT7837	ED	206	198	0	0	22	176	95	81
PCT7837	TO	923	338	0	0	37	301	153	148
PCT7838	MV	752	174	0	0	18	156	75	81
PCT7838	ED	143	155	0	0	18	137	83	54
PCT7838	TO	895	329	0	0	36	293	158	135
PCT7839	MV	731	156	0	0	10	146	71	75
PCT7839	ED	130	136	0	0	14	122	61	61
PCT7839	TO	861	292	0	0	24	268	132	136
PCT7841	MV	752	138	0	0	7	131	79	52
PCT7841	ED	198	207	0	0	15	192	105	87
PCT7841	TO	950	345	0	0	22	323	184	139
PCT7842	MV	701	114	0	0	8	106	70	36
PCT7842	ED	178	154	0	0	9	145	86	59
PCT7842	TO	879	268	0	0	17	251	156	95
PCT7843	MV	545	88	0	0	8	80	48	32
PCT7843	ED	184	163	0	0	14	149	99	50
PCT7843	TO	729	251	0	0	22	229	147	82
PCT7844	MV	499	84	0	0	6	78	54	24
PCT7844	ED	152	136	0	0	14	122	85	37
PCT7844	TO	651	220	0	0	20	200	139	61
PCT7845	MV	675	129	0	0	6	123	60	63
PCT7845	ED	205	177	0	0	15	162	80	82
PCT7845	TO	880	306	0	0	21	285	140	145
PCT7846	MV	735	147	0	0	11	136	54	82
PCT7846	ED	173	166	0	0	20	146	77	69
PCT7846	TO	908	313	0	0	31	282	131	151
PCT7847	MV	698	142	0	0	16	126	82	44
PCT7847	ED	193	181	0	0	9	172	96	76
PCT7847	TO	891	323	0	0	25	298	178	120
PCT7848	MV	663	131	0	0	6	125	62	63
PCT7848	ED	184	168	0	0	23	145	77	68
PCT7848	TO	847	299	0	0	29	270	139	131
PCT7849	MV	729	141	0	0	12	129	66	63
PCT7849	ED	172	186	0	0	19	167	101	66
PCT7849	TO	901	327	0	0	31	296	167	129
PCT7851	MV	413	113	0	0	12	101	37	64
PCT7851	ED	113	84	0	0	14	70	14	56
PCT7851	TO	526	197	0	0	26	171	51	120
PCT7852	MV	532	139	0	0	12	127	62	65
PCT7852	ED	112	103	0	0	11	92	46	46
PCT7852	TO	644	242	0	0	23	219	108	111
PCT7853	MV	694	136	0	0	14	122	72	50
PCT7853	ED	161	137	0	0	10	127	60	67
PCT7853	TO	855	273	0	0	24	249	132	117
PCT7854	MV	703	138	0	0	15	123	67	56
PCT7854	ED	175	172	0	0	13	159	84	75
PCT7854	TO	878	310	0	0	28	282	151	131
PCT7855	MV	760	150	0	0	13	137	70	67
PCT7855	ED	214	202	0	0	23	179	95	84
PCT7855	TO	974	352	0	0	36	316	165	151
PCT7856	MV	643	106	0	0	8	98	60	38
PCT7856	ED	204	193	0	0	18	175	105	70
PCT7856	TO	847	299	0	0	26	273	165	108
PCT7857	MV	745	144	0	0	14	130	71	59
PCT7857	ED	161	153	0	0	13	140	81	59
PCT7857	TO	906	297	0	0	27	270	152	118
PCT7858	MV	618	120	0	0	13	107	73	34
PCT7858	ED	161	147	0	0	12	135	91	44
PCT7858	TO	779	267	0	0	25	242	164	78
PCT7859	MV	747	152	0	0	10	142	81	61
PCT7859	ED	152	165	0	0	21	144	81	63
PCT7859	TO	899	317	0	0	31	286	162	124
PCT7861	MV	699	144	0	1	15	128	70	58
PCT7861	ED	164	171	0	0	10	161	101	60
PCT7861	TO	863	315	0	1	25	289	171	118
PCT7862	MV	669	143	0	0	13	130	65	65
PCT7862	ED	195	197	0	0	14	183	100	83
PCT7862	TO	864	340	0	0	27	313	165	148
PCT7863	MV	690	102	0	0	4	98	64	34
PCT7863	ED	211	205	0	0	16	189	112	77
PCT7863	TO	901	307	0	0	20	287	176	111
PCT7864	MV	660	115	0	0	12	103	64	39
PCT7864	ED	154	157	0	0	17	140	87	53
PCT7864	TO	814	272	0	0	29	243	151	92
PCT7865	MV	677	132	0	0	8	124	71	53
PCT7865	ED	163	157	0	0	12	145	93	52
PCT7865	TO	840	289	0	0	20	269	164	105
PCT7866	MV	689	173	0	0	14	159	81	78
PCT7866	ED	159	141	0	0	13	128	62	66
PCT7866	TO	848	314	0	0	27	287	143	144
PCT7867	MV	763	179	0	0	20	159	92	67
PCT7867	ED	215	182	0	0	20	162	91	71
PCT7867	TO	978	361	0	0	40	321	183	138
PCT7868	MV	657	157	0	0	10	147	71	76
PCT7868	ED	219	161	0	0	22	139	83	56
PCT7868	TO	876	318	0	0	32	286	154	132
PCT7869	MV	682	157	0	0	11	146	83	63
PCT7869	ED	179	189	0	0	21	168	103	65
PCT7869	TO	861	346	0	0	32	314	186	128
PCT7871	MV	701	153	0	0	9	144	82	62
PCT7871	ED	201	157	0	0	12	145	70	75
PCT7871	TO	902	310	0	0	21	289	152	137
PCT7872	MV	675	149	0	0	9	140	65	75
PCT7872	ED	199	185	0	0	15	170	77	93
PCT7872	TO	874	334	0	0	24	310	142	168
PCT7873	MV	687	135	0	0	10	125	78	47
PCT7873	ED	204	212	0	0	19	193	117	76
PCT7873	TO	891	347	0	0	29	318	195	123
PCT7874	MV	370	58	0	0	6	52	35	17
PCT7874	ED	119	107	0	0	11	96	52	44
PCT7874	TO	489	165	0	0	17	148	87	61
PCT7875	MV	500	83	0	0	3	80	44	36
PCT7875	ED	147	114	0	0	6	108	68	40
PCT7875	TO	647	197	0	0	9	188	112	76
PCT7876	MV	462	93	0	0	11	82	51	31
PCT7876	ED	106	91	0	0	14	77	44	33
PCT7876	TO	568	184	0	0	25	159	95	64
PCT7901	MV	399	81	0	0	5	76	52	24
PCT7901	ED	150	65	0	0	1	64	45	19
PCT7901	TO	549	146	0	0	6	140	97	43
PCT7902	MV	678	102	0	0	11	91	52	39
PCT7902	ED	234	139	0	1	10	128	91	37
PCT7902	TO	912	241	0	1	21	219	143	76
PCT7903	MV	620	107	0	0	11	96	63	33
PCT7903	ED	232	123	0	0	9	114	84	30
PCT7903	TO	852	230	0	0	20	210	147	63
PCT7904	MV	675	104	0	0	6	98	69	29
PCT7904	ED	162	115	0	1	7	107	73	34
PCT7904	TO	837	219	0	1	13	205	142	63
PCT7905	MV	683	145	0	0	9	136	77	59
PCT7905	ED	192	183	0	0	11	172	111	61
PCT7905	TO	875	328	0	0	20	308	188	120
PCT7906	MV	596	79	0	0	5	74	42	32
PCT7906	ED	190	115	0	0	13	102	81	21
PCT7906	TO	786	194	0	0	18	176	123	53
PCT7907	MV	702	112	0	0	10	102	71	31
PCT7907	ED	240	163	0	0	15	148	104	44
PCT7907	TO	942	275	0	0	25	250	175	75
PCT7908	MV	748	142	0	0	8	134	88	46
PCT7908	ED	244	169	0	0	20	149	104	45
PCT7908	TO	992	311	0	0	28	283	192	91
PCT7909	MV	558	89	0	0	5	84	54	30
PCT7909	ED	185	140	0	0	5	135	95	40
PCT7909	TO	743	229	0	0	10	219	149	70
PCT7911	MV	666	107	0	0	9	98	54	44
PCT7911	ED	205	129	0	0	10	119	76	43
PCT7911	TO	871	236	0	0	19	217	130	87
PCT7912	MV	799	118	0	0	8	110	78	32
PCT7912	ED	260	176	0	0	23	153	107	46
PCT7912	TO	1059	294	0	0	31	263	185	78
PCT7913	MV	658	123	0	0	5	118	85	33
PCT7913	ED	265	212	0	0	11	201	133	68
PCT7913	TO	923	335	0	0	16	319	218	101
PCT7914	MV	715	106	0	0	8	98	69	29
PCT7914	ED	187	140	0	0	15	125	90	35
PCT7914	TO	902	246	0	0	23	223	159	64
PCT7915	MV	604	87	0	0	3	84	56	28
PCT7915	ED	239	181	0	0	7	174	130	44
PCT7915	TO	843	268	0	0	10	258	186	72
PCT7916	MV	637	100	0	0	6	94	60	34
PCT7916	ED	221	160	0	0	10	150	108	42
PCT7916	TO	858	260	0	0	16	244	168	76
PCT7917	MV	714	112	0	0	8	104	81	23
PCT7917	ED	273	187	0	0	6	181	142	39
PCT7917	TO	987	299	0	0	14	285	223	62
PCT7918	MV	594	79	0	0	2	77	57	20
PCT7918	ED	230	143	0	0	10	133	94	39
PCT7918	TO	824	222	0	0	12	210	151	59
PCT7919	MV	608	102	0	0	7	95	65	30
PCT7919	ED	258	175	0	0	11	164	123	41
PCT7919	TO	866	277	0	0	18	259	188	71
PCT7921	MV	679	113	0	0	7	106	76	30
PCT7921	ED	232	101	0	0	8	93	59	34
PCT7921	TO	911	214	0	0	15	199	135	64
PCT7922	MV	644	114	0	0	6	108	70	38
PCT7922	ED	214	155	0	0	14	141	104	37
PCT7922	TO	858	269	0	0	20	249	174	75
PCT7923	MV	665	108	0	0	3	105	67	38
PCT7923	ED	215	170	0	0	10	160	121	39
PCT7923	TO	880	278	0	0	13	265	188	77
PCT7924	MV	648	93	0	0	2	91	53	38
PCT7924	ED	203	124	0	0	8	116	80	36
PCT7924	TO	851	217	0	0	10	207	133	74
PCT7925	MV	434	81	0	0	6	75	46	29
PCT7925	ED	110	89	0	0	5	84	61	23
PCT7925	TO	544	170	0	0	11	159	107	52
PCT7926	MV	610	97	0	0	9	88	53	35
PCT7926	ED	178	150	0	0	16	134	80	54
PCT7926	TO	788	247	0	0	25	222	133	89
PCT7927	MV	579	106	0	0	12	94	55	39
PCT7927	ED	163	152	0	1	8	143	88	55
PCT7927	TO	742	258	0	1	20	237	143	94
PCT7928	MV	700	130	0	0	8	122	86	36
PCT7928	ED	217	208	0	0	13	195	126	69
PCT7928	TO	917	338	0	0	21	317	212	105
PCT7929	MV	678	128	0	0	14	114	68	46
PCT7929	ED	169	170	0	0	17	153	95	58
PCT7929	TO	847	298	0	0	31	267	163	104
PCT7931	MV	609	114	0	0	10	104	58	46
PCT7931	ED	142	149	0	0	15	134	78	56
PCT7931	TO	751	263	0	0	25	238	136	102
PCT7932	MV	442	98	0	0	6	92	56	36
PCT7932	ED	119	95	0	0	12	83	50	33
PCT7932	TO	561	193	0	0	18	175	106	69
PCT7933	MV	9	2	0	0	0	2	2	0
PCT7933	ED	-1	0	0	0	0	0	0	0
PCT7933	TO	8	2	0	0	0	2	2	0
PCT7934	MV	701	140	0	0	14	126	85	41
PCT7934	ED	183	154	0	0	21	133	105	28
PCT7934	TO	884	294	0	0	35	259	190	69
PCT7935	MV	715	138	0	0	11	127	76	51
PCT7935	ED	228	225	0	0	20	205	141	64
PCT7935	TO	943	363	0	0	31	332	217	115
PCT7936	MV	619	119	0	0	10	109	76	33
PCT7936	ED	237	220	0	0	15	205	131	74
PCT7936	TO	856	339	0	0	25	314	207	107
PCT7937	MV	697	143	0	0	11	132	84	48
PCT7937	ED	203	171	0	0	13	158	124	34
PCT7937	TO	900	314	0	0	24	290	208	82
PCT7938	MV	536	105	0	0	7	98	60	38
PCT7938	ED	215	120	0	0	9	111	80	31
PCT7938	TO	751	225	0	0	16	209	140	69
PCT7939	MV	480	76	0	0	7	69	40	29
PCT7939	ED	206	191	0	0	16	175	112	63
PCT7939	TO	686	267	0	0	23	244	152	92
PCT7941	MV	574	92	0	0	12	80	53	27
PCT7941	ED	198	170	0	0	16	154	83	71
PCT7941	TO	772	262	0	0	28	234	136	98
PCT7942	MV	658	134	0	0	9	125	81	44
PCT7942	ED	274	141	0	0	8	133	90	43
PCT7942	TO	932	275	0	0	17	258	171	87
PCT7943	MV	686	128	0	0	7	121	78	43
PCT7943	ED	214	156	0	0	14	142	84	58
PCT7943	TO	900	284	0	0	21	263	162	101
PCT7944	MV	583	104	0	0	9	95	61	34
PCT7944	ED	231	196	0	0	18	178	107	71
PCT7944	TO	814	300	0	0	27	273	168	105
PCT7945	MV	725	116	0	0	7	109	66	43
PCT7945	ED	229	82	0	0	9	73	53	20
PCT7945	TO	954	198	0	0	16	182	119	63
PCT7946	MV	779	161	0	0	10	151	72	79
PCT7946	ED	206	114	0	0	13	101	70	31
PCT7946	TO	985	275	0	0	23	252	142	110
PCT7947	MV	791	160	0	0	15	145	88	57
PCT7947	ED	195	93	0	0	6	87	56	31
PCT7947	TO	986	253	0	0	21	232	144	88
PCT7948	MV	730	151	0	0	15	136	68	68
PCT7948	ED	200	119	0	0	7	112	68	44
PCT7948	TO	930	270	0	0	22	248	136	112
PCT7949	MV	483	107	0	0	4	103	38	65
PCT7949	ED	107	56	0	0	9	47	26	21
PCT7949	TO	590	163	0	0	13	150	64	86
PCT7951	MV	729	149	0	0	9	140	62	78
PCT7951	ED	158	90	0	0	8	82	48	34
PCT7951	TO	887	239	0	0	17	222	110	112
PCT7952	MV	730	105	0	0	7	98	46	52
PCT7952	ED	182	86	0	0	12	74	42	32
PCT7952	TO	912	191	0	0	19	172	88	84
PCT7953	MV	668	136	0	0	7	129	48	81
PCT7953	ED	162	106	0	0	8	98	51	47
PCT7953	TO	830	242	0	0	15	227	99	128
PCT7954	MV	0	0	0	0	0	0	0	0
PCT7954	ED	0	0	0	0	0	0	0	0
PCT7954	TO	0	0	0	0	0	0	0	0
PCT7955	MV	774	120	0	0	11	109	57	52
PCT7955	ED	173	97	0	0	12	85	42	43
PCT7955	TO	947	217	0	0	23	194	99	95
PCT7956	MV	699	102	0	0	4	98	55	43
PCT7956	ED	170	39	0	0	2	37	22	15
PCT7956	TO	869	141	0	0	6	135	77	58
PCT7957	MV	537	101	0	1	12	88	52	36
PCT7957	ED	136	83	0	0	10	73	44	29
PCT7957	TO	673	184	0	1	22	161	96	65
PCT7958	MV	320	36	0	0	2	34	23	11
PCT7958	ED	-23	0	0	0	0	0	0	0
PCT7958	TO	297	36	0	0	2	34	23	11
PCT7959	MV	537	86	0	0	7	79	50	29
PCT7959	ED	149	65	0	0	8	57	41	16
PCT7959	TO	686	151	0	0	15	136	91	45
PCT9001	MV	313	39	0	0	0	39	21	18
PCT9001	ED	-29	0	0	0	0	0	0	0
PCT9001	TO	284	39	0	0	0	39	21	18
PCT9101	MV	711	162	0	0	11	151	80	71
PCT9101	ED	202	150	0	0	11	139	85	54
PCT9101	TO	913	312	0	0	22	290	165	125
PCT9102	MV	785	134	0	0	10	124	70	54
PCT9102	ED	207	126	0	0	9	117	60	57
PCT9102	TO	992	260	0	0	19	241	130	111
PCT9103	MV	717	147	0	0	16	131	74	57
PCT9103	ED	240	153	0	0	20	133	69	64
PCT9103	TO	957	300	0	0	36	264	143	121
PCT9104	MV	808	143	0	0	13	130	75	55
PCT9104	ED	222	152	0	0	15	137	91	46
PCT9104	TO	1030	295	0	0	28	267	166	101
PCT9105	MV	719	152	0	0	13	139	63	76
PCT9105	ED	199	173	0	0	19	154	85	69
PCT9105	TO	918	325	0	0	32	293	148	145
PCT9106	MV	745	149	0	0	15	134	69	65
PCT9106	ED	201	178	0	0	18	160	90	70
PCT9106	TO	946	327	0	0	33	294	159	135
PCT9107	MV	635	124	0	0	10	114	67	47
PCT9107	ED	209	118	0	0	11	107	68	39
PCT9107	TO	844	242	0	0	21	221	135	86
PCT9108	MV	610	104	0	0	12	92	51	41
PCT9108	ED	200	136	0	0	11	125	79	46
PCT9108	TO	810	240	0	0	23	217	130	87
PCT9109	MV	672	103	0	0	9	94	47	47
PCT9109	ED	211	162	0	0	13	149	81	68
PCT9109	TO	883	265	0	0	22	243	128	115
PCT9111	MV	638	123	0	0	16	107	66	41
PCT9111	ED	196	134	0	0	21	113	72	41
PCT9111	TO	834	257	0	0	37	220	138	82
PCT9112	MV	742	129	0	0	9	120	72	48
PCT9112	ED	219	160	0	0	15	145	87	58
PCT9112	TO	961	289	0	0	24	265	159	106
PCT9113	MV	795	126	0	0	11	115	57	58
PCT9113	ED	209	180	0	0	18	162	88	74
PCT9113	TO	1004	306	0	0	29	277	145	132
PCT9114	MV	657	107	0	0	11	96	55	41
PCT9114	ED	233	147	0	0	20	127	87	40
PCT9114	TO	890	254	0	0	31	223	142	81
PCT9115	MV	697	122	0	0	12	110	66	44
PCT9115	ED	184	155	0	0	23	132	97	35
PCT9115	TO	881	277	0	0	35	242	163	79
PCT9116	MV	781	129	0	0	8	121	73	48
PCT9116	ED	180	148	0	0	19	129	87	42
PCT9116	TO	961	277	0	0	27	250	160	90
PCT9117	MV	628	139	0	0	11	128	68	60
PCT9117	ED	172	158	0	0	12	146	80	66
PCT9117	TO	800	297	0	0	23	274	148	126
PCT9118	MV	738	105	0	0	10	95	41	54
PCT9118	ED	246	165	0	0	17	148	97	51
PCT9118	TO	984	270	0	0	27	243	138	105
PCT9119	MV	703	152	0	0	15	137	53	84
PCT9119	ED	197	120	0	0	15	105	63	42
PCT9119	TO	900	272	0	0	30	242	116	126
PCT9121	MV	733	114	0	0	7	107	53	54
PCT9121	ED	220	141	0	0	13	128	73	55
PCT9121	TO	953	255	0	0	20	235	126	109
PCT9122	MV	773	143	0	0	16	127	70	57
PCT9122	ED	194	122	0	0	15	107	60	47
PCT9122	TO	967	265	0	0	31	234	130	104
PCT9123	MV	661	121	0	0	8	113	61	52
PCT9123	ED	191	139	0	0	17	122	70	52
PCT9123	TO	852	260	0	0	25	235	131	104
PCT9124	MV	734	131	0	0	6	125	63	62
PCT9124	ED	169	118	0	0	8	110	77	33
PCT9124	TO	903	249	0	0	14	235	140	95
PCT9125	MV	680	132	0	0	6	126	69	57
PCT9125	ED	189	124	0	0	10	114	67	47
PCT9125	TO	869	256	0	0	16	240	136	104
PCT9126	MV	817	172	0	0	17	155	70	85
PCT9126	ED	196	152	0	0	13	139	80	59
PCT9126	TO	1013	324	0	0	30	294	150	144
PCT9127	MV	748	141	0	0	14	127	61	66
PCT9127	ED	223	184	0	0	17	167	92	75
PCT9127	TO	971	325	0	0	31	294	153	141
PCT9128	MV	626	93	0	0	7	86	36	50
PCT9128	ED	192	166	0	0	17	149	85	64
PCT9128	TO	818	259	0	0	24	235	121	114
PCT9129	MV	586	107	0	0	10	97	54	43
PCT9129	ED	152	129	0	0	7	122	77	45
PCT9129	TO	738	236	0	0	17	219	131	88
PCT9131	MV	596	119	0	0	8	111	56	55
PCT9131	ED	138	111	0	0	14	97	61	36
PCT9131	TO	734	230	0	0	22	208	117	91
PCT9132	MV	628	85	0	0	7	78	52	26
PCT9132	ED	193	130	0	0	12	118	82	36
PCT9132	TO	821	215	0	0	19	196	134	62
PCT9133	MV	806	172	0	0	19	153	76	77
PCT9133	ED	211	157	0	0	12	145	80	65
PCT9133	TO	1017	329	0	0	31	298	156	142
PCT9134	MV	734	121	0	0	6	115	52	63
PCT9134	ED	157	102	0	0	12	90	53	37
PCT9134	TO	891	223	0	0	18	205	105	100
PCT9135	MV	639	134	0	0	12	122	70	52
PCT9135	ED	183	125	0	0	12	113	54	59
PCT9135	TO	822	259	0	0	24	235	124	111
PCT9136	MV	706	124	0	0	9	115	59	56
PCT9136	ED	212	139	0	0	13	126	85	41
PCT9136	TO	918	263	0	0	22	241	144	97
PCT9137	MV	804	153	0	0	22	131	80	51
PCT9137	ED	211	133	0	0	9	124	83	41
PCT9137	TO	1015	286	0	0	31	255	163	92
PCT9138	MV	769	157	0	0	8	149	58	91
PCT9138	ED	176	119	0	0	10	109	77	32
PCT9138	TO	945	276	0	0	18	258	135	123
PCT9139	MV	826	158	0	0	9	149	61	88
PCT9139	ED	192	141	0	0	15	126	68	58
PCT9139	TO	1018	299	0	0	24	275	129	146
PCT9141	MV	788	160	0	0	20	140	75	65
PCT9141	ED	185	144	0	0	12	132	77	55
PCT9141	TO	973	304	0	0	32	272	152	120
PCT9142	MV	747	146	0	0	14	132	81	51
PCT9142	ED	239	162	0	0	14	148	89	59
PCT9142	TO	986	308	0	0	28	280	170	110
PCT9143	MV	703	149	0	0	17	132	61	71
PCT9143	ED	211	150	0	0	8	142	74	68
PCT9143	TO	914	299	0	0	25	274	135	139
PCT9144	MV	765	152	0	0	14	138	76	62
PCT9144	ED	205	177	0	0	16	161	107	54
PCT9144	TO	970	329	0	0	30	299	183	116
PCT9145	MV	680	117	0	0	14	103	52	51
PCT9145	ED	195	157	0	0	14	143	75	68
PCT9145	TO	875	274	0	0	28	246	127	119
PCT9146	MV	725	120	0	0	11	109	62	47
PCT9146	ED	160	143	0	0	16	127	73	54
PCT9146	TO	885	263	0	0	27	236	135	101
PCT9147	MV	763	111	0	0	6	105	57	48
PCT9147	ED	227	161	0	0	14	147	89	58
PCT9147	TO	990	272	0	0	20	252	146	106
PCT9148	MV	778	135	0	0	7	128	61	67
PCT9148	ED	236	177	0	0	19	158	86	72
PCT9148	TO	1014	312	0	0	26	286	147	139
PCT9149	MV	808	124	0	0	11	113	64	49
PCT9149	ED	183	240	0	0	23	217	142	75
PCT9149	TO	991	364	0	0	34	330	206	124
PCT9151	MV	691	133	0	0	12	121	77	44
PCT9151	ED	170	111	0	0	7	104	55	49
PCT9151	TO	861	244	0	0	19	225	132	93
PCT9152	MV	544	63	0	0	4	59	39	20
PCT9152	ED	193	124	0	1	14	109	81	28
PCT9152	TO	737	187	0	1	18	168	120	48
PCT9201	MV	784	110	0	0	11	99	68	31
PCT9201	ED	187	166	0	0	17	149	100	49
PCT9201	TO	971	276	0	0	28	248	168	80
PCT9202	MV	819	126	0	1	14	111	61	50
PCT9202	ED	177	164	0	0	18	146	66	80
PCT9202	TO	996	290	0	1	32	257	127	130
PCT9203	MV	847	142	0	0	19	123	35	88
PCT9203	ED	155	120	0	0	16	104	44	60
PCT9203	TO	1002	262	0	0	35	227	79	148
PCT9204	MV	686	115	0	0	12	103	30	73
PCT9204	ED	176	138	0	0	18	120	39	81
PCT9204	TO	862	253	0	0	30	223	69	154
PCT9205	MV	620	119	0	0	17	102	56	46
PCT9205	ED	116	92	0	0	17	75	38	37
PCT9205	TO	736	211	0	0	34	177	94	83
PCT9206	MV	741	141	0	0	16	125	35	90
PCT9206	ED	188	149	0	0	26	123	49	74
PCT9206	TO	929	290	0	0	42	248	84	164
PCT9207	MV	824	129	0	0	11	118	48	70
PCT9207	ED	165	130	0	0	16	114	47	67
PCT9207	TO	989	259	0	0	27	232	95	137
PCT9208	MV	806	127	0	1	14	112	43	69
PCT9208	ED	181	127	0	0	15	112	51	61
PCT9208	TO	987	254	0	1	29	224	94	130
PCT9209	MV	615	100	0	0	8	92	34	58
PCT9209	ED	156	119	0	1	19	99	43	56
PCT9209	TO	771	219	0	1	27	191	77	114
PCT9211	MV	730	114	0	0	11	103	41	62
PCT9211	ED	161	132	0	0	19	113	39	74
PCT9211	TO	891	246	0	0	30	216	80	136
PCT9212	MV	670	100	0	0	3	97	36	61
PCT9212	ED	138	114	0	0	23	91	39	52
PCT9212	TO	808	214	0	0	26	188	75	113
PCT9213	MV	774	138	0	0	15	123	59	64
PCT9213	ED	163	130	0	0	20	110	60	50
PCT9213	TO	937	268	0	0	35	233	119	114
PCT9214	MV	514	95	0	0	7	88	38	50
PCT9214	ED	113	103	0	0	20	83	24	59
PCT9214	TO	627	198	0	0	27	171	62	109
PCT9215	MV	523	97	0	0	8	89	31	58
PCT9215	ED	121	100	0	0	15	85	24	61
PCT9215	TO	644	197	0	0	23	174	55	119
PCT9216	MV	668	95	0	0	15	80	36	44
PCT9216	ED	156	125	0	0	14	111	59	52
PCT9216	TO	824	220	0	0	29	191	95	96
PCT9217	MV	587	89	0	0	10	79	30	49
PCT9217	ED	118	87	0	0	7	80	38	42
PCT9217	TO	705	176	0	0	17	159	68	91
PCT9218	MV	649	97	0	0	8	89	41	48
PCT9218	ED	167	112	0	0	10	102	40	62
PCT9218	TO	816	209	0	0	18	191	81	110
PCT9219	MV	643	95	0	0	11	84	46	38
PCT9219	ED	147	116	0	0	11	105	56	49
PCT9219	TO	790	211	0	0	22	189	102	87
PCT9221	MV	561	144	0	0	9	135	32	103
PCT9221	ED	90	99	0	0	13	86	21	65
PCT9221	TO	651	243	0	0	22	221	53	168
PCT9222	MV	773	145	0	0	23	122	36	86
PCT9222	ED	137	116	0	0	12	104	40	64
PCT9222	TO	910	261	0	0	35	226	76	150
PCT9223	MV	557	124	0	0	11	113	35	78
PCT9223	ED	110	59	0	0	9	50	17	33
PCT9223	TO	667	183	0	0	20	163	52	111
PCT9224	MV	767	173	0	0	12	161	60	101
PCT9224	ED	182	151	0	0	24	127	54	73
PCT9224	TO	949	324	0	0	36	288	114	174
PCT9225	MV	757	109	0	0	14	95	55	40
PCT9225	ED	169	156	0	0	24	132	59	73
PCT9225	TO	926	265	0	0	38	227	114	113
PCT9226	MV	739	140	0	0	14	126	41	85
PCT9226	ED	157	143	0	0	14	129	61	68
PCT9226	TO	896	283	0	0	28	255	102	153
PCT9227	MV	605	150	0	0	13	137	41	96
PCT9227	ED	124	114	0	0	7	107	39	68
PCT9227	TO	729	264	0	0	20	244	80	164
PCT9228	MV	577	114	0	0	14	100	37	63
PCT9228	ED	161	141	0	0	19	122	43	79
PCT9228	TO	738	255	0	0	33	222	80	142
PCT9229	MV	460	106	0	0	14	92	38	54
PCT9229	ED	119	106	0	0	10	96	36	60
PCT9229	TO	579	212	0	0	24	188	74	114
PCT9231	MV	725	133	0	0	15	118	45	73
PCT9231	ED	237	208	0	0	28	180	94	86
PCT9231	TO	962	341	0	0	43	298	139	159
PCT9232	MV	608	98	0	0	4	94	43	51
PCT9232	ED	126	140	0	0	15	125	59	66
PCT9232	TO	734	238	0	0	19	219	102	117
PCT9233	MV	668	140	0	0	12	128	37	91
PCT9233	ED	150	141	0	0	18	123	43	80
PCT9233	TO	818	281	0	0	30	251	80	171
PCT9234	MV	643	134	0	0	11	123	52	71
PCT9234	ED	91	112	0	0	17	95	39	56
PCT9234	TO	734	246	0	0	28	218	91	127
PCT9235	MV	703	143	0	0	10	133	40	93
PCT9235	ED	160	140	0	0	14	126	40	86
PCT9235	TO	863	283	0	0	24	259	80	179
PCT9236	MV	538	114	0	0	13	101	42	59
PCT9236	ED	135	101	0	0	14	87	32	55
PCT9236	TO	673	215	0	0	27	188	74	114
PCT9237	MV	778	129	0	1	8	120	48	72
PCT9237	ED	119	134	0	0	18	116	56	60
PCT9237	TO	897	263	0	1	26	236	104	132
PCT9238	MV	686	126	0	0	17	109	32	77
PCT9238	ED	119	118	0	0	17	101	45	56
PCT9238	TO	805	244	0	0	34	210	77	133
PCT9239	MV	740	176	0	0	18	158	57	101
PCT9239	ED	124	117	0	0	16	101	34	67
PCT9239	TO	864	293	0	0	34	259	91	168
PCT9241	MV	819	156	0	0	10	146	51	95
PCT9241	ED	141	139	0	0	16	123	53	70
PCT9241	TO	960	295	0	0	26	269	104	165
PCT9242	MV	771	125	0	0	14	111	45	66
PCT9242	ED	172	155	0	0	20	135	77	58
PCT9242	TO	943	280	0	0	34	246	122	124
PCT9243	MV	480	75	0	0	8	67	24	43
PCT9243	ED	123	113	0	0	16	97	53	44
PCT9243	TO	603	188	0	0	24	164	77	87
PCT9244	MV	753	114	0	0	13	101	41	60
PCT9244	ED	157	121	0	0	12	109	60	49
PCT9244	TO	910	235	0	0	25	210	101	109
PCT9245	MV	615	105	0	0	13	92	45	47
PCT9245	ED	99	91	0	0	9	82	38	44
PCT9245	TO	714	196	0	0	22	174	83	91
PCT9246	MV	815	161	0	0	14	147	64	83
PCT9246	ED	155	140	0	0	26	114	54	60
PCT9246	TO	970	301	0	0	40	261	118	143
PCT9247	MV	761	139	0	0	11	128	59	69
PCT9247	ED	151	156	0	0	25	131	68	63
PCT9247	TO	912	295	0	0	36	259	127	132
PCT9248	MV	755	130	0	0	16	114	64	50
PCT9248	ED	152	145	0	0	17	128	78	50
PCT9248	TO	907	275	0	0	33	242	142	100
PCT9249	MV	724	137	0	0	12	125	64	61
PCT9249	ED	191	171	0	0	19	152	72	80
PCT9249	TO	915	308	0	0	31	277	136	141
PCT9251	MV	792	143	0	0	17	126	57	69
PCT9251	ED	174	179	0	0	18	161	77	84
PCT9251	TO	966	322	0	0	35	287	134	153
PCT9252	MV	809	162	0	0	14	148	69	79
PCT9252	ED	144	127	0	0	7	120	58	62
PCT9252	TO	953	289	0	0	21	268	127	141
PCT9253	MV	599	100	0	0	8	92	41	51
PCT9253	ED	162	116	0	0	13	103	64	39
PCT9253	TO	761	216	0	0	21	195	105	90
PCT9254	MV	756	162	0	0	7	155	74	81
PCT9254	ED	165	155	0	0	24	131	70	61
PCT9254	TO	921	317	0	0	31	286	144	142
PCT9255	MV	435	52	0	0	4	48	27	21
PCT9255	ED	115	112	0	0	17	95	53	42
PCT9255	TO	550	164	0	0	21	143	80	63
PCT9256	MV	365	61	0	0	4	57	25	32
PCT9256	ED	97	74	0	0	9	65	34	31
PCT9256	TO	462	135	0	0	13	122	59	63
PCT9257	MV	356	36	0	0	5	31	20	11
PCT9257	ED	-36	0	0	0	0	0	0	0
PCT9257	TO	320	36	0	0	5	31	20	11
PCT9258	MV	582	114	0	0	9	105	46	59
PCT9258	ED	121	103	0	0	13	90	47	43
PCT9258	TO	703	217	0	0	22	195	93	102
PCT9401	MV	790	129	0	0	6	123	73	50
PCT9401	ED	248	176	0	0	14	162	124	38
PCT9401	TO	1038	305	0	0	20	285	197	88
PCT9402	MV	772	120	0	0	10	110	65	45
PCT9402	ED	245	159	0	0	12	147	95	52
PCT9402	TO	1017	279	0	0	22	257	160	97
PCT9403	MV	731	125	0	0	4	121	62	59
PCT9403	ED	190	123	0	0	12	111	79	32
PCT9403	TO	921	248	0	0	16	232	141	91
PCT9404	MV	751	115	0	0	13	102	54	48
PCT9404	ED	193	154	0	0	18	136	85	51
PCT9404	TO	944	269	0	0	31	238	139	99
PCT9405	MV	626	106	0	0	16	90	45	45
PCT9405	ED	154	104	0	0	5	99	58	41
PCT9405	TO	780	210	0	0	21	189	103	86
PCT9406	MV	694	111	0	0	9	102	54	48
PCT9406	ED	189	150	0	0	11	139	70	69
PCT9406	TO	883	261	0	0	20	241	124	117
PCT9407	MV	712	123	0	0	14	109	54	55
PCT9407	ED	201	131	0	0	23	108	61	47
PCT9407	TO	913	254	0	0	37	217	115	102
PCT9408	MV	708	104	0	0	13	91	54	37
PCT9408	ED	155	125	0	0	10	115	77	38
PCT9408	TO	863	229	0	0	23	206	131	75
PCT9409	MV	443	81	0	0	5	76	39	37
PCT9409	ED	158	127	0	0	9	118	83	35
PCT9409	TO	601	208	0	0	14	194	122	72
PCT9411	MV	815	106	0	0	7	99	65	34
PCT9411	ED	192	135	0	0	10	125	85	40
PCT9411	TO	1007	241	0	0	17	224	150	74
PCT9412	MV	667	128	0	0	12	116	51	65
PCT9412	ED	203	138	0	0	14	124	75	49
PCT9412	TO	870	266	0	0	26	240	126	114
PCT9413	MV	756	130	0	0	14	116	55	61
PCT9413	ED	180	127	0	0	11	116	76	40
PCT9413	TO	936	257	0	0	25	232	131	101
PCT9414	MV	733	156	0	0	14	142	79	63
PCT9414	ED	187	107	0	0	10	97	49	48
PCT9414	TO	920	263	0	0	24	239	128	111
PCT9415	MV	633	112	0	0	13	99	50	49
PCT9415	ED	155	96	0	0	8	88	53	35
PCT9415	TO	788	208	0	0	21	187	103	84
PCT9416	MV	768	157	0	0	21	136	63	73
PCT9416	ED	231	143	0	0	13	130	70	60
PCT9416	TO	999	300	0	0	34	266	133	133
PCT9417	MV	628	143	0	0	11	132	56	76
PCT9417	ED	146	110	0	0	7	103	60	43
PCT9417	TO	774	253	0	0	18	235	116	119
PCT9418	MV	627	129	0	0	15	114	46	68
PCT9418	ED	192	122	0	0	10	112	71	41
PCT9418	TO	819	251	0	0	25	226	117	109
PCT9419	MV	736	144	0	0	12	132	54	78
PCT9419	ED	173	107	0	0	10	97	43	54
PCT9419	TO	909	251	0	0	22	229	97	132
PCT9421	MV	751	128	0	0	8	120	60	60
PCT9421	ED	174	112	0	0	9	103	54	49
PCT9421	TO	925	240	0	0	17	223	114	109
PCT9422	MV	831	153	0	0	17	136	67	69
PCT9422	ED	270	145	0	0	17	128	77	51
PCT9422	TO	1101	298	0	0	34	264	144	120
PCT9423	MV	710	100	0	0	7	93	45	48
PCT9423	ED	194	121	0	0	11	110	62	48
PCT9423	TO	904	221	0	0	18	203	107	96
PCT9424	MV	795	136	0	0	11	125	71	54
PCT9424	ED	214	114	0	0	12	102	60	42
PCT9424	TO	1009	250	0	0	23	227	131	96
PCT9425	MV	789	134	0	0	19	115	60	55
PCT9425	ED	187	114	0	0	14	100	63	37
PCT9425	TO	976	248	0	0	33	215	123	92
PCT9426	MV	693	110	0	0	11	99	39	60
PCT9426	ED	160	104	0	0	17	87	40	47
PCT9426	TO	853	214	0	0	28	186	79	107
PCT9427	MV	795	154	0	0	10	144	57	87
PCT9427	ED	192	115	0	0	19	96	51	45
PCT9427	TO	987	269	0	0	29	240	108	132
PCT9428	MV	809	136	0	0	12	124	60	64
PCT9428	ED	181	113	0	0	13	100	59	41
PCT9428	TO	990	249	0	0	25	224	119	105
PCT9429	MV	705	120	0	0	7	113	42	71
PCT9429	ED	201	124	0	0	18	106	53	53
PCT9429	TO	906	244	0	0	25	219	95	124
PCT9431	MV	831	154	0	0	15	139	49	90
PCT9431	ED	205	125	0	0	9	116	66	50
PCT9431	TO	1036	279	0	0	24	255	115	140
PCT9432	MV	742	134	0	0	12	122	60	62
PCT9432	ED	216	117	0	0	13	104	53	51
PCT9432	TO	958	251	0	0	25	226	113	113
PCT9433	MV	790	155	0	0	18	137	61	76
PCT9433	ED	168	93	0	0	9	84	34	50
PCT9433	TO	958	248	0	0	27	221	95	126
PCT9434	MV	779	132	0	0	9	123	60	63
PCT9434	ED	233	162	0	0	21	141	81	60
PCT9434	TO	1012	294	0	0	30	264	141	123
PCT9435	MV	774	141	0	0	14	127	59	68
PCT9435	ED	230	157	0	0	10	147	97	50
PCT9435	TO	1004	298	0	0	24	274	156	118
PCT9436	MV	840	154	0	0	10	144	53	91
PCT9436	ED	228	129	0	0	15	114	53	61
PCT9436	TO	1068	283	0	0	25	258	106	152
PCT9437	MV	733	192	0	0	17	175	81	94
PCT9437	ED	194	130	0	0	9	121	75	46
PCT9437	TO	927	322	0	0	26	296	156	140
PCT9438	MV	833	179	0	0	13	166	73	93
PCT9438	ED	156	83	0	0	6	77	41	36
PCT9438	TO	989	262	0	0	19	243	114	129
PCT9439	MV	718	123	0	0	9	114	37	77
PCT9439	ED	199	111	0	0	15	96	52	44
PCT9439	TO	917	234	0	0	24	210	89	121
PCT9441	MV	772	134	0	0	12	122	73	49
PCT9441	ED	199	125	0	0	18	107	67	40
PCT9441	TO	971	259	0	0	30	229	140	89
PCT9442	MV	825	133	0	0	17	116	58	58
PCT9442	ED	215	156	0	0	14	142	79	63
PCT9442	TO	1040	289	0	0	31	258	137	121
PCT9443	MV	758	142	0	0	17	125	62	63
PCT9443	ED	197	109	0	1	10	98	58	40
PCT9443	TO	955	251	0	1	27	223	120	103
PCT9444	MV	760	144	0	0	8	136	57	79
PCT9444	ED	205	94	0	0	12	82	45	37
PCT9444	TO	965	238	0	0	20	218	102	116
PCT9445	MV	820	143	0	0	11	132	47	85
PCT9445	ED	176	113	0	0	10	103	58	45
PCT9445	TO	996	256	0	0	21	235	105	130
PCT9446	MV	899	178	0	0	17	161	59	102
PCT9446	ED	217	145	0	0	16	129	71	58
PCT9446	TO	1116	323	0	0	33	290	130	160
PCT9447	MV	726	127	0	0	10	117	54	63
PCT9447	ED	195	143	0	0	13	130	64	66
PCT9447	TO	921	270	0	0	23	247	118	129
PCT9448	MV	737	143	0	0	8	135	63	72
PCT9448	ED	203	127	0	0	12	115	72	43
PCT9448	TO	940	270	0	0	20	250	135	115
PCT9449	MV	717	132	0	0	11	121	51	70
PCT9449	ED	164	96	0	1	9	86	45	41
PCT9449	TO	881	228	0	1	20	207	96	111
PCT9451	MV	353	55	0	0	4	51	19	32
PCT9451	ED	88	54	0	0	5	49	29	20
PCT9451	TO	441	109	0	0	9	100	48	52
PCT9452	MV	646	108	0	0	14	94	43	51
PCT9452	ED	196	134	0	0	14	120	54	66
PCT9452	TO	842	242	0	0	28	214	97	117
PCT9453	MV	408	99	0	0	8	91	35	56
PCT9453	ED	116	70	0	0	7	63	27	36
PCT9453	TO	524	169	0	0	15	154	62	92
PCT9501	MV	158	36	0	0	6	30	21	9
PCT9501	ED	-8	0	0	0	0	0	0	0
PCT9501	TO	150	36	0	0	6	30	21	9
PCT9502	MV	291	41	0	0	4	37	21	16
PCT9502	ED	-40	0	0	0	0	0	0	0
PCT9502	TO	251	41	0	0	4	37	21	16
PCT9503	MV	549	109	0	0	18	91	49	42
PCT9503	ED	151	82	0	0	7	75	47	28
PCT9503	TO	700	191	0	0	25	166	96	70
PCT9505	MV	589	112	0	0	13	99	62	37
PCT9505	ED	176	110	0	0	10	100	57	43
PCT9505	TO	765	222	0	0	23	199	119	80
PCT9506	MV	547	76	0	0	5	71	37	34
PCT9506	ED	207	128	0	0	16	112	81	31
PCT9506	TO	754	204	0	0	21	183	118	65
PCT9507	MV	556	90	0	0	11	79	51	28
PCT9507	ED	160	152	0	0	17	135	79	56
PCT9507	TO	716	242	0	0	28	214	130	84
PCT9508	MV	627	101	0	0	3	98	66	32
PCT9508	ED	153	132	0	0	10	122	80	42
PCT9508	TO	780	233	0	0	13	220	146	74
PCT9509	MV	585	85	0	0	2	83	45	38
PCT9509	ED	142	121	0	0	8	113	80	33
PCT9509	TO	727	206	0	0	10	196	125	71
PCT9511	MV	456	56	0	0	5	51	26	25
PCT9511	ED	178	120	0	0	10	110	66	44
PCT9511	TO	634	176	0	0	15	161	92	69
PCT9512	MV	614	97	0	0	14	83	48	35
PCT9512	ED	163	132	0	0	10	122	80	42
PCT9512	TO	777	229	0	0	24	205	128	77
PCT9513	MV	686	104	0	0	13	91	58	33
PCT9513	ED	191	126	0	0	11	115	84	31
PCT9513	TO	877	230	0	0	24	206	142	64
PCT9514	MV	713	95	0	0	9	86	48	38
PCT9514	ED	183	167	0	0	19	148	104	44
PCT9514	TO	896	262	0	0	28	234	152	82
PCT9515	MV	541	94	0	0	9	85	49	36
PCT9515	ED	171	133	0	0	14	119	68	51
PCT9515	TO	712	227	0	0	23	204	117	87
PCT9516	MV	705	128	0	0	9	119	79	40
PCT9516	ED	184	157	0	0	13	144	83	61
PCT9516	TO	889	285	0	0	22	263	162	101
PCT9517	MV	624	125	0	0	8	117	62	55
PCT9517	ED	164	135	0	0	22	113	82	31
PCT9517	TO	788	260	0	0	30	230	144	86
PCT9518	MV	641	87	0	0	6	81	49	32
PCT9518	ED	147	146	0	0	10	136	91	45
PCT9518	TO	788	233	0	0	16	217	140	77
PCT9519	MV	692	105	0	0	8	97	62	35
PCT9519	ED	199	170	0	0	14	156	98	58
PCT9519	TO	891	275	0	0	22	253	160	93
PCT9521	MV	684	115	0	0	6	109	65	44
PCT9521	ED	217	190	0	0	19	171	108	63
PCT9521	TO	901	305	0	0	25	280	173	107
PCT9701	MV	498	95	0	0	7	88	57	31
PCT9701	ED	156	135	0	0	9	126	80	46
PCT9701	TO	654	230	0	0	16	214	137	77
PCT9702	MV	553	88	0	0	10	78	43	35
PCT9702	ED	167	143	0	0	10	133	82	51
PCT9702	TO	720	231	0	0	20	211	125	86
PCT9703	MV	808	144	0	0	14	130	63	67
PCT9703	ED	183	142	0	0	13	129	72	57
PCT9703	TO	991	286	0	0	27	259	135	124
PCT9704	MV	759	150	0	0	15	135	62	73
PCT9704	ED	200	196	0	0	20	176	109	67
PCT9704	TO	959	346	0	0	35	311	171	140
PCT9705	MV	752	155	0	0	11	144	75	69
PCT9705	ED	177	142	0	0	14	128	76	52
PCT9705	TO	929	297	0	0	25	272	151	121
PCT9706	MV	57	7	0	0	0	7	3	4
PCT9706	ED	-8	0	0	0	0	0	0	0
PCT9706	TO	49	7	0	0	0	7	3	4
PCT9707	MV	686	138	0	0	8	130	49	81
PCT9707	ED	140	101	0	0	11	90	42	48
PCT9707	TO	826	239	0	0	19	220	91	129
PCT9708	MV	785	159	0	0	20	139	74	65
PCT9708	ED	176	157	0	0	15	142	85	57
PCT9708	TO	961	316	0	0	35	281	159	122
PCT9709	MV	829	139	0	0	8	131	57	74
PCT9709	ED	211	178	0	0	14	164	89	75
PCT9709	TO	1040	317	0	0	22	295	146	149
PCT9711	MV	502	119	0	0	13	106	44	62
PCT9711	ED	144	138	0	0	14	124	57	67
PCT9711	TO	646	257	0	0	27	230	101	129
PCT9712	MV	534	125	0	0	16	109	38	71
PCT9712	ED	127	116	0	0	7	109	51	58
PCT9712	TO	661	241	0	0	23	218	89	129
PCT9713	MV	746	157	0	0	11	146	56	90
PCT9713	ED	204	137	0	0	14	123	68	55
PCT9713	TO	950	294	0	0	25	269	124	145
PCT9714	MV	792	181	0	0	12	169	50	119
PCT9714	ED	159	133	0	0	8	125	58	67
PCT9714	TO	951	314	0	0	20	294	108	186
PCT9715	MV	449	100	0	0	11	89	20	69
PCT9715	ED	130	134	0	0	8	126	42	84
PCT9715	TO	579	234	0	0	19	215	62	153
PCT9716	MV	743	152	0	0	16	136	58	78
PCT9716	ED	223	164	0	0	18	146	73	73
PCT9716	TO	966	316	0	0	34	282	131	151
PCT9717	MV	750	138	0	0	9	129	46	83
PCT9717	ED	227	144	0	0	15	129	58	71
PCT9717	TO	977	282	0	0	24	258	104	154
PCT9718	MV	742	171	0	0	19	152	73	79
PCT9718	ED	159	144	0	0	12	132	56	76
PCT9718	TO	901	315	0	0	31	284	129	155
PCT9719	MV	747	153	0	0	10	143	47	96
PCT9719	ED	173	150	0	0	8	142	59	83
PCT9719	TO	920	303	0	0	18	285	106	179
PCT9721	MV	498	91	0	0	5	86	29	57
PCT9721	ED	164	133	0	0	8	125	46	79
PCT9721	TO	662	224	0	0	13	211	75	136
PCT9722	MV	511	135	0	0	5	130	54	76
PCT9722	ED	86	76	0	0	9	67	29	38
PCT9722	TO	597	211	0	0	14	197	83	114
PCT9723	MV	434	107	0	0	5	102	32	70
PCT9723	ED	74	44	0	0	4	40	10	30
PCT9723	TO	508	151	0	0	9	142	42	100
PCT9724	MV	847	189	0	0	14	175	53	122
PCT9724	ED	173	99	0	0	7	92	39	53
PCT9724	TO	1020	288	0	0	21	267	92	175
PCT9725	MV	800	166	0	0	11	155	56	99
PCT9725	ED	171	95	0	0	11	84	25	59
PCT9725	TO	971	261	0	0	22	239	81	158
PCT9726	MV	523	62	0	0	4	58	40	18
PCT9726	ED	93	102	0	0	9	93	59	34
PCT9726	TO	616	164	0	0	13	151	99	52
PCT9727	MV	400	89	0	0	7	82	25	57
PCT9727	ED	60	33	0	0	5	28	8	20
PCT9727	TO	460	122	0	0	12	110	33	77
PCT9728	MV	750	178	0	0	8	170	47	123
PCT9728	ED	213	137	0	0	16	121	45	76
PCT9728	TO	963	315	0	0	24	291	92	199
PCT9729	MV	654	148	0	0	10	138	35	103
PCT9729	ED	164	128	0	0	6	122	38	84
PCT9729	TO	818	276	0	0	16	260	73	187
PCT9731	MV	436	86	0	0	10	76	19	57
PCT9731	ED	143	111	0	0	7	104	32	72
PCT9731	TO	579	197	0	0	17	180	51	129
PCT9732	MV	78	16	0	0	0	16	6	10
PCT9732	ED	-5	0	0	0	0	0	0	0
PCT9732	TO	73	16	0	0	0	16	6	10
PCT9733	MV	260	55	0	0	2	53	20	33
PCT9733	ED	-20	0	0	0	0	0	0	0
PCT9733	TO	240	55	0	0	2	53	20	33
PCT9734	MV	473	111	0	0	9	102	38	64
PCT9734	ED	131	109	0	0	9	100	34	66
PCT9734	TO	604	220	0	0	18	202	72	130
PCT9735	MV	650	140	0	0	9	131	52	79
PCT9735	ED	170	132	0	0	16	116	46	70
PCT9735	TO	820	272	0	0	25	247	98	149
PCT9736	MV	585	126	0	0	11	115	49	66
PCT9736	ED	151	151	0	0	13	138	63	75
PCT9736	TO	736	277	0	0	24	253	112	141
PCT9737	MV	636	172	0	0	15	157	66	91
PCT9737	ED	155	135	0	1	7	127	64	63
PCT9737	TO	791	307	0	1	22	284	130	154
PCT9738	MV	684	152	0	0	14	138	80	58
PCT9738	ED	154	64	0	0	5	59	30	29
PCT9738	TO	838	216	0	0	19	197	110	87
PCT9739	MV	619	86	0	0	4	82	54	28
PCT9739	ED	170	88	0	0	6	82	70	12
PCT9739	TO	789	174	0	0	10	164	124	40
PCT9741	MV	326	15	0	0	1	14	12	2
PCT9741	ED	115	10	0	0	2	8	6	2
PCT9741	TO	441	25	0	0	3	22	18	4
PCT9742	MV	529	86	0	0	6	80	28	52
PCT9742	ED	166	98	0	0	9	89	39	50
PCT9742	TO	695	184	0	0	15	169	67	102
PCT9743	MV	891	161	0	0	12	149	82	67
PCT9743	ED	249	170	0	0	19	151	114	37
PCT9743	TO	1140	331	0	0	31	300	196	104
PCT9744	MV	739	141	0	0	14	127	69	58
PCT9744	ED	204	121	0	0	16	105	73	32
PCT9744	TO	943	262	0	0	30	232	142	90
PCT9745	MV	745	120	0	0	9	111	72	39
PCT9745	ED	247	128	0	0	12	116	80	36
PCT9745	TO	992	248	0	0	21	227	152	75
PCT9746	MV	711	146	0	0	5	141	64	77
PCT9746	ED	192	118	0	0	11	107	44	63
PCT9746	TO	903	264	0	0	16	248	108	140
PCT9747	MV	766	132	0	0	12	120	59	61
PCT9747	ED	210	145	0	0	13	132	68	64
PCT9747	TO	976	277	0	0	25	252	127	125
PCT9748	MV	746	149	0	0	11	138	62	76
PCT9748	ED	167	116	0	0	11	105	54	51
PCT9748	TO	913	265	0	0	22	243	116	127
PCT9749	MV	747	99	0	0	5	94	64	30
PCT9749	ED	191	108	0	0	9	99	63	36
PCT9749	TO	938	207	0	0	14	193	127	66
PCT9751	MV	854	174	0	0	14	160	76	84
PCT9751	ED	217	151	0	0	17	134	65	69
PCT9751	TO	1071	325	0	0	31	294	141	153
PCT9752	MV	563	145	0	0	10	135	55	80
PCT9752	ED	134	108	0	0	9	99	51	48
PCT9752	TO	697	253	0	0	19	234	106	128
PCT9753	MV	615	108	0	0	7	101	54	47
PCT9753	ED	147	123	0	0	3	120	67	53
PCT9753	TO	762	231	0	0	10	221	121	100
PCT9754	MV	542	104	0	0	6	98	58	40
PCT9754	ED	165	113	0	0	9	104	62	42
PCT9754	TO	707	217	0	0	15	202	120	82
PCT9755	MV	441	86	0	0	9	77	38	39
PCT9755	ED	139	99	0	0	7	92	42	50
PCT9755	TO	580	185	0	0	16	169	80	89
PCT9756	MV	798	158	0	0	17	141	61	80
PCT9756	ED	169	106	0	0	10	96	57	39
PCT9756	TO	967	264	0	0	27	237	118	119
PCT9801	MV	320	63	0	0	10	53	28	25
PCT9801	ED	88	52	0	0	5	47	24	23
PCT9801	TO	408	115	0	0	15	100	52	48
PCT9900	MV	0	0	0	0	0	0	0	0
PCT9900	ED	0	0	0	0	0	0	0	0
PCT9900	TO	0	0	0	0	0	0	0	0
PCT9901	MV	0	0	0	0	0	0	0	0
PCT9901	ED	0	0	0	0	0	0	0	0
PCT9901	TO	0	0	0	0	0	0	0	0
PCT9902	MV	0	0	0	0	0	0	0	0
PCT9902	ED	0	0	0	0	0	0	0	0
PCT9902	TO	0	0	0	0	0	0	0	0
CONG12	MV	354748	63860	0	9	5613	58238	30725	27513
CONG12	ED	91100	65251	0	12	6588	58651	34709	23942
CONG12	TO	445848	129111	0	21	12201	116889	65434	51455
CONG14	MV	46263	8566	0	0	636	7930	3737	4193
CONG14	ED	11788	6926	0	1	607	6318	3442	2876
CONG14	TO	58051	15492	0	1	1243	14248	7179	7069
ASSM17	MV	232212	41818	0	6	3611	38201	21187	17014
ASSM17	ED	60210	41964	0	8	4113	37843	23141	14702
ASSM17	TO	292422	83782	0	14	7724	76044	44328	31716
ASSM19	MV	168799	30608	0	3	2638	27967	13275	14692
ASSM19	ED	42678	30213	0	5	3082	27126	15010	12116
ASSM19	TO	211477	60821	0	8	5720	55093	28285	26808
SUPV1	MV	33800	6168	0	0	534	5634	2972	2662
SUPV1	ED	9316	6893	0	1	670	6222	3738	2484
SUPV1	TO	43116	13061	0	1	1204	11856	6710	5146
SUPV2	MV	41378	7543	0	3	753	6787	2778	4009
SUPV2	ED	8668	7551	0	1	979	6571	3037	3534
SUPV2	TO	50046	15094	0	4	1732	13358	5815	7543
SUPV3	MV	31862	5929	0	0	580	5349	2806	2543
SUPV3	ED	7515	5109	0	1	575	4533	2646	1887
SUPV3	TO	39377	11038	0	1	1155	9882	5452	4430
SUPV4	MV	34929	6292	0	0	565	5727	2674	3053
SUPV4	ED	9165	5869	0	2	584	5283	3054	2229
SUPV4	TO	44094	12161	0	2	1149	11010	5728	5282
SUPV5	MV	41848	6933	0	1	623	6309	3763	2546
SUPV5	ED	11052	8955	0	1	891	8063	5138	2925
SUPV5	TO	52900	15888	0	2	1514	14372	8901	5471
SUPV6	MV	35635	6264	0	2	573	5689	3139	2550
SUPV6	ED	8060	4327	0	2	498	3827	2346	1481
SUPV6	TO	43695	10591	0	4	1071	9516	5485	4031
SUPV7	MV	38007	7748	0	0	618	7130	3126	4004
SUPV7	ED	9436	7178	0	1	622	6555	3307	3248
SUPV7	TO	47443	14926	0	1	1240	13685	6433	7252
SUPV8	MV	46274	9322	0	1	754	8567	4810	3757
SUPV8	ED	11903	11078	0	0	1040	10038	5955	4083
SUPV8	TO	58177	20400	0	1	1794	18605	10765	7840
SUPV9	MV	33102	5788	0	1	416	5371	3282	2089
SUPV9	ED	10161	7052	0	3	574	6475	4353	2122
SUPV9	TO	43263	12840	0	4	990	11846	7635	4211
SUPV10	MV	33679	5334	0	1	455	4878	2569	2309
SUPV10	ED	9434	4180	0	0	398	3782	2272	1510
SUPV10	TO	43113	9514	0	1	853	8660	4841	3819
SUPV11	MV	30497	5105	0	0	378	4727	2543	2184
SUPV11	ED	8178	3985	0	1	364	3620	2305	1315
SUPV11	TO	38675	9090	0	1	742	8347	4848	3499
NEIG1	MV	15417	2302	0	0	204	2098	1110	988
NEIG1	ED	5068	1543	0	0	142	1401	850	551
NEIG1	TO	20485	3845	0	0	346	3499	1960	1539
NEIG2	MV	14005	2518	0	0	271	2247	1157	1090
NEIG2	ED	3262	2161	0	0	270	1891	1051	840
NEIG2	TO	17267	4679	0	0	541	4138	2208	1930
NEIG3	MV	21971	4094	0	1	391	3702	2228	1474
NEIG3	ED	6048	3247	0	1	338	2908	1959	949
NEIG3	TO	28019	7341	0	2	729	6610	4187	2423
NEIG4	MV	5619	1283	0	0	106	1177	615	562
NEIG4	ED	1441	1236	0	0	132	1104	564	540
NEIG4	TO	7060	2519	0	0	238	2281	1179	1102
NEIG5	MV	22639	3890	0	0	303	3587	1928	1659
NEIG5	ED	5954	2958	0	1	275	2682	1670	1012
NEIG5	TO	28593	6848	0	1	578	6269	3598	2671
NEIG6	MV	11497	1751	0	1	141	1609	980	629
NEIG6	ED	2365	2735	0	1	263	2471	1542	929
NEIG6	TO	13862	4486	0	2	404	4080	2522	1558
NEIG7	MV	9723	1535	0	0	107	1428	768	660
NEIG7	ED	2672	1293	0	0	113	1180	779	401
NEIG7	TO	12395	2828	0	0	220	2608	1547	1061
NEIG8	MV	7616	1294	0	0	99	1195	703	492
NEIG8	ED	2042	1820	0	0	173	1647	1026	621
NEIG8	TO	9658	3114	0	0	272	2842	1729	1113
NEIG9	MV	6608	1199	0	0	88	1111	550	561
NEIG9	ED	1650	921	0	0	91	830	506	324
NEIG9	TO	8258	2120	0	0	179	1941	1056	885
NEIG10	MV	8150	1365	0	0	114	1251	653	598
NEIG10	ED	1872	1658	0	1	168	1489	861	628
NEIG10	TO	10022	3023	0	1	282	2740	1514	1226
NEIG11	MV	33459	5852	0	3	609	5240	2159	3081
NEIG11	ED	5981	5701	0	1	779	4921	2309	2612
NEIG11	TO	39440	11553	0	4	1388	10161	4468	5693
NEIG12	MV	23496	3892	0	0	267	3625	2345	1280
NEIG12	ED	7509	5267	0	2	428	4837	3346	1491
NEIG12	TO	31005	9159	0	2	695	8462	5691	2771
NEIG14	MV	6784	1294	0	0	111	1183	743	440
NEIG14	ED	1949	1783	0	1	155	1627	1079	548
NEIG14	TO	8733	3077	0	1	266	2810	1822	988
NEIG15	MV	5763	1099	0	0	98	1001	481	520
NEIG15	ED	1325	1007	0	0	110	897	486	411
NEIG15	TO	7088	2106	0	0	208	1898	967	931
NEIG13	MV	13536	2683	0	1	220	2462	1343	1119
NEIG13	ED	3452	3361	0	0	301	3060	1751	1309
NEIG13	TO	16988	6044	0	1	521	5522	3094	2428
NEIG26	MV	7824	1429	0	1	108	1320	656	664
NEIG26	ED	1808	941	0	0	88	853	509	344
NEIG26	TO	9632	2370	0	1	196	2173	1165	1008
NEIG16	MV	14588	2407	0	1	204	2202	1114	1088
NEIG16	ED	2768	2400	0	1	257	2142	1262	880
NEIG16	TO	17356	4807	0	2	461	4344	2376	1968
NEIG17	MV	29398	5395	0	0	472	4923	2589	2334
NEIG17	ED	8227	5965	0	0	577	5388	3232	2156
NEIG17	TO	37625	11360	0	0	1049	10311	5821	4490
NEIG19	MV	7156	1337	0	0	97	1240	744	496
NEIG19	ED	2415	1863	0	0	162	1701	1026	675
NEIG19	TO	9571	3200	0	0	259	2941	1770	1171
NEIG18	MV	6453	1319	0	0	121	1198	465	733
NEIG18	ED	1568	1453	0	0	165	1288	568	720
NEIG18	TO	8021	2772	0	0	286	2486	1033	1453
NEIG20	MV	20838	3692	0	1	324	3367	1728	1639
NEIG20	ED	4239	2417	0	1	279	2137	1200	937
NEIG20	TO	25077	6109	0	2	603	5504	2928	2576
NEIG21	MV	34486	6211	0	0	560	5651	2635	3016
NEIG21	ED	9007	5742	0	2	575	5165	2971	2194
NEIG21	TO	43493	11953	0	2	1135	10816	5606	5210
NEIG22	MV	15344	3230	0	0	255	2975	1657	1318
NEIG22	ED	3549	3598	0	0	332	3266	1985	1281
NEIG22	TO	18893	6828	0	0	587	6241	3642	2599
NEIG23	MV	6627	1071	0	0	92	979	510	469
NEIG23	ED	1861	598	0	0	57	541	323	218
NEIG23	TO	8488	1669	0	0	149	1520	833	687
NEIG24	MV	28380	6028	0	0	486	5542	2314	3228
NEIG24	ED	6994	5659	0	1	484	5174	2462	2712
NEIG24	TO	35374	11687	0	1	970	10716	4776	5940
NEIG25	MV	23634	4256	0	0	401	3855	2287	1568
NEIG25	ED	7862	4850	0	0	481	4369	2834	1535
NEIG25	TO	31496	9106	0	0	882	8224	5121	3103
