area_id	subtotal_type	RSReg	RSCst	RSRej	RSOvr	RSUnd	RSTot	5:YES	6:NO
ALLPCTS	TO	503899	304487	0	59	22773	281655	233310	48345
ALLPCTS	ED	101024	106604	0	19	9729	96856	82711	14145
ALLPCTS	MV	402875	197883	0	40	13044	184799	150599	34200
PCT1101	MV	448	216	0	0	14	202	155	47
PCT1101	ED	114	93	0	0	9	84	73	11
PCT1101	TO	562	309	0	0	23	286	228	58
PCT1102	MV	774	370	0	0	15	355	251	104
PCT1102	ED	230	209	0	0	15	194	153	41
PCT1102	TO	1004	579	0	0	30	549	404	145
PCT1103	MV	749	372	0	0	19	353	271	82
PCT1103	ED	222	193	0	0	12	181	142	39
PCT1103	TO	971	565	0	0	31	534	413	121
PCT1104	MV	751	343	0	0	12	331	263	68
PCT1104	ED	267	169	0	0	16	153	122	31
PCT1104	TO	1018	512	0	0	28	484	385	99
PCT1106	MV	598	255	0	0	16	239	163	76
PCT1106	ED	173	148	0	1	11	136	108	28
PCT1106	TO	771	403	0	1	27	375	271	104
PCT1107	MV	612	288	0	0	14	274	187	87
PCT1107	ED	139	124	0	0	10	114	98	16
PCT1107	TO	751	412	0	0	24	388	285	103
PCT1108	MV	725	360	0	0	17	343	272	71
PCT1108	ED	198	158	0	0	14	144	119	25
PCT1108	TO	923	518	0	0	31	487	391	96
PCT1109	MV	653	285	0	0	12	273	184	89
PCT1109	ED	169	140	0	0	9	131	108	23
PCT1109	TO	822	425	0	0	21	404	292	112
PCT1111	MV	849	354	0	0	17	337	235	102
PCT1111	ED	197	187	0	0	13	174	139	35
PCT1111	TO	1046	541	0	0	30	511	374	137
PCT1112	MV	643	280	0	0	14	266	200	66
PCT1112	ED	159	118	0	0	7	111	95	16
PCT1112	TO	802	398	0	0	21	377	295	82
PCT1113	MV	675	286	0	0	15	271	190	81
PCT1113	ED	120	108	0	0	15	93	78	15
PCT1113	TO	795	394	0	0	30	364	268	96
PCT1114	MV	769	328	0	0	22	306	240	66
PCT1114	ED	222	166	0	0	19	147	129	18
PCT1114	TO	991	494	0	0	41	453	369	84
PCT1115	MV	743	295	0	0	16	279	201	78
PCT1115	ED	193	131	0	0	11	120	98	22
PCT1115	TO	936	426	0	0	27	399	299	100
PCT1116	MV	715	309	0	0	18	291	217	74
PCT1116	ED	216	195	0	0	17	178	156	22
PCT1116	TO	931	504	0	0	35	469	373	96
PCT1117	MV	665	259	0	0	14	245	184	61
PCT1117	ED	181	146	0	0	16	130	112	18
PCT1117	TO	846	405	0	0	30	375	296	79
PCT1118	MV	846	365	0	0	16	349	247	102
PCT1118	ED	219	163	0	0	15	148	118	30
PCT1118	TO	1065	528	0	0	31	497	365	132
PCT1119	MV	659	305	0	0	13	292	227	65
PCT1119	ED	138	117	0	0	12	105	96	9
PCT1119	TO	797	422	0	0	25	397	323	74
PCT1121	MV	556	269	0	0	20	249	165	84
PCT1121	ED	149	123	0	0	7	116	90	26
PCT1121	TO	705	392	0	0	27	365	255	110
PCT1122	MV	519	247	0	0	13	234	164	70
PCT1122	ED	118	96	0	0	8	88	72	16
PCT1122	TO	637	343	0	0	21	322	236	86
PCT1123	MV	730	258	0	0	17	241	164	77
PCT1123	ED	208	149	0	0	14	135	105	30
PCT1123	TO	938	407	0	0	31	376	269	107
PCT1124	MV	631	246	0	2	7	237	180	57
PCT1124	ED	198	120	0	0	7	113	99	14
PCT1124	TO	829	366	0	2	14	350	279	71
PCT1125	MV	919	365	0	0	31	334	232	102
PCT1125	ED	178	113	0	0	10	103	93	10
PCT1125	TO	1097	478	0	0	41	437	325	112
PCT1126	MV	812	308	0	0	16	292	223	69
PCT1126	ED	200	108	0	0	3	105	84	21
PCT1126	TO	1012	416	0	0	19	397	307	90
PCT1127	MV	743	295	0	0	12	283	188	95
PCT1127	ED	222	148	0	0	3	145	119	26
PCT1127	TO	965	443	0	0	15	428	307	121
PCT1128	MV	734	287	0	0	13	274	180	94
PCT1128	ED	145	108	0	0	11	97	80	17
PCT1128	TO	879	395	0	0	24	371	260	111
PCT1129	MV	790	314	0	0	22	292	201	91
PCT1129	ED	246	144	0	0	17	127	96	31
PCT1129	TO	1036	458	0	0	39	419	297	122
PCT1131	MV	694	280	0	0	22	258	181	77
PCT1131	ED	166	111	0	0	12	99	87	12
PCT1131	TO	860	391	0	0	34	357	268	89
PCT1132	MV	838	370	0	0	24	346	252	94
PCT1132	ED	194	103	0	0	7	96	70	26
PCT1132	TO	1032	473	0	0	31	442	322	120
PCT1133	MV	716	336	0	0	12	324	244	80
PCT1133	ED	159	113	0	0	7	106	75	31
PCT1133	TO	875	449	0	0	19	430	319	111
PCT1134	MV	585	293	0	0	11	282	180	102
PCT1134	ED	182	127	0	0	11	116	100	16
PCT1134	TO	767	420	0	0	22	398	280	118
PCT1135	MV	465	220	0	0	5	215	155	60
PCT1135	ED	91	60	0	0	1	59	49	10
PCT1135	TO	556	280	0	0	6	274	204	70
PCT1136	MV	710	342	0	0	16	326	245	81
PCT1136	ED	157	116	0	0	6	110	93	17
PCT1136	TO	867	458	0	0	22	436	338	98
PCT1141	MV	836	394	0	0	20	374	269	105
PCT1141	ED	220	184	0	0	11	173	136	37
PCT1141	TO	1056	578	0	0	31	547	405	142
PCT1142	MV	721	330	0	0	26	304	243	61
PCT1142	ED	175	119	0	0	6	113	98	15
PCT1142	TO	896	449	0	0	32	417	341	76
PCT1143	MV	824	360	0	0	22	338	242	96
PCT1143	ED	225	189	0	0	16	173	152	21
PCT1143	TO	1049	549	0	0	38	511	394	117
PCT1144	MV	727	326	0	0	10	316	220	96
PCT1144	ED	220	165	0	0	20	145	114	31
PCT1144	TO	947	491	0	0	30	461	334	127
PCT1145	MV	753	411	0	0	25	386	274	112
PCT1145	ED	152	152	0	0	12	140	112	28
PCT1145	TO	905	563	0	0	37	526	386	140
PCT1146	MV	839	364	0	0	15	349	276	73
PCT1146	ED	215	159	0	0	12	147	115	32
PCT1146	TO	1054	523	0	0	27	496	391	105
PCT1147	MV	673	310	0	0	11	299	215	84
PCT1147	ED	212	159	0	0	12	147	115	32
PCT1147	TO	885	469	0	0	23	446	330	116
PCT1148	MV	804	370	0	0	16	354	246	108
PCT1148	ED	224	158	0	0	17	141	114	27
PCT1148	TO	1028	528	0	0	33	495	360	135
PCT1149	MV	710	320	0	1	22	297	213	84
PCT1149	ED	229	160	0	0	10	150	120	30
PCT1149	TO	939	480	0	1	32	447	333	114
PCT1152	MV	710	315	0	0	17	298	222	76
PCT1152	ED	180	137	0	0	10	127	101	26
PCT1152	TO	890	452	0	0	27	425	323	102
PCT1153	MV	730	285	0	0	17	268	205	63
PCT1153	ED	210	181	0	0	14	167	128	39
PCT1153	TO	940	466	0	0	31	435	333	102
PCT7001	MV	632	331	0	0	21	310	271	39
PCT7001	ED	141	149	0	0	12	137	122	15
PCT7001	TO	773	480	0	0	33	447	393	54
PCT7002	MV	598	270	0	0	22	248	213	35
PCT7002	ED	116	142	0	0	12	130	113	17
PCT7002	TO	714	412	0	0	34	378	326	52
PCT7003	MV	759	435	0	0	24	411	351	60
PCT7003	ED	147	193	0	0	21	172	144	28
PCT7003	TO	906	628	0	0	45	583	495	88
PCT7004	MV	764	418	0	0	25	393	337	56
PCT7004	ED	149	225	0	0	23	202	172	30
PCT7004	TO	913	643	0	0	48	595	509	86
PCT7005	MV	698	351	0	0	23	328	294	34
PCT7005	ED	161	230	0	0	23	207	193	14
PCT7005	TO	859	581	0	0	46	535	487	48
PCT7006	MV	729	361	0	0	27	334	294	40
PCT7006	ED	203	238	0	0	24	214	179	35
PCT7006	TO	932	599	0	0	51	548	473	75
PCT7007	MV	777	438	0	0	30	408	351	57
PCT7007	ED	180	242	0	0	19	223	197	26
PCT7007	TO	957	680	0	0	49	631	548	83
PCT7008	MV	732	369	0	0	30	339	282	57
PCT7008	ED	177	254	0	0	24	230	197	33
PCT7008	TO	909	623	0	0	54	569	479	90
PCT7009	MV	752	391	0	0	26	365	303	62
PCT7009	ED	119	160	0	0	14	146	124	22
PCT7009	TO	871	551	0	0	40	511	427	84
PCT7011	MV	704	231	0	0	18	213	184	29
PCT7011	ED	269	142	0	0	12	130	118	12
PCT7011	TO	973	373	0	0	30	343	302	41
PCT7012	MV	999	489	0	0	34	455	392	63
PCT7012	ED	227	308	0	0	29	279	244	35
PCT7012	TO	1226	797	0	0	63	734	636	98
PCT7013	MV	984	431	0	0	27	404	363	41
PCT7013	ED	155	259	0	0	27	232	207	25
PCT7013	TO	1139	690	0	0	54	636	570	66
PCT7014	MV	610	305	0	0	18	287	255	32
PCT7014	ED	109	182	0	1	24	157	136	21
PCT7014	TO	719	487	0	1	42	444	391	53
PCT7015	MV	128	41	0	0	5	36	32	4
PCT7015	ED	-18	5	0	0	0	5	3	2
PCT7015	TO	110	46	0	0	5	41	35	6
PCT7016	MV	655	239	0	0	16	223	162	61
PCT7016	ED	277	105	0	0	8	97	86	11
PCT7016	TO	932	344	0	0	24	320	248	72
PCT7017	MV	543	182	0	0	18	164	136	28
PCT7017	ED	238	92	0	0	13	79	70	9
PCT7017	TO	781	274	0	0	31	243	206	37
PCT7018	MV	847	358	0	0	20	338	248	90
PCT7018	ED	200	103	0	0	7	96	82	14
PCT7018	TO	1047	461	0	0	27	434	330	104
PCT7019	MV	734	356	0	0	25	331	243	88
PCT7019	ED	166	112	0	0	12	100	83	17
PCT7019	TO	900	468	0	0	37	431	326	105
PCT7021	MV	679	271	0	0	18	253	207	46
PCT7021	ED	288	159	0	0	18	141	121	20
PCT7021	TO	967	430	0	0	36	394	328	66
PCT7022	MV	770	340	0	0	27	313	263	50
PCT7022	ED	193	93	0	0	5	88	83	5
PCT7022	TO	963	433	0	0	32	401	346	55
PCT7023	MV	687	331	0	0	16	315	252	63
PCT7023	ED	233	118	0	0	10	108	91	17
PCT7023	TO	920	449	0	0	26	423	343	80
PCT7024	MV	251	51	0	0	3	48	43	5
PCT7024	ED	190	35	0	0	4	31	30	1
PCT7024	TO	441	86	0	0	7	79	73	6
PCT7025	MV	316	97	0	0	5	92	79	13
PCT7025	ED	167	66	0	0	1	65	55	10
PCT7025	TO	483	163	0	0	6	157	134	23
PCT7026	MV	819	337	0	1	13	323	211	112
PCT7026	ED	191	125	0	0	14	111	86	25
PCT7026	TO	1010	462	0	1	27	434	297	137
PCT7027	MV	677	272	0	0	19	253	186	67
PCT7027	ED	219	143	0	0	13	130	109	21
PCT7027	TO	896	415	0	0	32	383	295	88
PCT7028	MV	586	221	0	0	15	206	169	37
PCT7028	ED	270	150	0	0	13	137	114	23
PCT7028	TO	856	371	0	0	28	343	283	60
PCT7029	MV	643	209	0	0	20	189	149	40
PCT7029	ED	266	81	0	0	6	75	66	9
PCT7029	TO	909	290	0	0	26	264	215	49
PCT7030	MV	654	274	0	0	9	265	168	97
PCT7030	ED	141	80	0	0	3	77	54	23
PCT7030	TO	795	354	0	0	12	342	222	120
PCT7031	MV	622	265	0	1	23	241	195	46
PCT7031	ED	72	77	0	0	11	66	56	10
PCT7031	TO	694	342	0	1	34	307	251	56
PCT7032	MV	643	266	0	0	20	246	204	42
PCT7032	ED	238	104	0	0	8	96	77	19
PCT7032	TO	881	370	0	0	28	342	281	61
PCT7033	MV	549	214	0	0	17	197	154	43
PCT7033	ED	229	136	0	0	13	123	103	20
PCT7033	TO	778	350	0	0	30	320	257	63
PCT7034	MV	620	142	0	0	15	127	118	9
PCT7034	ED	318	110	0	0	8	102	91	11
PCT7034	TO	938	252	0	0	23	229	209	20
PCT7035	MV	567	238	0	0	17	221	179	42
PCT7035	ED	152	101	0	0	9	92	80	12
PCT7035	TO	719	339	0	0	26	313	259	54
PCT7036	MV	781	267	0	0	14	253	169	84
PCT7036	ED	193	79	0	0	9	70	60	10
PCT7036	TO	974	346	0	0	23	323	229	94
PCT7037	MV	434	64	0	0	4	60	49	11
PCT7037	ED	312	63	0	0	11	52	47	5
PCT7037	TO	746	127	0	0	15	112	96	16
PCT7038	MV	758	308	0	0	20	288	194	94
PCT7038	ED	203	105	0	0	13	92	79	13
PCT7038	TO	961	413	0	0	33	380	273	107
PCT7039	MV	636	244	0	0	14	230	155	75
PCT7039	ED	201	146	0	0	7	139	100	39
PCT7039	TO	837	390	0	0	21	369	255	114
PCT7041	MV	70	29	0	0	4	25	17	8
PCT7041	ED	-4	2	0	0	0	2	1	1
PCT7041	TO	66	31	0	0	4	27	18	9
PCT7042	MV	514	224	0	0	9	215	169	46
PCT7042	ED	146	96	0	0	5	91	74	17
PCT7042	TO	660	320	0	0	14	306	243	63
PCT7043	MV	754	295	0	0	17	278	198	80
PCT7043	ED	224	121	0	0	10	111	87	24
PCT7043	TO	978	416	0	0	27	389	285	104
PCT7044	MV	586	150	0	0	5	145	117	28
PCT7044	ED	266	95	0	0	12	83	70	13
PCT7044	TO	852	245	0	0	17	228	187	41
PCT7045	MV	632	268	0	0	14	254	175	79
PCT7045	ED	154	80	0	0	9	71	50	21
PCT7045	TO	786	348	0	0	23	325	225	100
PCT7046	MV	334	134	0	0	4	130	91	39
PCT7046	ED	96	76	0	0	4	72	58	14
PCT7046	TO	430	210	0	0	8	202	149	53
PCT7047	MV	733	315	0	0	20	295	193	102
PCT7047	ED	150	100	0	0	12	88	71	17
PCT7047	TO	883	415	0	0	32	383	264	119
PCT7048	MV	685	267	0	0	12	255	195	60
PCT7048	ED	196	79	0	0	9	70	54	16
PCT7048	TO	881	346	0	0	21	325	249	76
PCT7049	MV	616	248	0	0	12	236	150	86
PCT7049	ED	210	104	0	0	6	98	81	17
PCT7049	TO	826	352	0	0	18	334	231	103
PCT7051	MV	715	311	0	0	21	290	184	106
PCT7051	ED	165	105	0	0	8	97	80	17
PCT7051	TO	880	416	0	0	29	387	264	123
PCT7052	MV	722	298	0	0	9	289	202	87
PCT7052	ED	184	135	0	0	13	122	101	21
PCT7052	TO	906	433	0	0	22	411	303	108
PCT7053	MV	542	227	0	0	29	198	148	50
PCT7053	ED	43	70	0	0	5	65	55	10
PCT7053	TO	585	297	0	0	34	263	203	60
PCT7054	MV	863	310	0	0	16	294	240	54
PCT7054	ED	273	169	0	0	10	159	122	37
PCT7054	TO	1136	479	0	0	26	453	362	91
PCT7055	MV	732	292	0	0	16	276	224	52
PCT7055	ED	94	150	0	0	20	130	113	17
PCT7055	TO	826	442	0	0	36	406	337	69
PCT7056	MV	618	277	0	0	20	257	224	33
PCT7056	ED	87	178	0	0	23	155	137	18
PCT7056	TO	705	455	0	0	43	412	361	51
PCT7101	MV	162	99	0	0	6	93	88	5
PCT7101	ED	-15	9	0	0	2	7	7	0
PCT7101	TO	147	108	0	0	8	100	95	5
PCT7201	MV	788	384	0	0	23	361	298	63
PCT7201	ED	147	194	0	0	24	170	146	24
PCT7201	TO	935	578	0	0	47	531	444	87
PCT7202	MV	708	309	0	0	23	286	226	60
PCT7202	ED	143	187	0	0	17	170	142	28
PCT7202	TO	851	496	0	0	40	456	368	88
PCT7203	MV	693	321	0	0	33	288	239	49
PCT7203	ED	186	217	0	0	24	193	160	33
PCT7203	TO	879	538	0	0	57	481	399	82
PCT7204	MV	773	425	0	0	43	382	322	60
PCT7204	ED	126	200	0	0	32	168	143	25
PCT7204	TO	899	625	0	0	75	550	465	85
PCT7205	MV	724	360	0	0	26	334	274	60
PCT7205	ED	147	203	0	0	19	184	150	34
PCT7205	TO	871	563	0	0	45	518	424	94
PCT7206	MV	299	129	0	0	10	119	98	21
PCT7206	ED	78	128	0	0	14	114	98	16
PCT7206	TO	377	257	0	0	24	233	196	37
PCT7207	MV	744	333	0	0	25	308	255	53
PCT7207	ED	123	177	0	0	15	162	143	19
PCT7207	TO	867	510	0	0	40	470	398	72
PCT7208	MV	492	254	0	0	27	227	185	42
PCT7208	ED	78	110	0	0	11	99	92	7
PCT7208	TO	570	364	0	0	38	326	277	49
PCT7209	MV	595	343	0	0	28	315	271	44
PCT7209	ED	52	82	0	0	6	76	62	14
PCT7209	TO	647	425	0	0	34	391	333	58
PCT7301	MV	813	319	0	0	16	303	253	50
PCT7301	ED	201	153	0	0	16	137	112	25
PCT7301	TO	1014	472	0	0	32	440	365	75
PCT7302	MV	713	352	0	0	22	330	269	61
PCT7302	ED	136	153	0	0	14	139	126	13
PCT7302	TO	849	505	0	0	36	469	395	74
PCT7303	MV	869	376	0	0	23	353	289	64
PCT7303	ED	199	254	0	0	36	218	185	33
PCT7303	TO	1068	630	0	0	59	571	474	97
PCT7304	MV	802	367	0	0	27	340	261	79
PCT7304	ED	199	239	0	0	16	223	200	23
PCT7304	TO	1001	606	0	0	43	563	461	102
PCT7305	MV	714	390	0	0	26	364	275	89
PCT7305	ED	153	206	0	0	16	190	156	34
PCT7305	TO	867	596	0	0	42	554	431	123
PCT7306	MV	801	375	0	0	36	339	265	74
PCT7306	ED	243	222	0	1	41	180	153	27
PCT7306	TO	1044	597	0	1	77	519	418	101
PCT7307	MV	605	275	0	0	13	262	212	50
PCT7307	ED	169	154	0	0	19	135	118	17
PCT7307	TO	774	429	0	0	32	397	330	67
PCT7308	MV	520	257	0	0	10	247	196	51
PCT7308	ED	105	174	0	0	17	157	133	24
PCT7308	TO	625	431	0	0	27	404	329	75
PCT7309	MV	691	324	0	0	29	295	253	42
PCT7309	ED	167	213	0	0	23	190	165	25
PCT7309	TO	858	537	0	0	52	485	418	67
PCT7311	MV	698	336	0	0	23	313	268	45
PCT7311	ED	208	250	0	0	20	230	205	25
PCT7311	TO	906	586	0	0	43	543	473	70
PCT7312	MV	700	397	0	0	26	371	301	70
PCT7312	ED	110	176	0	0	16	160	132	28
PCT7312	TO	810	573	0	0	42	531	433	98
PCT7313	MV	819	375	0	0	23	352	285	67
PCT7313	ED	184	181	0	0	27	154	132	22
PCT7313	TO	1003	556	0	0	50	506	417	89
PCT7314	MV	612	226	0	0	19	207	158	49
PCT7314	ED	147	89	0	0	15	74	65	9
PCT7314	TO	759	315	0	0	34	281	223	58
PCT7315	MV	570	207	0	0	9	198	156	42
PCT7315	ED	195	179	0	0	16	163	137	26
PCT7315	TO	765	386	0	0	25	361	293	68
PCT7316	MV	654	261	0	0	28	233	188	45
PCT7316	ED	178	161	0	0	17	144	131	13
PCT7316	TO	832	422	0	0	45	377	319	58
PCT7317	MV	744	350	0	0	25	325	263	62
PCT7317	ED	146	162	0	0	14	148	134	14
PCT7317	TO	890	512	0	0	39	473	397	76
PCT7318	MV	605	294	0	0	24	270	233	37
PCT7318	ED	118	150	0	0	25	125	97	28
PCT7318	TO	723	444	0	0	49	395	330	65
PCT7319	MV	861	346	0	0	27	319	266	53
PCT7319	ED	188	208	0	0	25	183	156	27
PCT7319	TO	1049	554	0	0	52	502	422	80
PCT7321	MV	557	202	0	0	20	182	140	42
PCT7321	ED	102	106	0	0	11	95	75	20
PCT7321	TO	659	308	0	0	31	277	215	62
PCT7322	MV	742	296	0	0	25	271	209	62
PCT7322	ED	146	56	0	0	3	53	50	3
PCT7322	TO	888	352	0	0	28	324	259	65
PCT7323	MV	790	369	0	0	34	335	284	51
PCT7323	ED	166	179	0	0	20	159	132	27
PCT7323	TO	956	548	0	0	54	494	416	78
PCT7324	MV	587	260	0	0	24	236	193	43
PCT7324	ED	150	135	0	0	13	122	101	21
PCT7324	TO	737	395	0	0	37	358	294	64
PCT7325	MV	714	328	0	0	33	295	246	49
PCT7325	ED	172	181	0	0	20	161	135	26
PCT7325	TO	886	509	0	0	53	456	381	75
PCT7326	MV	685	304	0	0	25	279	218	61
PCT7326	ED	174	187	0	0	28	159	140	19
PCT7326	TO	859	491	0	0	53	438	358	80
PCT7327	MV	561	230	0	0	24	206	152	54
PCT7327	ED	126	59	0	0	4	55	49	6
PCT7327	TO	687	289	0	0	28	261	201	60
PCT7328	MV	829	333	0	0	36	297	242	55
PCT7328	ED	173	85	0	0	18	67	59	8
PCT7328	TO	1002	418	0	0	54	364	301	63
PCT7329	MV	556	228	0	0	20	208	172	36
PCT7329	ED	95	105	0	0	15	90	79	11
PCT7329	TO	651	333	0	0	35	298	251	47
PCT7331	MV	710	363	0	0	33	330	278	52
PCT7331	ED	160	170	0	0	22	148	123	25
PCT7331	TO	870	533	0	0	55	478	401	77
PCT7332	MV	654	265	0	0	22	243	215	28
PCT7332	ED	136	173	0	0	15	158	140	18
PCT7332	TO	790	438	0	0	37	401	355	46
PCT7333	MV	822	392	0	0	34	358	297	61
PCT7333	ED	193	241	0	0	24	217	190	27
PCT7333	TO	1015	633	0	0	58	575	487	88
PCT7334	MV	688	307	0	0	17	290	253	37
PCT7334	ED	131	169	0	0	16	153	131	22
PCT7334	TO	819	476	0	0	33	443	384	59
PCT7335	MV	788	390	0	0	34	356	296	60
PCT7335	ED	146	217	0	0	24	193	178	15
PCT7335	TO	934	607	0	0	58	549	474	75
PCT7336	MV	779	405	0	1	24	380	298	82
PCT7336	ED	175	189	0	0	24	165	140	25
PCT7336	TO	954	594	0	1	48	545	438	107
PCT7337	MV	772	387	0	0	31	356	291	65
PCT7337	ED	125	143	0	0	11	132	115	17
PCT7337	TO	897	530	0	0	42	488	406	82
PCT7338	MV	770	360	0	0	28	332	274	58
PCT7338	ED	125	104	0	0	11	93	82	11
PCT7338	TO	895	464	0	0	39	425	356	69
PCT7339	MV	605	270	0	0	19	251	212	39
PCT7339	ED	150	149	0	0	10	139	121	18
PCT7339	TO	755	419	0	0	29	390	333	57
PCT7341	MV	675	292	0	0	29	263	219	44
PCT7341	ED	178	183	0	0	15	168	151	17
PCT7341	TO	853	475	0	0	44	431	370	61
PCT7342	MV	674	326	0	0	20	306	261	45
PCT7342	ED	230	269	0	1	20	248	220	28
PCT7342	TO	904	595	0	1	40	554	481	73
PCT7343	MV	554	253	0	0	19	234	214	20
PCT7343	ED	150	176	0	0	20	156	141	15
PCT7343	TO	704	429	0	0	39	390	355	35
PCT7344	MV	863	393	0	0	28	365	309	56
PCT7344	ED	201	237	0	0	24	213	186	27
PCT7344	TO	1064	630	0	0	52	578	495	83
PCT7345	MV	904	434	0	0	24	410	367	43
PCT7345	ED	210	253	0	0	21	232	209	23
PCT7345	TO	1114	687	0	0	45	642	576	66
PCT7346	MV	681	288	0	1	15	272	239	33
PCT7346	ED	208	208	0	0	25	183	166	17
PCT7346	TO	889	496	0	1	40	455	405	50
PCT7347	MV	833	371	0	1	34	336	313	23
PCT7347	ED	170	190	0	0	17	173	160	13
PCT7347	TO	1003	561	0	1	51	509	473	36
PCT7348	MV	650	279	0	0	20	259	225	34
PCT7348	ED	193	157	0	0	17	140	123	17
PCT7348	TO	843	436	0	0	37	399	348	51
PCT7349	MV	710	318	0	0	23	295	255	40
PCT7349	ED	202	178	0	0	17	161	149	12
PCT7349	TO	912	496	0	0	40	456	404	52
PCT7501	MV	456	248	0	0	24	224	175	49
PCT7501	ED	95	127	0	0	14	113	90	23
PCT7501	TO	551	375	0	0	38	337	265	72
PCT7502	MV	669	318	0	0	24	294	232	62
PCT7502	ED	120	167	0	0	22	145	128	17
PCT7502	TO	789	485	0	0	46	439	360	79
PCT7503	MV	614	286	0	0	24	262	227	35
PCT7503	ED	148	163	0	0	23	140	114	26
PCT7503	TO	762	449	0	0	47	402	341	61
PCT7504	MV	404	175	0	0	15	160	138	22
PCT7504	ED	84	92	0	0	12	80	72	8
PCT7504	TO	488	267	0	0	27	240	210	30
PCT7505	MV	729	406	0	0	33	373	347	26
PCT7505	ED	133	143	0	0	6	137	125	12
PCT7505	TO	862	549	0	0	39	510	472	38
PCT7506	MV	842	365	0	0	35	330	285	45
PCT7506	ED	158	206	0	0	23	183	176	7
PCT7506	TO	1000	571	0	0	58	513	461	52
PCT7507	MV	694	291	0	0	18	273	237	36
PCT7507	ED	262	155	0	0	10	145	128	17
PCT7507	TO	956	446	0	0	28	418	365	53
PCT7508	MV	618	375	0	0	29	346	301	45
PCT7508	ED	126	131	0	0	13	118	103	15
PCT7508	TO	744	506	0	0	42	464	404	60
PCT7509	MV	756	399	0	0	28	371	318	53
PCT7509	ED	173	184	0	0	12	172	151	21
PCT7509	TO	929	583	0	0	40	543	469	74
PCT7512	MV	476	248	0	0	19	229	193	36
PCT7512	ED	124	118	0	0	13	105	95	10
PCT7512	TO	600	366	0	0	32	334	288	46
PCT7513	MV	575	248	0	0	23	225	207	18
PCT7513	ED	231	159	0	0	26	133	122	11
PCT7513	TO	806	407	0	0	49	358	329	29
PCT7514	MV	709	242	0	0	24	218	177	41
PCT7514	ED	207	100	0	0	16	84	74	10
PCT7514	TO	916	342	0	0	40	302	251	51
PCT7515	MV	664	323	0	0	16	307	255	52
PCT7515	ED	200	131	0	0	18	113	102	11
PCT7515	TO	864	454	0	0	34	420	357	63
PCT7516	MV	773	424	0	0	27	397	339	58
PCT7516	ED	147	152	0	0	13	139	114	25
PCT7516	TO	920	576	0	0	40	536	453	83
PCT7517	MV	645	362	0	0	28	334	296	38
PCT7517	ED	223	265	0	0	25	240	216	24
PCT7517	TO	868	627	0	0	53	574	512	62
PCT7518	MV	708	395	0	0	31	364	315	49
PCT7518	ED	218	273	0	0	25	248	231	17
PCT7518	TO	926	668	0	0	56	612	546	66
PCT7519	MV	543	261	0	0	26	235	214	21
PCT7519	ED	172	194	0	0	16	178	160	18
PCT7519	TO	715	455	0	0	42	413	374	39
PCT7521	MV	597	323	0	1	18	304	275	29
PCT7521	ED	182	222	0	0	13	209	189	20
PCT7521	TO	779	545	0	1	31	513	464	49
PCT7522	MV	588	302	0	0	18	284	255	29
PCT7522	ED	171	221	0	0	28	193	175	18
PCT7522	TO	759	523	0	0	46	477	430	47
PCT7523	MV	564	285	0	0	21	264	244	20
PCT7523	ED	180	247	0	0	17	230	210	20
PCT7523	TO	744	532	0	0	38	494	454	40
PCT7524	MV	481	228	0	0	22	206	192	14
PCT7524	ED	143	152	0	0	13	139	129	10
PCT7524	TO	624	380	0	0	35	345	321	24
PCT7525	MV	594	247	0	1	25	221	203	18
PCT7525	ED	170	158	0	0	19	139	134	5
PCT7525	TO	764	405	0	1	44	360	337	23
PCT7526	MV	826	397	0	0	39	358	333	25
PCT7526	ED	162	258	0	0	28	230	212	18
PCT7526	TO	988	655	0	0	67	588	545	43
PCT7527	MV	538	296	0	0	22	274	244	30
PCT7527	ED	172	157	0	0	12	145	134	11
PCT7527	TO	710	453	0	0	34	419	378	41
PCT7529	MV	749	367	0	0	22	345	322	23
PCT7529	ED	154	259	0	0	16	243	224	19
PCT7529	TO	903	626	0	0	38	588	546	42
PCT7531	MV	714	336	0	0	22	314	293	21
PCT7531	ED	159	211	0	0	13	198	177	21
PCT7531	TO	873	547	0	0	35	512	470	42
PCT7532	MV	668	330	0	0	23	307	282	25
PCT7532	ED	167	225	0	0	22	203	172	31
PCT7532	TO	835	555	0	0	45	510	454	56
PCT7533	MV	776	405	0	0	33	372	336	36
PCT7533	ED	194	285	0	0	24	261	239	22
PCT7533	TO	970	690	0	0	57	633	575	58
PCT7534	MV	670	377	0	0	35	342	299	43
PCT7534	ED	233	259	0	0	28	231	213	18
PCT7534	TO	903	636	0	0	63	573	512	61
PCT7535	MV	606	303	0	0	21	282	252	30
PCT7535	ED	139	218	0	0	23	195	180	15
PCT7535	TO	745	521	0	0	44	477	432	45
PCT7536	MV	670	347	0	0	13	334	295	39
PCT7536	ED	163	231	0	1	24	206	179	27
PCT7536	TO	833	578	0	1	37	540	474	66
PCT7537	MV	619	302	0	0	22	280	257	23
PCT7537	ED	126	221	0	0	20	201	187	14
PCT7537	TO	745	523	0	0	42	481	444	37
PCT7538	MV	562	324	0	0	19	305	285	20
PCT7538	ED	189	233	0	0	20	213	189	24
PCT7538	TO	751	557	0	0	39	518	474	44
PCT7539	MV	696	376	0	0	19	357	334	23
PCT7539	ED	225	277	0	0	23	254	233	21
PCT7539	TO	921	653	0	0	42	611	567	44
PCT7541	MV	601	296	0	0	24	272	245	27
PCT7541	ED	169	235	0	0	26	209	187	22
PCT7541	TO	770	531	0	0	50	481	432	49
PCT7542	MV	632	325	0	0	14	311	277	34
PCT7542	ED	192	222	0	0	14	208	188	20
PCT7542	TO	824	547	0	0	28	519	465	54
PCT7543	MV	694	373	0	0	14	359	321	38
PCT7543	ED	230	190	0	0	22	168	149	19
PCT7543	TO	924	563	0	0	36	527	470	57
PCT7544	MV	731	389	0	0	36	353	320	33
PCT7544	ED	168	232	0	0	20	212	194	18
PCT7544	TO	899	621	0	0	56	565	514	51
PCT7545	MV	723	386	0	0	24	362	326	36
PCT7545	ED	172	211	0	2	21	188	174	14
PCT7545	TO	895	597	0	2	45	550	500	50
PCT7546	MV	770	419	0	0	22	397	367	30
PCT7546	ED	183	277	0	0	27	250	221	29
PCT7546	TO	953	696	0	0	49	647	588	59
PCT7547	MV	799	427	0	0	31	396	371	25
PCT7547	ED	182	267	0	0	19	248	239	9
PCT7547	TO	981	694	0	0	50	644	610	34
PCT7548	MV	803	450	0	0	28	422	380	42
PCT7548	ED	248	279	0	0	24	255	233	22
PCT7548	TO	1051	729	0	0	52	677	613	64
PCT7549	MV	660	359	0	0	27	332	296	36
PCT7549	ED	146	199	0	0	21	178	165	13
PCT7549	TO	806	558	0	0	48	510	461	49
PCT7551	MV	587	304	0	0	15	289	265	24
PCT7551	ED	136	233	0	0	15	218	200	18
PCT7551	TO	723	537	0	0	30	507	465	42
PCT7552	MV	561	289	0	0	24	265	244	21
PCT7552	ED	124	185	0	0	25	160	139	21
PCT7552	TO	685	474	0	0	49	425	383	42
PCT7553	MV	211	96	0	1	5	90	79	11
PCT7553	ED	-20	19	0	0	3	16	14	2
PCT7553	TO	191	115	0	1	8	106	93	13
PCT7554	MV	653	382	0	0	26	356	318	38
PCT7554	ED	168	226	0	0	21	205	185	20
PCT7554	TO	821	608	0	0	47	561	503	58
PCT7555	MV	662	418	0	0	30	388	343	45
PCT7555	ED	210	258	0	0	23	235	212	23
PCT7555	TO	872	676	0	0	53	623	555	68
PCT7556	MV	812	514	0	0	30	484	434	50
PCT7556	ED	154	236	0	0	26	210	180	30
PCT7556	TO	966	750	0	0	56	694	614	80
PCT7601	MV	485	207	0	0	14	193	177	16
PCT7601	ED	192	125	0	2	15	108	95	13
PCT7601	TO	677	332	0	2	29	301	272	29
PCT7602	MV	654	277	0	0	13	264	239	25
PCT7602	ED	232	149	0	0	14	135	122	13
PCT7602	TO	886	426	0	0	27	399	361	38
PCT7603	MV	615	296	0	0	23	273	241	32
PCT7603	ED	200	207	0	0	17	190	167	23
PCT7603	TO	815	503	0	0	40	463	408	55
PCT7604	MV	685	270	0	0	11	259	235	24
PCT7604	ED	259	186	0	0	25	161	139	22
PCT7604	TO	944	456	0	0	36	420	374	46
PCT7605	MV	468	192	0	1	15	176	150	26
PCT7605	ED	193	97	0	0	11	86	79	7
PCT7605	TO	661	289	0	1	26	262	229	33
PCT7606	MV	673	267	0	0	27	240	209	31
PCT7606	ED	210	123	0	0	15	108	97	11
PCT7606	TO	883	390	0	0	42	348	306	42
PCT7607	MV	712	288	0	0	21	267	231	36
PCT7607	ED	207	142	0	0	12	130	117	13
PCT7607	TO	919	430	0	0	33	397	348	49
PCT7608	MV	279	96	0	0	6	90	74	16
PCT7608	ED	101	28	0	1	0	27	24	3
PCT7608	TO	380	124	0	1	6	117	98	19
PCT7609	MV	699	287	0	0	21	266	239	27
PCT7609	ED	185	76	0	1	9	66	57	9
PCT7609	TO	884	363	0	1	30	332	296	36
PCT7611	MV	586	236	0	0	18	218	194	24
PCT7611	ED	202	69	0	0	7	62	57	5
PCT7611	TO	788	305	0	0	25	280	251	29
PCT7612	MV	452	216	0	0	11	205	174	31
PCT7612	ED	105	60	0	0	6	54	41	13
PCT7612	TO	557	276	0	0	17	259	215	44
PCT7613	MV	634	244	0	0	19	225	202	23
PCT7613	ED	249	122	0	0	11	111	103	8
PCT7613	TO	883	366	0	0	30	336	305	31
PCT7614	MV	713	254	0	0	24	230	203	27
PCT7614	ED	203	130	0	0	10	120	101	19
PCT7614	TO	916	384	0	0	34	350	304	46
PCT7615	MV	510	165	0	0	7	158	134	24
PCT7615	ED	240	91	0	0	9	82	73	9
PCT7615	TO	750	256	0	0	16	240	207	33
PCT7616	MV	754	332	0	0	37	295	266	29
PCT7616	ED	82	189	0	0	24	165	147	18
PCT7616	TO	836	521	0	0	61	460	413	47
PCT7617	MV	583	222	0	0	21	201	178	23
PCT7617	ED	169	78	0	0	11	67	56	11
PCT7617	TO	752	300	0	0	32	268	234	34
PCT7618	MV	763	365	0	0	20	345	283	62
PCT7618	ED	151	141	0	0	18	123	110	13
PCT7618	TO	914	506	0	0	38	468	393	75
PCT7619	MV	938	439	0	0	28	411	361	50
PCT7619	ED	169	206	0	0	24	182	159	23
PCT7619	TO	1107	645	0	0	52	593	520	73
PCT7621	MV	1006	443	0	0	29	414	374	40
PCT7621	ED	149	184	0	0	25	159	137	22
PCT7621	TO	1155	627	0	0	54	573	511	62
PCT7622	MV	697	216	0	0	9	207	181	26
PCT7622	ED	263	127	0	0	17	110	102	8
PCT7622	TO	960	343	0	0	26	317	283	34
PCT7623	MV	767	256	0	2	17	237	216	21
PCT7623	ED	237	167	0	0	19	148	135	13
PCT7623	TO	1004	423	0	2	36	385	351	34
PCT7624	MV	652	210	0	0	12	198	179	19
PCT7624	ED	223	114	0	0	19	95	93	2
PCT7624	TO	875	324	0	0	31	293	272	21
PCT7625	MV	749	396	0	2	40	354	301	53
PCT7625	ED	73	48	0	0	2	46	44	2
PCT7625	TO	822	444	0	2	42	400	345	55
PCT7626	MV	945	403	0	0	42	361	311	50
PCT7626	ED	128	164	0	0	16	148	137	11
PCT7626	TO	1073	567	0	0	58	509	448	61
PCT7627	MV	457	196	0	0	18	178	140	38
PCT7627	ED	67	80	0	0	12	68	54	14
PCT7627	TO	524	276	0	0	30	246	194	52
PCT7628	MV	718	333	0	0	16	317	280	37
PCT7628	ED	220	184	0	0	12	172	147	25
PCT7628	TO	938	517	0	0	28	489	427	62
PCT7629	MV	691	276	0	0	22	254	227	27
PCT7629	ED	162	156	0	0	14	142	127	15
PCT7629	TO	853	432	0	0	36	396	354	42
PCT7631	MV	1009	442	0	0	32	410	360	50
PCT7631	ED	210	213	0	0	25	188	163	25
PCT7631	TO	1219	655	0	0	57	598	523	75
PCT7632	MV	1002	414	0	0	20	394	346	48
PCT7632	ED	169	236	0	0	21	215	192	23
PCT7632	TO	1171	650	0	0	41	609	538	71
PCT7633	MV	609	278	0	0	19	259	222	37
PCT7633	ED	126	124	0	0	12	112	102	10
PCT7633	TO	735	402	0	0	31	371	324	47
PCT7634	MV	704	344	0	0	36	308	267	41
PCT7634	ED	186	154	0	0	21	133	114	19
PCT7634	TO	890	498	0	0	57	441	381	60
PCT7635	MV	665	274	0	0	14	260	218	42
PCT7635	ED	188	145	0	0	13	132	118	14
PCT7635	TO	853	419	0	0	27	392	336	56
PCT7636	MV	798	331	0	0	24	307	261	46
PCT7636	ED	161	188	0	0	21	167	136	31
PCT7636	TO	959	519	0	0	45	474	397	77
PCT7637	MV	747	344	0	0	30	314	244	70
PCT7637	ED	121	169	0	0	25	144	125	19
PCT7637	TO	868	513	0	0	55	458	369	89
PCT7638	MV	806	374	0	0	25	349	276	73
PCT7638	ED	83	148	0	0	16	132	95	37
PCT7638	TO	889	522	0	0	41	481	371	110
PCT7639	MV	889	397	0	0	33	364	289	75
PCT7639	ED	133	175	0	0	35	140	121	19
PCT7639	TO	1022	572	0	0	68	504	410	94
PCT7641	MV	817	401	0	0	17	384	305	79
PCT7641	ED	134	158	0	0	13	145	123	22
PCT7641	TO	951	559	0	0	30	529	428	101
PCT7642	MV	647	314	0	0	35	279	251	28
PCT7642	ED	118	156	0	0	25	131	116	15
PCT7642	TO	765	470	0	0	60	410	367	43
PCT7643	MV	810	434	0	1	27	406	332	74
PCT7643	ED	131	135	0	0	18	117	102	15
PCT7643	TO	941	569	0	1	45	523	434	89
PCT7644	MV	1014	404	0	0	35	369	312	57
PCT7644	ED	162	233	0	0	26	207	189	18
PCT7644	TO	1176	637	0	0	61	576	501	75
PCT7645	MV	595	286	0	1	20	265	213	52
PCT7645	ED	61	112	0	0	14	98	80	18
PCT7645	TO	656	398	0	1	34	363	293	70
PCT7646	MV	1032	485	0	0	36	449	382	67
PCT7646	ED	121	251	0	0	44	207	186	21
PCT7646	TO	1153	736	0	0	80	656	568	88
PCT7647	MV	724	212	0	0	10	202	172	30
PCT7647	ED	263	147	0	0	15	132	118	14
PCT7647	TO	987	359	0	0	25	334	290	44
PCT7648	MV	2	1	0	0	0	1	1	0
PCT7648	TO	2	1	0	0	0	1	1	0
PCT7649	MV	724	286	0	0	12	274	233	41
PCT7649	ED	176	150	0	0	14	136	115	21
PCT7649	TO	900	436	0	0	26	410	348	62
PCT7651	MV	834	334	0	0	23	311	263	48
PCT7651	ED	113	168	0	0	21	147	128	19
PCT7651	TO	947	502	0	0	44	458	391	67
PCT7652	MV	535	209	0	0	15	194	162	32
PCT7652	ED	100	122	0	0	10	112	97	15
PCT7652	TO	635	331	0	0	25	306	259	47
PCT7653	MV	750	337	0	0	34	303	269	34
PCT7653	ED	89	146	0	0	19	127	107	20
PCT7653	TO	839	483	0	0	53	430	376	54
PCT7654	MV	413	191	0	0	11	180	150	30
PCT7654	ED	53	105	0	0	11	94	83	11
PCT7654	TO	466	296	0	0	22	274	233	41
PCT7655	MV	583	216	0	0	8	208	180	28
PCT7655	ED	96	127	0	0	17	110	97	13
PCT7655	TO	679	343	0	0	25	318	277	41
PCT7656	MV	603	309	0	0	23	286	242	44
PCT7656	ED	35	81	0	0	14	67	46	21
PCT7656	TO	638	390	0	0	37	353	288	65
PCT7657	MV	561	270	0	0	22	248	209	39
PCT7657	ED	37	109	0	0	15	94	82	12
PCT7657	TO	598	379	0	0	37	342	291	51
PCT7701	MV	869	482	0	0	37	445	383	62
PCT7701	ED	195	250	0	0	22	228	206	22
PCT7701	TO	1064	732	0	0	59	673	589	84
PCT7702	MV	623	378	0	0	18	360	279	81
PCT7702	ED	133	146	0	0	19	127	101	26
PCT7702	TO	756	524	0	0	37	487	380	107
PCT7703	MV	187	71	0	0	2	69	65	4
PCT7703	ED	-13	1	0	0	1	0	0	0
PCT7703	TO	174	72	0	0	3	69	65	4
PCT7704	MV	798	491	0	0	37	454	340	114
PCT7704	ED	204	221	0	0	12	209	152	57
PCT7704	TO	1002	712	0	0	49	663	492	171
PCT7705	MV	470	286	0	0	15	271	204	67
PCT7705	ED	125	148	0	0	11	137	108	29
PCT7705	TO	595	434	0	0	26	408	312	96
PCT7706	MV	687	451	0	0	25	426	327	99
PCT7706	ED	179	198	0	0	10	188	144	44
PCT7706	TO	866	649	0	0	35	614	471	143
PCT7707	MV	683	432	0	0	23	409	333	76
PCT7707	ED	189	226	0	0	10	216	167	49
PCT7707	TO	872	658	0	0	33	625	500	125
PCT7708	MV	710	462	0	0	34	428	334	94
PCT7708	ED	165	192	0	0	19	173	143	30
PCT7708	TO	875	654	0	0	53	601	477	124
PCT7709	MV	324	194	0	0	9	185	154	31
PCT7709	ED	82	107	0	0	12	95	81	14
PCT7709	TO	406	301	0	0	21	280	235	45
PCT7711	MV	658	380	0	0	22	358	291	67
PCT7711	ED	153	162	0	0	10	152	135	17
PCT7711	TO	811	542	0	0	32	510	426	84
PCT7712	MV	425	259	0	0	11	248	203	45
PCT7712	ED	107	135	0	0	13	122	104	18
PCT7712	TO	532	394	0	0	24	370	307	63
PCT7801	MV	824	487	0	0	24	463	386	77
PCT7801	ED	150	249	0	0	18	231	187	44
PCT7801	TO	974	736	0	0	42	694	573	121
PCT7802	MV	647	402	0	0	27	375	331	44
PCT7802	ED	151	211	0	1	14	196	176	20
PCT7802	TO	798	613	0	1	41	571	507	64
PCT7803	MV	718	476	0	0	28	448	384	64
PCT7803	ED	113	160	0	0	15	145	125	20
PCT7803	TO	831	636	0	0	43	593	509	84
PCT7804	MV	734	463	0	0	46	417	376	41
PCT7804	ED	151	246	0	0	26	220	194	26
PCT7804	TO	885	709	0	0	72	637	570	67
PCT7805	MV	644	402	0	0	38	364	315	49
PCT7805	ED	156	216	0	0	16	200	185	15
PCT7805	TO	800	618	0	0	54	564	500	64
PCT7806	MV	602	362	0	0	24	338	307	31
PCT7806	ED	153	208	0	0	21	187	166	21
PCT7806	TO	755	570	0	0	45	525	473	52
PCT7807	MV	642	363	0	1	17	345	321	24
PCT7807	ED	185	247	0	0	22	225	210	15
PCT7807	TO	827	610	0	1	39	570	531	39
PCT7808	MV	525	297	0	0	21	276	244	32
PCT7808	ED	129	170	0	0	19	151	139	12
PCT7808	TO	654	467	0	0	40	427	383	44
PCT7809	MV	624	352	0	0	22	330	303	27
PCT7809	ED	140	184	0	0	21	163	156	7
PCT7809	TO	764	536	0	0	43	493	459	34
PCT7811	MV	582	311	0	0	23	288	266	22
PCT7811	ED	176	217	0	0	20	197	178	19
PCT7811	TO	758	528	0	0	43	485	444	41
PCT7812	MV	680	371	0	0	24	347	316	31
PCT7812	ED	217	232	0	0	19	213	190	23
PCT7812	TO	897	603	0	0	43	560	506	54
PCT7813	MV	843	486	0	0	22	464	419	45
PCT7813	ED	225	299	0	0	21	278	253	25
PCT7813	TO	1068	785	0	0	43	742	672	70
PCT7814	MV	660	281	0	0	15	266	234	32
PCT7814	ED	241	191	0	0	17	174	162	12
PCT7814	TO	901	472	0	0	32	440	396	44
PCT7815	MV	749	465	0	0	48	417	369	48
PCT7815	ED	168	231	0	0	21	210	189	21
PCT7815	TO	917	696	0	0	69	627	558	69
PCT7816	MV	724	475	0	0	36	439	384	55
PCT7816	ED	148	213	0	0	15	198	169	29
PCT7816	TO	872	688	0	0	51	637	553	84
PCT7817	MV	652	396	0	0	10	386	353	33
PCT7817	ED	186	236	0	1	13	222	199	23
PCT7817	TO	838	632	0	1	23	608	552	56
PCT7818	MV	668	393	0	0	25	368	328	40
PCT7818	ED	171	205	0	0	16	189	175	14
PCT7818	TO	839	598	0	0	41	557	503	54
PCT7819	MV	635	353	0	0	22	331	281	50
PCT7819	ED	139	183	0	0	22	161	139	22
PCT7819	TO	774	536	0	0	44	492	420	72
PCT7821	MV	806	520	0	0	26	494	433	61
PCT7821	ED	170	249	0	0	17	232	204	28
PCT7821	TO	976	769	0	0	43	726	637	89
PCT7822	MV	673	396	0	1	26	369	324	45
PCT7822	ED	219	258	0	0	25	233	192	41
PCT7822	TO	892	654	0	1	51	602	516	86
PCT7823	MV	706	411	0	0	26	385	340	45
PCT7823	ED	177	273	0	0	18	255	231	24
PCT7823	TO	883	684	0	0	44	640	571	69
PCT7824	MV	615	338	0	0	25	313	279	34
PCT7824	ED	153	219	0	0	20	199	178	21
PCT7824	TO	768	557	0	0	45	512	457	55
PCT7825	MV	457	252	0	0	13	239	228	11
PCT7825	ED	151	186	0	0	5	181	159	22
PCT7825	TO	608	438	0	0	18	420	387	33
PCT7826	MV	486	263	0	1	17	245	222	23
PCT7826	ED	204	227	0	0	21	206	191	15
PCT7826	TO	690	490	0	1	38	451	413	38
PCT7827	MV	609	320	0	0	20	300	265	35
PCT7827	ED	217	222	0	0	29	193	180	13
PCT7827	TO	826	542	0	0	49	493	445	48
PCT7828	MV	857	479	0	0	35	444	370	74
PCT7828	ED	171	251	0	0	29	222	192	30
PCT7828	TO	1028	730	0	0	64	666	562	104
PCT7829	MV	742	468	0	0	24	444	373	71
PCT7829	ED	149	203	0	0	11	192	169	23
PCT7829	TO	891	671	0	0	35	636	542	94
PCT7831	MV	763	486	0	0	41	445	385	60
PCT7831	ED	139	205	0	0	12	193	163	30
PCT7831	TO	902	691	0	0	53	638	548	90
PCT7832	MV	663	415	0	0	27	388	345	43
PCT7832	ED	118	170	0	0	15	155	139	16
PCT7832	TO	781	585	0	0	42	543	484	59
PCT7833	MV	587	345	0	0	18	327	295	32
PCT7833	ED	146	191	0	0	18	173	157	16
PCT7833	TO	733	536	0	0	36	500	452	48
PCT7834	MV	700	377	0	0	29	348	323	25
PCT7834	ED	194	257	0	0	25	232	213	19
PCT7834	TO	894	634	0	0	54	580	536	44
PCT7835	MV	721	430	0	0	27	403	329	74
PCT7835	ED	142	202	0	0	16	186	158	28
PCT7835	TO	863	632	0	0	43	589	487	102
PCT7836	MV	850	507	0	0	25	482	414	68
PCT7836	ED	193	232	0	0	10	222	182	40
PCT7836	TO	1043	739	0	0	35	704	596	108
PCT7837	MV	718	425	0	0	41	384	322	62
PCT7837	ED	205	264	0	0	18	246	220	26
PCT7837	TO	923	689	0	0	59	630	542	88
PCT7838	MV	752	494	0	0	34	460	384	76
PCT7838	ED	143	210	0	0	19	191	167	24
PCT7838	TO	895	704	0	0	53	651	551	100
PCT7839	MV	731	459	0	0	32	427	362	65
PCT7839	ED	130	201	0	0	18	183	161	22
PCT7839	TO	861	660	0	0	50	610	523	87
PCT7841	MV	752	459	0	0	31	428	373	55
PCT7841	ED	198	264	0	0	14	250	223	27
PCT7841	TO	950	723	0	0	45	678	596	82
PCT7842	MV	702	396	0	0	24	372	331	41
PCT7842	ED	177	243	0	0	18	225	204	21
PCT7842	TO	879	639	0	0	42	597	535	62
PCT7843	MV	546	296	0	0	13	283	250	33
PCT7843	ED	183	220	0	0	17	203	182	21
PCT7843	TO	729	516	0	0	30	486	432	54
PCT7844	MV	499	282	0	0	25	257	238	19
PCT7844	ED	152	187	0	0	15	172	152	20
PCT7844	TO	651	469	0	0	40	429	390	39
PCT7845	MV	676	405	0	0	24	381	348	33
PCT7845	ED	204	224	0	0	17	207	178	29
PCT7845	TO	880	629	0	0	41	588	526	62
PCT7846	MV	736	467	0	0	38	429	369	60
PCT7846	ED	172	234	0	0	27	207	181	26
PCT7846	TO	908	701	0	0	65	636	550	86
PCT7847	MV	698	432	0	0	31	401	351	50
PCT7847	ED	193	231	0	0	11	220	188	32
PCT7847	TO	891	663	0	0	42	621	539	82
PCT7848	MV	665	438	0	0	23	415	354	61
PCT7848	ED	182	226	0	0	24	202	174	28
PCT7848	TO	847	664	0	0	47	617	528	89
PCT7849	MV	729	443	0	0	32	411	356	55
PCT7849	ED	172	260	0	0	26	234	211	23
PCT7849	TO	901	703	0	0	58	645	567	78
PCT7851	MV	414	272	0	0	21	251	195	56
PCT7851	ED	112	118	0	0	9	109	83	26
PCT7851	TO	526	390	0	0	30	360	278	82
PCT7852	MV	533	351	0	0	25	326	265	61
PCT7852	ED	111	133	0	0	10	123	103	20
PCT7852	TO	644	484	0	0	35	449	368	81
PCT7853	MV	694	395	0	0	27	368	306	62
PCT7853	ED	161	196	0	0	20	176	147	29
PCT7853	TO	855	591	0	0	47	544	453	91
PCT7854	MV	703	430	0	0	26	404	348	56
PCT7854	ED	175	221	0	0	19	202	176	26
PCT7854	TO	878	651	0	0	45	606	524	82
PCT7855	MV	763	451	0	0	35	416	364	52
PCT7855	ED	211	263	0	0	26	237	206	31
PCT7855	TO	974	714	0	0	61	653	570	83
PCT7856	MV	643	378	0	0	22	356	312	44
PCT7856	ED	204	250	0	0	20	230	199	31
PCT7856	TO	847	628	0	0	42	586	511	75
PCT7857	MV	748	438	0	0	33	405	351	54
PCT7857	ED	158	220	0	0	22	198	179	19
PCT7857	TO	906	658	0	0	55	603	530	73
PCT7858	MV	622	351	0	0	21	330	296	34
PCT7858	ED	157	205	0	0	16	189	167	22
PCT7858	TO	779	556	0	0	37	519	463	56
PCT7859	MV	747	465	0	0	32	433	356	77
PCT7859	ED	152	224	0	0	27	197	160	37
PCT7859	TO	899	689	0	0	59	630	516	114
PCT7861	MV	699	435	0	0	24	411	341	70
PCT7861	ED	164	217	0	0	10	207	183	24
PCT7861	TO	863	652	0	0	34	618	524	94
PCT7862	MV	669	403	0	0	23	380	337	43
PCT7862	ED	195	241	0	0	14	227	206	21
PCT7862	TO	864	644	0	0	37	607	543	64
PCT7863	MV	693	376	0	0	26	350	306	44
PCT7863	ED	208	272	0	0	19	253	213	40
PCT7863	TO	901	648	0	0	45	603	519	84
PCT7864	MV	661	376	0	0	30	346	286	60
PCT7864	ED	153	208	0	0	19	189	161	28
PCT7864	TO	814	584	0	0	49	535	447	88
PCT7865	MV	677	410	0	0	32	378	319	59
PCT7865	ED	163	201	0	0	17	184	152	32
PCT7865	TO	840	611	0	0	49	562	471	91
PCT7866	MV	690	447	0	0	16	431	329	102
PCT7866	ED	158	192	0	0	12	180	137	43
PCT7866	TO	848	639	0	0	28	611	466	145
PCT7867	MV	766	475	0	0	21	454	390	64
PCT7867	ED	212	235	0	0	22	213	182	31
PCT7867	TO	978	710	0	0	43	667	572	95
PCT7868	MV	659	376	0	0	17	359	307	52
PCT7868	ED	217	219	0	0	15	204	174	30
PCT7868	TO	876	595	0	0	32	563	481	82
PCT7869	MV	683	445	0	0	27	418	365	53
PCT7869	ED	178	225	0	0	18	207	181	26
PCT7869	TO	861	670	0	0	45	625	546	79
PCT7871	MV	702	466	0	0	38	428	375	53
PCT7871	ED	200	198	0	1	16	181	143	38
PCT7871	TO	902	664	0	1	54	609	518	91
PCT7872	MV	675	422	0	0	26	396	339	57
PCT7872	ED	199	232	0	0	16	216	185	31
PCT7872	TO	874	654	0	0	42	612	524	88
PCT7873	MV	689	445	0	0	29	416	367	49
PCT7873	ED	202	256	0	0	21	235	198	37
PCT7873	TO	891	701	0	0	50	651	565	86
PCT7874	MV	370	191	0	0	8	183	151	32
PCT7874	ED	119	131	0	0	9	122	99	23
PCT7874	TO	489	322	0	0	17	305	250	55
PCT7875	MV	500	253	0	0	16	237	194	43
PCT7875	ED	147	158	0	0	12	146	126	20
PCT7875	TO	647	411	0	0	28	383	320	63
PCT7876	MV	462	258	0	0	18	240	221	19
PCT7876	ED	106	129	0	0	12	117	108	9
PCT7876	TO	568	387	0	0	30	357	329	28
PCT7901	MV	399	192	0	0	9	183	168	15
PCT7901	ED	150	104	0	0	7	97	86	11
PCT7901	TO	549	296	0	0	16	280	254	26
PCT7902	MV	680	291	0	0	14	277	244	33
PCT7902	ED	232	208	0	0	17	191	170	21
PCT7902	TO	912	499	0	0	31	468	414	54
PCT7903	MV	623	286	0	0	21	265	245	20
PCT7903	ED	229	196	0	0	21	175	165	10
PCT7903	TO	852	482	0	0	42	440	410	30
PCT7904	MV	680	299	0	0	20	279	244	35
PCT7904	ED	157	185	0	0	17	168	154	14
PCT7904	TO	837	484	0	0	37	447	398	49
PCT7905	MV	684	356	0	0	19	337	301	36
PCT7905	ED	191	226	0	0	15	211	196	15
PCT7905	TO	875	582	0	0	34	548	497	51
PCT7906	MV	599	283	0	0	17	266	239	27
PCT7906	ED	187	206	0	0	26	180	163	17
PCT7906	TO	786	489	0	0	43	446	402	44
PCT7907	MV	704	345	0	0	18	327	296	31
PCT7907	ED	238	251	0	0	24	227	205	22
PCT7907	TO	942	596	0	0	42	554	501	53
PCT7908	MV	752	366	0	1	21	344	319	25
PCT7908	ED	240	249	0	0	22	227	217	10
PCT7908	TO	992	615	0	1	43	571	536	35
PCT7909	MV	558	311	0	0	18	293	267	26
PCT7909	ED	185	179	0	0	11	168	155	13
PCT7909	TO	743	490	0	0	29	461	422	39
PCT7911	MV	666	323	0	0	22	301	261	40
PCT7911	ED	205	207	0	0	17	190	170	20
PCT7911	TO	871	530	0	0	39	491	431	60
PCT7912	MV	800	370	0	0	22	348	331	17
PCT7912	ED	259	262	0	0	32	230	221	9
PCT7912	TO	1059	632	0	0	54	578	552	26
PCT7913	MV	661	352	0	0	11	341	290	51
PCT7913	ED	262	302	0	0	13	289	256	33
PCT7913	TO	923	654	0	0	24	630	546	84
PCT7914	MV	716	391	0	0	26	365	320	45
PCT7914	ED	186	217	0	0	23	194	167	27
PCT7914	TO	902	608	0	0	49	559	487	72
PCT7915	MV	605	290	0	0	22	268	236	32
PCT7915	ED	238	249	0	0	15	234	212	22
PCT7915	TO	843	539	0	0	37	502	448	54
PCT7916	MV	639	338	0	0	19	319	286	33
PCT7916	ED	219	231	0	0	17	214	200	14
PCT7916	TO	858	569	0	0	36	533	486	47
PCT7917	MV	716	358	0	0	21	337	305	32
PCT7917	ED	271	261	0	0	13	248	230	18
PCT7917	TO	987	619	0	0	34	585	535	50
PCT7918	MV	597	297	0	0	14	283	268	15
PCT7918	ED	227	201	0	1	14	186	167	19
PCT7918	TO	824	498	0	1	28	469	435	34
PCT7919	MV	608	309	0	0	16	293	268	25
PCT7919	ED	258	250	0	0	19	231	216	15
PCT7919	TO	866	559	0	0	35	524	484	40
PCT7921	MV	682	310	0	0	16	294	261	33
PCT7921	ED	229	181	0	0	18	163	145	18
PCT7921	TO	911	491	0	0	34	457	406	51
PCT7922	MV	648	314	0	0	10	304	273	31
PCT7922	ED	210	246	0	0	18	228	211	17
PCT7922	TO	858	560	0	0	28	532	484	48
PCT7923	MV	666	338	0	0	15	323	267	56
PCT7923	ED	214	261	0	0	26	235	211	24
PCT7923	TO	880	599	0	0	41	558	478	80
PCT7924	MV	649	305	0	0	11	294	259	35
PCT7924	ED	202	190	0	0	18	172	154	18
PCT7924	TO	851	495	0	0	29	466	413	53
PCT7925	MV	434	227	0	0	15	212	183	29
PCT7925	ED	110	127	0	0	9	118	107	11
PCT7925	TO	544	354	0	0	24	330	290	40
PCT7926	MV	610	341	0	0	23	318	281	37
PCT7926	ED	178	199	0	0	12	187	157	30
PCT7926	TO	788	540	0	0	35	505	438	67
PCT7927	MV	580	335	0	0	28	307	273	34
PCT7927	ED	162	217	0	0	14	203	184	19
PCT7927	TO	742	552	0	0	42	510	457	53
PCT7928	MV	700	397	0	0	22	375	333	42
PCT7928	ED	217	276	0	0	17	259	232	27
PCT7928	TO	917	673	0	0	39	634	565	69
PCT7929	MV	678	424	0	0	23	401	352	49
PCT7929	ED	169	225	0	0	13	212	188	24
PCT7929	TO	847	649	0	0	36	613	540	73
PCT7931	MV	610	378	0	0	30	348	300	48
PCT7931	ED	141	187	0	0	17	170	144	26
PCT7931	TO	751	565	0	0	47	518	444	74
PCT7932	MV	443	277	0	0	16	261	216	45
PCT7932	ED	118	117	0	0	11	106	95	11
PCT7932	TO	561	394	0	0	27	367	311	56
PCT7933	MV	9	6	0	0	0	6	4	2
PCT7933	ED	-1	0	0	0	0	0	0	0
PCT7933	TO	8	6	0	0	0	6	4	2
PCT7934	MV	702	413	0	0	28	385	353	32
PCT7934	ED	182	201	0	0	23	178	159	19
PCT7934	TO	884	614	0	0	51	563	512	51
PCT7935	MV	716	440	0	0	29	411	362	49
PCT7935	ED	227	277	0	0	22	255	230	25
PCT7935	TO	943	717	0	0	51	666	592	74
PCT7936	MV	620	373	0	0	24	349	308	41
PCT7936	ED	236	271	0	1	22	248	219	29
PCT7936	TO	856	644	0	1	46	597	527	70
PCT7937	MV	698	406	0	0	25	381	341	40
PCT7937	ED	202	218	0	0	14	204	179	25
PCT7937	TO	900	624	0	0	39	585	520	65
PCT7938	MV	536	301	0	0	13	288	253	35
PCT7938	ED	215	153	0	0	14	139	121	18
PCT7938	TO	751	454	0	0	27	427	374	53
PCT7939	MV	481	292	0	0	15	277	250	27
PCT7939	ED	205	239	0	0	18	221	200	21
PCT7939	TO	686	531	0	0	33	498	450	48
PCT7941	MV	576	305	0	0	25	280	243	37
PCT7941	ED	196	201	0	0	12	189	163	26
PCT7941	TO	772	506	0	0	37	469	406	63
PCT7942	MV	658	333	0	0	16	317	273	44
PCT7942	ED	274	191	0	0	10	181	160	21
PCT7942	TO	932	524	0	0	26	498	433	65
PCT7943	MV	686	369	0	0	16	353	289	64
PCT7943	ED	214	241	0	0	22	219	185	34
PCT7943	TO	900	610	0	0	38	572	474	98
PCT7944	MV	584	343	0	0	23	320	280	40
PCT7944	ED	230	241	0	0	19	222	190	32
PCT7944	TO	814	584	0	0	42	542	470	72
PCT7945	MV	726	339	0	0	25	314	273	41
PCT7945	ED	228	137	0	0	14	123	109	14
PCT7945	TO	954	476	0	0	39	437	382	55
PCT7946	MV	779	369	0	0	18	351	239	112
PCT7946	ED	206	145	0	0	10	135	106	29
PCT7946	TO	985	514	0	0	28	486	345	141
PCT7947	MV	792	333	0	0	26	307	197	110
PCT7947	ED	194	150	0	0	11	139	109	30
PCT7947	TO	986	483	0	0	37	446	306	140
PCT7948	MV	730	375	0	0	26	349	233	116
PCT7948	ED	200	161	0	0	11	150	119	31
PCT7948	TO	930	536	0	0	37	499	352	147
PCT7949	MV	484	233	0	0	12	221	138	83
PCT7949	ED	106	84	0	0	9	75	60	15
PCT7949	TO	590	317	0	0	21	296	198	98
PCT7951	MV	731	366	0	0	27	339	218	121
PCT7951	ED	156	116	0	0	11	105	78	27
PCT7951	TO	887	482	0	0	38	444	296	148
PCT7952	MV	730	294	0	0	20	274	170	104
PCT7952	ED	182	132	0	0	12	120	91	29
PCT7952	TO	912	426	0	0	32	394	261	133
PCT7953	MV	669	331	0	0	18	313	218	95
PCT7953	ED	161	139	0	0	6	133	86	47
PCT7953	TO	830	470	0	0	24	446	304	142
PCT7955	MV	774	351	0	0	15	336	228	108
PCT7955	ED	173	142	0	0	18	124	89	35
PCT7955	TO	947	493	0	0	33	460	317	143
PCT7956	MV	699	267	0	0	11	256	170	86
PCT7956	ED	170	83	0	0	4	79	67	12
PCT7956	TO	869	350	0	0	15	335	237	98
PCT7957	MV	538	261	0	0	13	248	191	57
PCT7957	ED	135	120	0	0	8	112	96	16
PCT7957	TO	673	381	0	0	21	360	287	73
PCT7958	MV	320	108	0	0	6	102	78	24
PCT7958	ED	-23	14	0	0	3	11	9	2
PCT7958	TO	297	122	0	0	9	113	87	26
PCT7959	MV	541	230	0	0	18	212	195	17
PCT7959	ED	145	162	0	0	17	145	133	12
PCT7959	TO	686	392	0	0	35	357	328	29
PCT9001	MV	314	101	0	0	3	98	86	12
PCT9001	ED	-30	7	0	0	1	6	4	2
PCT9001	TO	284	108	0	0	4	104	90	14
PCT9101	MV	712	380	0	0	23	357	277	80
PCT9101	ED	201	210	0	0	16	194	163	31
PCT9101	TO	913	590	0	0	39	551	440	111
PCT9102	MV	788	394	0	0	25	369	303	66
PCT9102	ED	204	201	0	1	11	189	156	33
PCT9102	TO	992	595	0	1	36	558	459	99
PCT9103	MV	719	382	0	0	25	357	287	70
PCT9103	ED	238	225	0	0	18	207	160	47
PCT9103	TO	957	607	0	0	43	564	447	117
PCT9104	MV	810	383	0	0	32	351	280	71
PCT9104	ED	220	205	0	0	16	189	157	32
PCT9104	TO	1030	588	0	0	48	540	437	103
PCT9105	MV	719	413	0	0	20	393	318	75
PCT9105	ED	199	241	0	0	18	223	186	37
PCT9105	TO	918	654	0	0	38	616	504	112
PCT9106	MV	748	399	0	0	24	375	305	70
PCT9106	ED	198	268	0	0	26	242	212	30
PCT9106	TO	946	667	0	0	50	617	517	100
PCT9107	MV	636	305	0	0	24	281	237	44
PCT9107	ED	208	187	0	0	20	167	153	14
PCT9107	TO	844	492	0	0	44	448	390	58
PCT9108	MV	610	338	0	0	31	307	258	49
PCT9108	ED	200	197	0	0	14	183	161	22
PCT9108	TO	810	535	0	0	45	490	419	71
PCT9109	MV	672	300	0	0	25	275	227	48
PCT9109	ED	211	213	0	0	11	202	164	38
PCT9109	TO	883	513	0	0	36	477	391	86
PCT9111	MV	639	318	0	0	23	295	251	44
PCT9111	ED	195	196	0	0	18	178	157	21
PCT9111	TO	834	514	0	0	41	473	408	65
PCT9112	MV	742	351	0	0	23	328	268	60
PCT9112	ED	219	218	0	0	16	202	181	21
PCT9112	TO	961	569	0	0	39	530	449	81
PCT9113	MV	797	372	0	0	24	348	274	74
PCT9113	ED	207	263	0	0	24	239	197	42
PCT9113	TO	1004	635	0	0	48	587	471	116
PCT9114	MV	659	294	0	0	18	276	237	39
PCT9114	ED	231	201	0	0	20	181	167	14
PCT9114	TO	890	495	0	0	38	457	404	53
PCT9115	MV	699	325	0	0	26	299	254	45
PCT9115	ED	182	198	0	0	18	180	157	23
PCT9115	TO	881	523	0	0	44	479	411	68
PCT9116	MV	782	347	0	0	18	329	265	64
PCT9116	ED	179	225	0	0	18	207	170	37
PCT9116	TO	961	572	0	0	36	536	435	101
PCT9117	MV	629	328	0	0	16	312	242	70
PCT9117	ED	171	207	0	0	18	189	152	37
PCT9117	TO	800	535	0	0	34	501	394	107
PCT9118	MV	742	341	0	0	26	315	237	78
PCT9118	ED	242	254	0	0	27	227	188	39
PCT9118	TO	984	595	0	0	53	542	425	117
PCT9119	MV	703	389	0	0	22	367	280	87
PCT9119	ED	197	171	0	0	19	152	128	24
PCT9119	TO	900	560	0	0	41	519	408	111
PCT9121	MV	735	336	0	0	18	318	250	68
PCT9121	ED	218	207	0	0	12	195	155	40
PCT9121	TO	953	543	0	0	30	513	405	108
PCT9122	MV	775	365	0	0	24	341	244	97
PCT9122	ED	192	184	0	0	26	158	129	29
PCT9122	TO	967	549	0	0	50	499	373	126
PCT9123	MV	661	319	0	0	20	299	223	76
PCT9123	ED	191	206	0	0	20	186	167	19
PCT9123	TO	852	525	0	0	40	485	390	95
PCT9124	MV	736	354	0	0	14	340	257	83
PCT9124	ED	167	175	0	0	11	164	134	30
PCT9124	TO	903	529	0	0	25	504	391	113
PCT9125	MV	681	360	0	0	17	343	273	70
PCT9125	ED	188	188	0	0	22	166	144	22
PCT9125	TO	869	548	0	0	39	509	417	92
PCT9126	MV	819	386	0	0	21	365	268	97
PCT9126	ED	194	224	0	0	14	210	173	37
PCT9126	TO	1013	610	0	0	35	575	441	134
PCT9127	MV	748	384	0	0	29	355	293	62
PCT9127	ED	223	241	0	0	15	226	185	41
PCT9127	TO	971	625	0	0	44	581	478	103
PCT9128	MV	628	336	0	0	23	313	241	72
PCT9128	ED	190	211	0	0	19	192	166	26
PCT9128	TO	818	547	0	0	42	505	407	98
PCT9129	MV	587	273	0	0	12	261	208	53
PCT9129	ED	151	170	0	0	14	156	138	18
PCT9129	TO	738	443	0	0	26	417	346	71
PCT9131	MV	596	288	0	0	11	277	212	65
PCT9131	ED	138	176	0	0	13	163	136	27
PCT9131	TO	734	464	0	0	24	440	348	92
PCT9132	MV	627	263	0	0	14	249	220	29
PCT9132	ED	194	197	0	0	14	183	158	25
PCT9132	TO	821	460	0	0	28	432	378	54
PCT9133	MV	808	383	0	0	22	361	302	59
PCT9133	ED	209	249	0	0	20	229	193	36
PCT9133	TO	1017	632	0	0	42	590	495	95
PCT9134	MV	736	328	0	0	18	310	228	82
PCT9134	ED	155	186	0	0	15	171	144	27
PCT9134	TO	891	514	0	0	33	481	372	109
PCT9135	MV	640	305	0	0	19	286	232	54
PCT9135	ED	182	173	0	0	13	160	124	36
PCT9135	TO	822	478	0	0	32	446	356	90
PCT9136	MV	706	368	0	0	26	342	270	72
PCT9136	ED	212	202	0	0	24	178	147	31
PCT9136	TO	918	570	0	0	50	520	417	103
PCT9137	MV	806	389	0	0	27	362	281	81
PCT9137	ED	209	210	0	0	16	194	166	28
PCT9137	TO	1015	599	0	0	43	556	447	109
PCT9138	MV	770	401	0	0	23	378	289	89
PCT9138	ED	175	171	0	0	16	155	139	16
PCT9138	TO	945	572	0	0	39	533	428	105
PCT9139	MV	828	424	0	0	26	398	293	105
PCT9139	ED	190	206	0	0	19	187	156	31
PCT9139	TO	1018	630	0	0	45	585	449	136
PCT9141	MV	789	419	0	0	31	388	292	96
PCT9141	ED	184	189	0	0	15	174	144	30
PCT9141	TO	973	608	0	0	46	562	436	126
PCT9142	MV	747	366	0	0	21	345	285	60
PCT9142	ED	239	236	0	0	21	215	180	35
PCT9142	TO	986	602	0	0	42	560	465	95
PCT9143	MV	706	362	0	0	21	341	265	76
PCT9143	ED	208	201	0	0	11	190	150	40
PCT9143	TO	914	563	0	0	32	531	415	116
PCT9144	MV	767	376	0	0	22	354	271	83
PCT9144	ED	203	238	0	0	15	223	199	24
PCT9144	TO	970	614	0	0	37	577	470	107
PCT9145	MV	681	335	0	0	18	317	256	61
PCT9145	ED	194	216	0	0	16	200	161	39
PCT9145	TO	875	551	0	0	34	517	417	100
PCT9146	MV	725	354	0	0	26	328	282	46
PCT9146	ED	160	215	0	0	26	189	155	34
PCT9146	TO	885	569	0	0	52	517	437	80
PCT9147	MV	765	373	0	0	20	353	292	61
PCT9147	ED	225	227	0	0	16	211	180	31
PCT9147	TO	990	600	0	0	36	564	472	92
PCT9148	MV	779	398	0	0	19	379	323	56
PCT9148	ED	235	256	0	0	26	230	199	31
PCT9148	TO	1014	654	0	0	45	609	522	87
PCT9149	MV	813	388	0	0	22	366	300	66
PCT9149	ED	178	290	0	0	20	270	235	35
PCT9149	TO	991	678	0	0	42	636	535	101
PCT9151	MV	693	352	0	0	25	327	282	45
PCT9151	ED	168	228	0	0	25	203	170	33
PCT9151	TO	861	580	0	0	50	530	452	78
PCT9152	MV	550	198	0	0	10	188	163	25
PCT9152	ED	187	356	0	0	30	326	294	32
PCT9152	TO	737	554	0	0	40	514	457	57
PCT9201	MV	785	358	0	0	25	333	308	25
PCT9201	ED	186	252	0	0	10	242	211	31
PCT9201	TO	971	610	0	0	35	575	519	56
PCT9202	MV	819	368	0	0	33	335	292	43
PCT9202	ED	177	253	0	0	22	231	195	36
PCT9202	TO	996	621	0	0	55	566	487	79
PCT9203	MV	847	374	0	0	52	322	247	75
PCT9203	ED	155	208	0	0	27	181	124	57
PCT9203	TO	1002	582	0	0	79	503	371	132
PCT9204	MV	686	309	0	0	30	279	211	68
PCT9204	ED	176	219	0	0	25	194	155	39
PCT9204	TO	862	528	0	0	55	473	366	107
PCT9205	MV	621	289	0	0	37	252	219	33
PCT9205	ED	115	171	0	0	24	147	116	31
PCT9205	TO	736	460	0	0	61	399	335	64
PCT9206	MV	741	354	0	0	22	332	246	86
PCT9206	ED	188	208	0	0	39	169	132	37
PCT9206	TO	929	562	0	0	61	501	378	123
PCT9207	MV	824	370	0	0	29	341	265	76
PCT9207	ED	165	208	0	0	24	184	147	37
PCT9207	TO	989	578	0	0	53	525	412	113
PCT9208	MV	808	359	0	0	26	333	273	60
PCT9208	ED	179	199	0	0	19	180	152	28
PCT9208	TO	987	558	0	0	45	513	425	88
PCT9209	MV	615	276	0	0	24	252	196	56
PCT9209	ED	156	190	0	0	33	157	126	31
PCT9209	TO	771	466	0	0	57	409	322	87
PCT9211	MV	730	314	0	0	31	283	223	60
PCT9211	ED	161	191	0	0	28	163	129	34
PCT9211	TO	891	505	0	0	59	446	352	94
PCT9212	MV	671	284	0	1	24	259	205	54
PCT9212	ED	137	192	0	0	36	156	132	24
PCT9212	TO	808	476	0	1	60	415	337	78
PCT9213	MV	776	350	0	0	35	315	248	67
PCT9213	ED	161	212	0	0	28	184	157	27
PCT9213	TO	937	562	0	0	63	499	405	94
PCT9214	MV	517	236	0	0	16	220	179	41
PCT9214	ED	110	156	0	0	21	135	109	26
PCT9214	TO	627	392	0	0	37	355	288	67
PCT9215	MV	524	246	0	0	15	231	184	47
PCT9215	ED	120	152	0	0	19	133	103	30
PCT9215	TO	644	398	0	0	34	364	287	77
PCT9216	MV	669	266	0	0	31	235	172	63
PCT9216	ED	155	223	0	0	23	200	159	41
PCT9216	TO	824	489	0	0	54	435	331	104
PCT9217	MV	588	269	0	0	11	258	208	50
PCT9217	ED	117	160	0	0	11	149	120	29
PCT9217	TO	705	429	0	0	22	407	328	79
PCT9218	MV	652	278	0	0	26	252	191	61
PCT9218	ED	164	188	0	0	21	167	138	29
PCT9218	TO	816	466	0	0	47	419	329	90
PCT9219	MV	646	292	0	0	30	262	230	32
PCT9219	ED	144	203	0	0	26	177	147	30
PCT9219	TO	790	495	0	0	56	439	377	62
PCT9221	MV	562	325	0	0	19	306	222	84
PCT9221	ED	89	144	0	0	16	128	102	26
PCT9221	TO	651	469	0	0	35	434	324	110
PCT9222	MV	773	374	0	0	29	345	278	67
PCT9222	ED	137	210	0	0	28	182	147	35
PCT9222	TO	910	584	0	0	57	527	425	102
PCT9223	MV	558	268	0	0	17	251	198	53
PCT9223	ED	109	127	0	0	14	113	84	29
PCT9223	TO	667	395	0	0	31	364	282	82
PCT9224	MV	768	380	0	0	25	355	286	69
PCT9224	ED	181	219	0	0	31	188	146	42
PCT9224	TO	949	599	0	0	56	543	432	111
PCT9225	MV	757	304	0	0	20	284	234	50
PCT9225	ED	169	234	0	0	27	207	176	31
PCT9225	TO	926	538	0	0	47	491	410	81
PCT9226	MV	741	357	0	0	36	321	277	44
PCT9226	ED	155	239	0	0	27	212	184	28
PCT9226	TO	896	596	0	0	63	533	461	72
PCT9227	MV	605	373	0	0	27	346	264	82
PCT9227	ED	124	156	0	0	8	148	119	29
PCT9227	TO	729	529	0	0	35	494	383	111
PCT9228	MV	578	314	0	3	19	292	219	73
PCT9228	ED	160	188	0	0	15	173	147	26
PCT9228	TO	738	502	0	3	34	465	366	99
PCT9229	MV	460	257	0	0	21	236	205	31
PCT9229	ED	119	147	0	0	13	134	115	19
PCT9229	TO	579	404	0	0	34	370	320	50
PCT9231	MV	726	354	0	0	21	333	268	65
PCT9231	ED	236	282	0	0	23	259	224	35
PCT9231	TO	962	636	0	0	44	592	492	100
PCT9232	MV	608	295	0	0	26	269	208	61
PCT9232	ED	126	183	0	0	19	164	129	35
PCT9232	TO	734	478	0	0	45	433	337	96
PCT9233	MV	668	332	0	0	28	304	232	72
PCT9233	ED	150	201	0	0	28	173	146	27
PCT9233	TO	818	533	0	0	56	477	378	99
PCT9234	MV	643	322	0	0	21	301	237	64
PCT9234	ED	91	155	0	0	23	132	104	28
PCT9234	TO	734	477	0	0	44	433	341	92
PCT9235	MV	703	368	0	0	27	341	245	96
PCT9235	ED	160	212	0	0	21	191	153	38
PCT9235	TO	863	580	0	0	48	532	398	134
PCT9236	MV	537	283	0	0	20	263	221	42
PCT9236	ED	136	148	0	0	19	129	106	23
PCT9236	TO	673	431	0	0	39	392	327	65
PCT9237	MV	779	396	0	0	27	369	294	75
PCT9237	ED	118	206	0	0	22	184	156	28
PCT9237	TO	897	602	0	0	49	553	450	103
PCT9238	MV	687	330	0	0	35	295	246	49
PCT9238	ED	118	192	0	0	27	165	140	25
PCT9238	TO	805	522	0	0	62	460	386	74
PCT9239	MV	740	391	0	0	41	350	292	58
PCT9239	ED	124	174	0	0	21	153	132	21
PCT9239	TO	864	565	0	0	62	503	424	79
PCT9241	MV	819	404	0	0	31	373	306	67
PCT9241	ED	141	211	0	0	21	190	167	23
PCT9241	TO	960	615	0	0	52	563	473	90
PCT9242	MV	771	350	0	0	36	314	264	50
PCT9242	ED	172	238	0	0	36	202	172	30
PCT9242	TO	943	588	0	0	72	516	436	80
PCT9243	MV	480	242	0	0	23	219	183	36
PCT9243	ED	123	154	0	0	21	133	115	18
PCT9243	TO	603	396	0	0	44	352	298	54
PCT9244	MV	756	399	0	0	44	355	302	53
PCT9244	ED	154	206	0	0	18	188	163	25
PCT9244	TO	910	605	0	0	62	543	465	78
PCT9245	MV	616	301	0	0	29	272	224	48
PCT9245	ED	98	145	0	0	19	126	102	24
PCT9245	TO	714	446	0	0	48	398	326	72
PCT9246	MV	815	434	0	0	33	401	321	80
PCT9246	ED	155	214	0	0	25	189	165	24
PCT9246	TO	970	648	0	0	58	590	486	104
PCT9247	MV	764	381	0	0	23	358	296	62
PCT9247	ED	148	225	0	0	27	198	165	33
PCT9247	TO	912	606	0	0	50	556	461	95
PCT9248	MV	757	360	0	0	29	331	289	42
PCT9248	ED	150	211	0	0	21	190	170	20
PCT9248	TO	907	571	0	0	50	521	459	62
PCT9249	MV	724	379	0	0	29	350	302	48
PCT9249	ED	191	235	0	0	21	214	176	38
PCT9249	TO	915	614	0	0	50	564	478	86
PCT9251	MV	792	393	0	0	29	364	304	60
PCT9251	ED	174	248	0	0	17	231	187	44
PCT9251	TO	966	641	0	0	46	595	491	104
PCT9252	MV	811	383	0	0	27	356	284	72
PCT9252	ED	142	211	0	0	22	189	160	29
PCT9252	TO	953	594	0	0	49	545	444	101
PCT9253	MV	599	300	0	0	16	284	239	45
PCT9253	ED	162	170	0	0	13	157	136	21
PCT9253	TO	761	470	0	0	29	441	375	66
PCT9254	MV	758	415	0	0	24	391	326	65
PCT9254	ED	163	229	0	0	31	198	172	26
PCT9254	TO	921	644	0	0	55	589	498	91
PCT9255	MV	437	196	0	0	20	176	153	23
PCT9255	ED	113	154	0	0	18	136	115	21
PCT9255	TO	550	350	0	0	38	312	268	44
PCT9256	MV	367	169	0	0	9	160	135	25
PCT9256	ED	95	134	0	0	12	122	108	14
PCT9256	TO	462	303	0	0	21	282	243	39
PCT9257	MV	359	165	0	0	15	150	132	18
PCT9257	ED	-39	21	0	0	4	17	16	1
PCT9257	TO	320	186	0	0	19	167	148	19
PCT9258	MV	583	307	0	0	29	278	230	48
PCT9258	ED	120	162	0	0	14	148	138	10
PCT9258	TO	703	469	0	0	43	426	368	58
PCT9401	MV	796	359	0	0	21	338	290	48
PCT9401	ED	242	258	0	0	25	233	208	25
PCT9401	TO	1038	617	0	0	46	571	498	73
PCT9402	MV	775	378	0	0	15	363	296	67
PCT9402	ED	242	225	0	0	17	208	181	27
PCT9402	TO	1017	603	0	0	32	571	477	94
PCT9403	MV	731	349	0	0	13	336	257	79
PCT9403	ED	190	183	0	0	13	170	155	15
PCT9403	TO	921	532	0	0	26	506	412	94
PCT9404	MV	753	345	0	0	20	325	247	78
PCT9404	ED	191	208	0	0	17	191	156	35
PCT9404	TO	944	553	0	0	37	516	403	113
PCT9405	MV	629	278	0	0	19	259	193	66
PCT9405	ED	151	144	0	0	7	137	107	30
PCT9405	TO	780	422	0	0	26	396	300	96
PCT9406	MV	695	332	0	0	21	311	236	75
PCT9406	ED	188	198	0	0	13	185	145	40
PCT9406	TO	883	530	0	0	34	496	381	115
PCT9407	MV	712	369	0	0	16	353	295	58
PCT9407	ED	201	194	0	0	21	173	142	31
PCT9407	TO	913	563	0	0	37	526	437	89
PCT9408	MV	711	323	0	0	24	299	265	34
PCT9408	ED	152	193	0	0	14	179	160	19
PCT9408	TO	863	516	0	0	38	478	425	53
PCT9409	MV	443	227	0	0	19	208	179	29
PCT9409	ED	158	172	0	0	11	161	145	16
PCT9409	TO	601	399	0	0	30	369	324	45
PCT9411	MV	816	378	0	0	24	354	302	52
PCT9411	ED	191	239	0	0	17	222	197	25
PCT9411	TO	1007	617	0	0	41	576	499	77
PCT9412	MV	668	340	0	0	16	324	241	83
PCT9412	ED	202	199	0	0	13	186	148	38
PCT9412	TO	870	539	0	0	29	510	389	121
PCT9413	MV	757	379	0	0	26	353	262	91
PCT9413	ED	179	185	0	0	15	170	139	31
PCT9413	TO	936	564	0	0	41	523	401	122
PCT9414	MV	734	361	0	1	24	336	248	88
PCT9414	ED	186	162	0	0	10	152	128	24
PCT9414	TO	920	523	0	1	34	488	376	112
PCT9415	MV	634	315	0	0	16	299	233	66
PCT9415	ED	154	138	0	0	7	131	112	19
PCT9415	TO	788	453	0	0	23	430	345	85
PCT9416	MV	769	391	0	0	31	360	273	87
PCT9416	ED	230	206	0	0	10	196	158	38
PCT9416	TO	999	597	0	0	41	556	431	125
PCT9417	MV	629	322	0	0	15	307	223	84
PCT9417	ED	145	153	0	0	7	146	113	33
PCT9417	TO	774	475	0	0	22	453	336	117
PCT9418	MV	631	310	0	0	25	285	201	84
PCT9418	ED	188	160	0	0	10	150	110	40
PCT9418	TO	819	470	0	0	35	435	311	124
PCT9419	MV	736	371	0	0	19	352	253	99
PCT9419	ED	173	148	0	0	10	138	99	39
PCT9419	TO	909	519	0	0	29	490	352	138
PCT9421	MV	752	341	0	0	21	320	216	104
PCT9421	ED	173	172	0	0	10	162	121	41
PCT9421	TO	925	513	0	0	31	482	337	145
PCT9422	MV	831	413	0	0	25	388	284	104
PCT9422	ED	270	222	0	0	21	201	169	32
PCT9422	TO	1101	635	0	0	46	589	453	136
PCT9423	MV	714	318	0	0	22	296	212	84
PCT9423	ED	190	186	0	0	19	167	133	34
PCT9423	TO	904	504	0	0	41	463	345	118
PCT9424	MV	799	386	0	0	18	368	260	108
PCT9424	ED	210	171	0	0	16	155	120	35
PCT9424	TO	1009	557	0	0	34	523	380	143
PCT9425	MV	789	348	0	0	23	325	238	87
PCT9425	ED	187	183	0	0	14	169	128	41
PCT9425	TO	976	531	0	0	37	494	366	128
PCT9426	MV	697	326	0	0	21	305	216	89
PCT9426	ED	156	159	0	0	19	140	102	38
PCT9426	TO	853	485	0	0	40	445	318	127
PCT9427	MV	799	386	0	0	18	368	232	136
PCT9427	ED	188	170	0	0	24	146	112	34
PCT9427	TO	987	556	0	0	42	514	344	170
PCT9428	MV	811	353	0	0	25	328	242	86
PCT9428	ED	179	163	0	0	17	146	120	26
PCT9428	TO	990	516	0	0	42	474	362	112
PCT9429	MV	709	344	0	1	21	322	220	102
PCT9429	ED	197	174	0	0	18	156	117	39
PCT9429	TO	906	518	0	1	39	478	337	141
PCT9431	MV	832	413	0	0	35	378	247	131
PCT9431	ED	204	189	0	0	10	179	137	42
PCT9431	TO	1036	602	0	0	45	557	384	173
PCT9432	MV	743	361	0	0	31	330	245	85
PCT9432	ED	215	156	0	0	12	144	117	27
PCT9432	TO	958	517	0	0	43	474	362	112
PCT9433	MV	794	374	0	0	28	346	226	120
PCT9433	ED	164	136	0	0	5	131	93	38
PCT9433	TO	958	510	0	0	33	477	319	158
PCT9434	MV	785	387	0	0	27	360	268	92
PCT9434	ED	227	239	0	0	26	213	173	40
PCT9434	TO	1012	626	0	0	53	573	441	132
PCT9435	MV	779	366	0	0	15	351	246	105
PCT9435	ED	225	217	0	0	15	202	148	54
PCT9435	TO	1004	583	0	0	30	553	394	159
PCT9436	MV	842	387	0	0	15	372	264	108
PCT9436	ED	226	176	0	0	16	160	123	37
PCT9436	TO	1068	563	0	0	31	532	387	145
PCT9437	MV	736	376	0	0	20	356	243	113
PCT9437	ED	191	171	0	0	10	161	124	37
PCT9437	TO	927	547	0	0	30	517	367	150
PCT9438	MV	837	420	0	0	23	397	274	123
PCT9438	ED	152	128	0	0	10	118	88	30
PCT9438	TO	989	548	0	0	33	515	362	153
PCT9439	MV	718	344	0	0	19	325	234	91
PCT9439	ED	199	150	0	0	18	132	103	29
PCT9439	TO	917	494	0	0	37	457	337	120
PCT9441	MV	778	396	0	0	25	371	265	106
PCT9441	ED	193	187	0	0	18	169	140	29
PCT9441	TO	971	583	0	0	43	540	405	135
PCT9442	MV	830	382	0	0	34	348	227	121
PCT9442	ED	210	231	0	0	16	215	172	43
PCT9442	TO	1040	613	0	0	50	563	399	164
PCT9443	MV	760	363	0	1	18	344	263	81
PCT9443	ED	195	172	0	0	15	157	118	39
PCT9443	TO	955	535	0	1	33	501	381	120
PCT9444	MV	768	343	0	0	15	328	222	106
PCT9444	ED	197	153	0	0	13	140	113	27
PCT9444	TO	965	496	0	0	28	468	335	133
PCT9445	MV	830	407	0	0	26	381	278	103
PCT9445	ED	166	178	0	0	16	162	125	37
PCT9445	TO	996	585	0	0	42	543	403	140
PCT9446	MV	900	466	0	0	29	437	288	149
PCT9446	ED	216	185	0	0	17	168	134	34
PCT9446	TO	1116	651	0	0	46	605	422	183
PCT9447	MV	729	395	0	0	19	376	264	112
PCT9447	ED	192	203	0	0	20	183	154	29
PCT9447	TO	921	598	0	0	39	559	418	141
PCT9448	MV	742	347	0	0	18	329	226	103
PCT9448	ED	198	183	0	0	15	168	143	25
PCT9448	TO	940	530	0	0	33	497	369	128
PCT9449	MV	719	342	0	0	19	323	206	117
PCT9449	ED	162	128	0	0	9	119	89	30
PCT9449	TO	881	470	0	0	28	442	295	147
PCT9451	MV	353	178	0	0	7	171	111	60
PCT9451	ED	88	71	0	0	4	67	49	18
PCT9451	TO	441	249	0	0	11	238	160	78
PCT9452	MV	647	336	0	0	18	318	227	91
PCT9452	ED	195	199	0	0	15	184	134	50
PCT9452	TO	842	535	0	0	33	502	361	141
PCT9453	MV	409	220	0	0	10	210	140	70
PCT9453	ED	115	88	0	0	9	79	57	22
PCT9453	TO	524	308	0	0	19	289	197	92
PCT9501	MV	158	92	0	2	7	83	67	16
PCT9501	ED	-8	5	0	0	2	3	2	1
PCT9501	TO	150	97	0	2	9	86	69	17
PCT9502	MV	294	136	0	0	9	127	110	17
PCT9502	ED	-43	12	0	0	1	11	11	0
PCT9502	TO	251	148	0	0	10	138	121	17
PCT9503	MV	550	263	0	0	28	235	216	19
PCT9503	ED	150	139	0	0	17	122	113	9
PCT9503	TO	700	402	0	0	45	357	329	28
PCT9505	MV	589	296	0	0	25	271	234	37
PCT9505	ED	176	147	0	0	14	133	120	13
PCT9505	TO	765	443	0	0	39	404	354	50
PCT9506	MV	547	233	0	0	15	218	197	21
PCT9506	ED	207	147	0	0	12	135	121	14
PCT9506	TO	754	380	0	0	27	353	318	35
PCT9507	MV	556	306	0	0	21	285	259	26
PCT9507	ED	160	206	0	0	18	188	165	23
PCT9507	TO	716	512	0	0	39	473	424	49
PCT9508	MV	632	320	0	0	20	300	279	21
PCT9508	ED	148	211	0	0	29	182	168	14
PCT9508	TO	780	531	0	0	49	482	447	35
PCT9509	MV	585	297	0	0	22	275	248	27
PCT9509	ED	142	196	0	0	21	175	164	11
PCT9509	TO	727	493	0	0	43	450	412	38
PCT9511	MV	458	242	0	0	16	226	200	26
PCT9511	ED	176	179	0	0	17	162	138	24
PCT9511	TO	634	421	0	0	33	388	338	50
PCT9512	MV	617	328	0	1	18	309	274	35
PCT9512	ED	160	209	0	0	18	191	175	16
PCT9512	TO	777	537	0	1	36	500	449	51
PCT9513	MV	686	335	0	0	23	312	296	16
PCT9513	ED	191	202	0	0	15	187	170	17
PCT9513	TO	877	537	0	0	38	499	466	33
PCT9514	MV	713	353	0	0	31	322	288	34
PCT9514	ED	183	247	0	0	17	230	213	17
PCT9514	TO	896	600	0	0	48	552	501	51
PCT9515	MV	543	306	0	0	21	285	245	40
PCT9515	ED	169	190	0	0	22	168	146	22
PCT9515	TO	712	496	0	0	43	453	391	62
PCT9516	MV	705	367	0	0	23	344	299	45
PCT9516	ED	184	221	0	0	20	201	163	38
PCT9516	TO	889	588	0	0	43	545	462	83
PCT9517	MV	626	335	0	0	25	310	281	29
PCT9517	ED	162	200	0	0	21	179	158	21
PCT9517	TO	788	535	0	0	46	489	439	50
PCT9518	MV	642	319	0	0	26	293	268	25
PCT9518	ED	146	218	0	0	16	202	183	19
PCT9518	TO	788	537	0	0	42	495	451	44
PCT9519	MV	693	370	0	0	17	353	315	38
PCT9519	ED	198	258	0	0	33	225	199	26
PCT9519	TO	891	628	0	0	50	578	514	64
PCT9521	MV	687	352	0	0	25	327	293	34
PCT9521	ED	214	256	0	0	25	231	211	20
PCT9521	TO	901	608	0	0	50	558	504	54
PCT9701	MV	498	271	0	0	19	252	203	49
PCT9701	ED	156	163	0	0	6	157	141	16
PCT9701	TO	654	434	0	0	25	409	344	65
PCT9702	MV	554	309	0	0	14	295	248	47
PCT9702	ED	166	195	0	0	7	188	163	25
PCT9702	TO	720	504	0	0	21	483	411	72
PCT9703	MV	809	403	0	0	30	373	261	112
PCT9703	ED	182	200	0	0	14	186	149	37
PCT9703	TO	991	603	0	0	44	559	410	149
PCT9704	MV	760	426	0	0	31	395	310	85
PCT9704	ED	199	244	0	0	21	223	190	33
PCT9704	TO	959	670	0	0	52	618	500	118
PCT9705	MV	754	421	0	0	29	392	319	73
PCT9705	ED	175	203	0	0	15	188	168	20
PCT9705	TO	929	624	0	0	44	580	487	93
PCT9706	MV	57	35	0	0	1	34	34	0
PCT9706	ED	-8	1	0	0	0	1	1	0
PCT9706	TO	49	36	0	0	1	35	35	0
PCT9707	MV	687	359	0	0	19	340	234	106
PCT9707	ED	139	146	0	0	14	132	102	30
PCT9707	TO	826	505	0	0	33	472	336	136
PCT9708	MV	786	432	0	0	41	391	317	74
PCT9708	ED	175	216	0	0	13	203	172	31
PCT9708	TO	961	648	0	0	54	594	489	105
PCT9709	MV	831	429	0	1	36	392	279	113
PCT9709	ED	209	229	0	0	12	217	165	52
PCT9709	TO	1040	658	0	1	48	609	444	165
PCT9711	MV	502	307	0	0	16	291	224	67
PCT9711	ED	144	168	0	0	12	156	113	43
PCT9711	TO	646	475	0	0	28	447	337	110
PCT9712	MV	534	337	0	0	23	314	231	83
PCT9712	ED	127	138	0	0	2	136	105	31
PCT9712	TO	661	475	0	0	25	450	336	114
PCT9713	MV	747	391	0	0	21	370	256	114
PCT9713	ED	203	182	0	0	13	169	120	49
PCT9713	TO	950	573	0	0	34	539	376	163
PCT9714	MV	795	447	0	0	31	416	292	124
PCT9714	ED	156	177	0	0	7	170	124	46
PCT9714	TO	951	624	0	0	38	586	416	170
PCT9715	MV	449	242	0	0	11	231	166	65
PCT9715	ED	130	156	0	0	7	149	115	34
PCT9715	TO	579	398	0	0	18	380	281	99
PCT9716	MV	745	401	0	0	21	380	285	95
PCT9716	ED	221	216	0	0	19	197	150	47
PCT9716	TO	966	617	0	0	40	577	435	142
PCT9717	MV	753	439	0	0	20	419	323	96
PCT9717	ED	224	189	0	0	15	174	130	44
PCT9717	TO	977	628	0	0	35	593	453	140
PCT9718	MV	749	451	0	0	24	427	336	91
PCT9718	ED	152	184	0	0	8	176	133	43
PCT9718	TO	901	635	0	0	32	603	469	134
PCT9719	MV	747	465	0	1	25	439	330	109
PCT9719	ED	173	191	0	0	13	178	138	40
PCT9719	TO	920	656	0	1	38	617	468	149
PCT9721	MV	498	291	0	0	18	273	203	70
PCT9721	ED	164	174	0	1	9	164	126	38
PCT9721	TO	662	465	0	1	27	437	329	108
PCT9722	MV	513	315	0	0	19	296	224	72
PCT9722	ED	84	100	0	0	11	89	72	17
PCT9722	TO	597	415	0	0	30	385	296	89
PCT9723	MV	436	224	0	0	9	215	112	103
PCT9723	ED	72	66	0	0	7	59	39	20
PCT9723	TO	508	290	0	0	16	274	151	123
PCT9724	MV	851	456	0	0	24	432	248	184
PCT9724	ED	169	143	0	1	10	132	91	41
PCT9724	TO	1020	599	0	1	34	564	339	225
PCT9725	MV	814	439	0	0	24	415	262	153
PCT9725	ED	157	165	0	0	14	151	98	53
PCT9725	TO	971	604	0	0	38	566	360	206
PCT9726	MV	630	217	0	0	18	199	169	30
PCT9726	ED	-14	261	0	0	22	239	224	15
PCT9726	TO	616	478	0	0	40	438	393	45
PCT9727	MV	404	227	0	2	12	213	151	62
PCT9727	ED	56	64	0	0	6	58	44	14
PCT9727	TO	460	291	0	2	18	271	195	76
PCT9728	MV	751	447	0	0	21	426	290	136
PCT9728	ED	212	183	0	0	10	173	121	52
PCT9728	TO	963	630	0	0	31	599	411	188
PCT9729	MV	654	338	0	0	19	319	216	103
PCT9729	ED	164	174	0	0	10	164	126	38
PCT9729	TO	818	512	0	0	29	483	342	141
PCT9731	MV	436	246	0	0	12	234	162	72
PCT9731	ED	143	145	0	0	8	137	106	31
PCT9731	TO	579	391	0	0	20	371	268	103
PCT9732	MV	78	47	0	0	5	42	29	13
PCT9732	ED	-5	3	0	0	1	2	2	0
PCT9732	TO	73	50	0	0	6	44	31	13
PCT9733	MV	261	162	0	0	3	159	138	21
PCT9733	ED	-21	12	0	0	3	9	9	0
PCT9733	TO	240	174	0	0	6	168	147	21
PCT9734	MV	473	290	0	0	16	274	199	75
PCT9734	ED	131	131	0	0	3	128	92	36
PCT9734	TO	604	421	0	0	19	402	291	111
PCT9735	MV	650	390	0	2	23	365	270	95
PCT9735	ED	170	187	0	0	29	158	125	33
PCT9735	TO	820	577	0	2	52	523	395	128
PCT9736	MV	586	329	0	0	19	310	232	78
PCT9736	ED	150	187	0	0	16	171	136	35
PCT9736	TO	736	516	0	0	35	481	368	113
PCT9737	MV	637	390	0	0	20	370	267	103
PCT9737	ED	154	164	0	0	10	154	131	23
PCT9737	TO	791	554	0	0	30	524	398	126
PCT9738	MV	688	320	0	0	23	297	244	53
PCT9738	ED	150	117	0	0	10	107	89	18
PCT9738	TO	838	437	0	0	33	404	333	71
PCT9739	MV	674	272	0	0	10	262	236	26
PCT9739	ED	115	240	0	0	19	221	210	11
PCT9739	TO	789	512	0	0	29	483	446	37
PCT9741	MV	841	174	0	0	15	159	150	9
PCT9741	ED	-400	352	0	0	44	308	285	23
PCT9741	TO	441	526	0	0	59	467	435	32
PCT9742	MV	530	229	0	0	6	223	148	75
PCT9742	ED	165	163	0	0	10	153	125	28
PCT9742	TO	695	392	0	0	16	376	273	103
PCT9743	MV	913	405	0	0	21	384	319	65
PCT9743	ED	227	256	0	0	22	234	203	31
PCT9743	TO	1140	661	0	0	43	618	522	96
PCT9744	MV	783	334	0	0	24	310	265	45
PCT9744	ED	160	252	0	0	40	212	184	28
PCT9744	TO	943	586	0	0	64	522	449	73
PCT9745	MV	791	321	0	0	22	299	267	32
PCT9745	ED	201	230	0	0	21	209	193	16
PCT9745	TO	992	551	0	0	43	508	460	48
PCT9746	MV	714	374	0	0	10	364	267	97
PCT9746	ED	189	154	0	0	9	145	116	29
PCT9746	TO	903	528	0	0	19	509	383	126
PCT9747	MV	772	401	0	0	18	383	280	103
PCT9747	ED	204	193	0	0	15	178	142	36
PCT9747	TO	976	594	0	0	33	561	422	139
PCT9748	MV	746	425	0	0	25	400	318	82
PCT9748	ED	167	164	0	0	10	154	118	36
PCT9748	TO	913	589	0	0	35	554	436	118
PCT9749	MV	750	289	0	0	11	278	218	60
PCT9749	ED	188	169	0	0	8	161	134	27
PCT9749	TO	938	458	0	0	19	439	352	87
PCT9751	MV	857	475	0	0	31	444	332	112
PCT9751	ED	214	205	0	0	25	180	146	34
PCT9751	TO	1071	680	0	0	56	624	478	146
PCT9752	MV	563	330	0	0	19	311	224	87
PCT9752	ED	134	156	0	0	11	145	113	32
PCT9752	TO	697	486	0	0	30	456	337	119
PCT9753	MV	617	300	0	0	13	287	230	57
PCT9753	ED	145	168	0	0	4	164	136	28
PCT9753	TO	762	468	0	0	17	451	366	85
PCT9754	MV	545	317	0	2	17	298	253	45
PCT9754	ED	162	149	0	0	12	137	117	20
PCT9754	TO	707	466	0	2	29	435	370	65
PCT9755	MV	441	240	0	0	16	224	176	48
PCT9755	ED	139	134	0	0	6	128	102	26
PCT9755	TO	580	374	0	0	22	352	278	74
PCT9756	MV	805	365	0	0	27	338	221	117
PCT9756	ED	162	152	0	0	10	142	113	29
PCT9756	TO	967	517	0	0	37	480	334	146
PCT9801	MV	320	163	0	0	12	151	119	32
PCT9801	ED	88	68	0	0	7	61	52	9
PCT9801	TO	408	231	0	0	19	212	171	41
CONG12	MV	355618	175425	0	31	11835	163559	134967	28592
CONG12	ED	90230	95881	0	16	8886	86979	74661	12318
CONG12	TO	445848	271306	0	47	20721	250538	209628	40910
CONG14	MV	47257	22458	0	9	1209	21240	15632	5608
CONG14	ED	10794	10723	0	3	843	9877	8050	1827
CONG14	TO	58051	33181	0	12	2052	31117	23682	7435
ASSM17	MV	232806	115045	0	20	7735	107290	90630	16660
ASSM17	ED	59616	61588	0	15	5721	55852	48754	7098
ASSM17	TO	292422	176633	0	35	13456	163142	139384	23758
ASSM19	MV	170069	82838	0	20	5309	77509	59969	17540
ASSM19	ED	41408	45016	0	4	4008	41004	33957	7047
ASSM19	TO	211477	127854	0	24	9317	118513	93926	24587
SUPV1	MV	33870	16641	0	0	1030	15611	12483	3128
SUPV1	ED	9246	10117	0	1	854	9262	7837	1425
SUPV1	TO	43116	26758	0	1	1884	24873	20320	4553
SUPV2	MV	41436	20051	0	4	1640	18407	14981	3426
SUPV2	ED	8610	11668	0	0	1320	10348	8625	1723
SUPV2	TO	50046	31719	0	4	2960	28755	23606	5149
SUPV3	MV	31944	14470	0	3	1101	13366	11063	2303
SUPV3	ED	7433	7823	0	2	838	6983	6082	901
SUPV3	TO	39377	22293	0	5	1939	20349	17145	3204
SUPV4	MV	35051	16945	0	3	1009	15933	11578	4355
SUPV4	ED	9043	8505	0	0	684	7821	6259	1562
SUPV4	TO	44094	25450	0	3	1693	23754	17837	5917
SUPV5	MV	41973	21588	0	6	1540	20042	17912	2130
SUPV5	ED	10927	13106	0	3	1255	11848	10677	1171
SUPV5	TO	52900	34694	0	9	2795	31890	28589	3301
SUPV6	MV	35758	15269	0	7	1102	14160	12158	2002
SUPV6	ED	7937	7195	0	4	839	6352	5555	797
SUPV6	TO	43695	22464	0	11	1941	20512	17713	2799
SUPV7	MV	38893	20830	0	8	1215	19607	14881	4726
SUPV7	ED	8550	10397	0	2	782	9613	7788	1825
SUPV7	TO	47443	31227	0	10	1997	29220	22669	6551
SUPV8	MV	46374	27610	0	3	1804	25803	22419	3384
SUPV8	ED	11803	15019	0	3	1239	13777	12061	1716
SUPV8	TO	58177	42629	0	6	3043	39580	34480	5100
SUPV9	MV	33166	16841	0	1	988	15852	13390	2462
SUPV9	ED	10097	10028	0	2	806	9220	8136	1084
SUPV9	TO	43263	26869	0	3	1794	25072	21526	3546
SUPV10	MV	33767	14153	0	2	909	13242	10468	2774
SUPV10	ED	9346	6679	0	1	627	6051	5130	921
SUPV10	TO	43113	20832	0	3	1536	19293	15598	3695
SUPV11	MV	30643	13485	0	3	706	12776	9266	3510
SUPV11	ED	8032	6067	0	1	485	5581	4561	1020
SUPV11	TO	38675	19552	0	4	1191	18357	13827	4530
NEIG1	MV	15466	5990	0	2	397	5591	4307	1284
NEIG1	ED	5019	2585	0	0	226	2359	1975	384
NEIG1	TO	20485	8575	0	2	623	7950	6282	1668
NEIG2	MV	14029	6299	0	0	528	5771	4699	1072
NEIG2	ED	3238	3333	0	1	383	2949	2538	411
NEIG2	TO	17267	9632	0	1	911	8720	7237	1483
NEIG3	MV	22050	9525	0	4	710	8811	7642	1169
NEIG3	ED	5969	4972	0	5	514	4453	3938	515
NEIG3	TO	28019	14497	0	9	1224	13264	11580	1684
NEIG4	MV	5630	3506	0	0	208	3298	2726	572
NEIG4	ED	1430	1650	0	1	144	1505	1233	272
NEIG4	TO	7060	5156	0	1	352	4803	3959	844
NEIG5	MV	22699	10154	0	1	554	9599	6945	2654
NEIG5	ED	5894	4391	0	0	346	4045	3275	770
NEIG5	TO	28593	14545	0	1	900	13644	10220	3424
NEIG6	MV	11528	5995	0	1	413	5581	5031	550
NEIG6	ED	2334	3912	0	1	359	3552	3225	327
NEIG6	TO	13862	9907	0	2	772	9133	8256	877
NEIG7	MV	9819	4148	0	2	202	3944	2879	1065
NEIG7	ED	2576	2065	0	1	164	1900	1585	315
NEIG7	TO	12395	6213	0	3	366	5844	4464	1380
NEIG8	MV	7628	4046	0	1	278	3767	3312	455
NEIG8	ED	2030	2564	0	0	223	2341	2086	255
NEIG8	TO	9658	6610	0	1	501	6108	5398	710
NEIG9	MV	7421	3162	0	0	190	2972	2272	700
NEIG9	ED	837	2082	0	1	209	1872	1616	256
NEIG9	TO	8258	5244	0	1	399	4844	3888	956
NEIG10	MV	8173	3963	0	0	277	3686	3102	584
NEIG10	ED	1849	2654	0	0	235	2419	2095	324
NEIG10	TO	10022	6617	0	0	512	6105	5197	908
NEIG11	MV	33510	15581	0	1	1324	14256	11632	2624
NEIG11	ED	5930	9037	0	0	1077	7960	6612	1348
NEIG11	TO	39440	24618	0	1	2401	22216	18244	3972
NEIG12	MV	23576	11896	0	2	692	11202	10014	1188
NEIG12	ED	7429	7889	0	1	687	7201	6551	650
NEIG12	TO	31005	19785	0	3	1379	18403	16565	1838
NEIG14	MV	6791	4011	0	0	263	3748	3302	446
NEIG14	ED	1942	2315	0	1	174	2140	1894	246
NEIG14	TO	8733	6326	0	1	437	5888	5196	692
NEIG15	MV	5780	2686	0	0	162	2524	2018	506
NEIG15	ED	1308	1495	0	0	148	1347	1164	183
NEIG15	TO	7088	4181	0	0	310	3871	3182	689
NEIG13	MV	13553	8197	0	0	557	7640	6564	1076
NEIG13	ED	3435	4440	0	0	348	4092	3557	535
NEIG13	TO	16988	12637	0	0	905	11732	10121	1611
NEIG26	MV	7830	3541	0	0	205	3336	2266	1070
NEIG26	ED	1802	1384	0	0	108	1276	985	291
NEIG26	TO	9632	4925	0	0	313	4612	3251	1361
NEIG16	MV	14623	6988	0	1	494	6493	5571	922
NEIG16	ED	2733	3777	0	1	417	3359	2940	419
NEIG16	TO	17356	10765	0	2	911	9852	8511	1341
NEIG17	MV	29449	14464	0	0	905	13559	10799	2760
NEIG17	ED	8176	8539	0	1	718	7820	6589	1231
NEIG17	TO	37625	23003	0	1	1623	21379	17388	3991
NEIG19	MV	7164	4038	0	0	239	3799	3277	522
NEIG19	ED	2407	2405	0	0	185	2220	1917	303
NEIG19	TO	9571	6443	0	0	424	6019	5194	825
NEIG18	MV	6458	3427	0	3	234	3190	2501	689
NEIG18	ED	1563	2033	0	0	194	1839	1535	304
NEIG18	TO	8021	5460	0	3	428	5029	4036	993
NEIG20	MV	20913	8934	0	5	629	8300	7075	1225
NEIG20	ED	4164	4203	0	0	492	3711	3221	490
NEIG20	TO	25077	13137	0	5	1121	12011	10296	1715
NEIG21	MV	34608	16718	0	3	990	15725	11399	4326
NEIG21	ED	8885	8333	0	0	673	7660	6114	1546
NEIG21	TO	43493	25051	0	3	1663	23385	17513	5872
NEIG22	MV	15383	9329	0	2	617	8710	7649	1061
NEIG22	ED	3510	4898	0	2	386	4510	3989	521
NEIG22	TO	18893	14227	0	4	1003	13220	11638	1582
NEIG23	MV	6638	2527	0	0	138	2389	1641	748
NEIG23	ED	1850	944	0	0	89	855	684	171
NEIG23	TO	8488	3471	0	0	227	3244	2325	919
NEIG24	MV	28440	16175	0	8	943	15224	11516	3708
NEIG24	ED	6934	7501	0	1	529	6971	5517	1454
NEIG24	TO	35374	23676	0	9	1472	22195	17033	5162
NEIG25	MV	23716	12583	0	4	895	11684	10460	1224
NEIG25	ED	7780	7203	0	2	701	6500	5876	624
NEIG25	TO	31496	19786	0	6	1596	18184	16336	1848
