area_id	subtotal_type	RSReg	RSCst	RSRej	RSOvr	RSUnd	RSTot	5:YES	6:NO
ALLPCTS	TO	503899	144603	0	29	9260	135314	109711	25603
ALLPCTS	ED	102888	72177	0	13	4886	67278	57004	10274
ALLPCTS	MV	401011	72426	0	16	4374	68036	52707	15329
PCT1101	MV	446	89	0	0	6	83	64	19
PCT1101	ED	116	60	0	0	5	55	45	10
PCT1101	TO	562	149	0	0	11	138	109	29
PCT1102	MV	767	120	0	0	4	116	77	39
PCT1102	ED	237	158	0	0	9	149	117	32
PCT1102	TO	1004	278	0	0	13	265	194	71
PCT1103	MV	747	147	0	0	2	145	105	40
PCT1103	ED	224	142	0	0	6	136	109	27
PCT1103	TO	971	289	0	0	8	281	214	67
PCT1104	MV	750	122	0	0	1	121	96	25
PCT1104	ED	268	119	0	0	5	114	92	22
PCT1104	TO	1018	241	0	0	6	235	188	47
PCT1106	MV	595	93	0	0	4	89	51	38
PCT1106	ED	176	96	0	1	6	89	68	21
PCT1106	TO	771	189	0	1	10	178	119	59
PCT1107	MV	602	100	0	0	3	97	57	40
PCT1107	ED	149	76	0	0	7	69	57	12
PCT1107	TO	751	176	0	0	10	166	114	52
PCT1108	MV	718	117	0	0	6	111	86	25
PCT1108	ED	205	114	0	0	9	105	83	22
PCT1108	TO	923	231	0	0	15	216	169	47
PCT1109	MV	649	108	0	0	5	103	58	45
PCT1109	ED	173	97	0	0	4	93	74	19
PCT1109	TO	822	205	0	0	9	196	132	64
PCT1111	MV	841	150	0	0	6	144	97	47
PCT1111	ED	205	118	0	0	6	112	89	23
PCT1111	TO	1046	268	0	0	12	256	186	70
PCT1112	MV	641	100	0	0	7	93	67	26
PCT1112	ED	161	76	0	0	5	71	59	12
PCT1112	TO	802	176	0	0	12	164	126	38
PCT1113	MV	674	102	0	0	7	95	68	27
PCT1113	ED	121	65	0	0	6	59	49	10
PCT1113	TO	795	167	0	0	13	154	117	37
PCT1114	MV	766	102	0	0	4	98	78	20
PCT1114	ED	225	97	0	0	9	88	78	10
PCT1114	TO	991	199	0	0	13	186	156	30
PCT1115	MV	739	114	0	0	4	110	76	34
PCT1115	ED	197	85	0	0	2	83	67	16
PCT1115	TO	936	199	0	0	6	193	143	50
PCT1116	MV	702	141	0	0	8	133	100	33
PCT1116	ED	229	118	0	0	7	111	102	9
PCT1116	TO	931	259	0	0	15	244	202	42
PCT1117	MV	654	103	0	0	2	101	63	38
PCT1117	ED	192	71	0	0	3	68	59	9
PCT1117	TO	846	174	0	0	5	169	122	47
PCT1118	MV	841	123	0	0	4	119	80	39
PCT1118	ED	224	100	0	0	9	91	71	20
PCT1118	TO	1065	223	0	0	13	210	151	59
PCT1119	MV	658	114	0	0	4	110	80	30
PCT1119	ED	139	73	0	0	6	67	63	4
PCT1119	TO	797	187	0	0	10	177	143	34
PCT1121	MV	556	115	0	0	6	109	65	44
PCT1121	ED	149	81	0	0	6	75	54	21
PCT1121	TO	705	196	0	0	12	184	119	65
PCT1122	MV	518	67	0	0	5	62	40	22
PCT1122	ED	119	70	0	0	5	65	54	11
PCT1122	TO	637	137	0	0	10	127	94	33
PCT1123	MV	720	77	0	0	1	76	48	28
PCT1123	ED	218	89	0	0	6	83	67	16
PCT1123	TO	938	166	0	0	7	159	115	44
PCT1124	MV	616	96	0	2	4	90	63	27
PCT1124	ED	213	72	0	0	3	69	60	9
PCT1124	TO	829	168	0	2	7	159	123	36
PCT1125	MV	913	154	0	0	14	140	96	44
PCT1125	ED	184	65	0	0	6	59	53	6
PCT1125	TO	1097	219	0	0	20	199	149	50
PCT1126	MV	811	149	0	0	8	141	107	34
PCT1126	ED	201	68	0	0	1	67	53	14
PCT1126	TO	1012	217	0	0	9	208	160	48
PCT1127	MV	742	123	0	0	6	117	77	40
PCT1127	ED	223	99	0	0	3	96	75	21
PCT1127	TO	965	222	0	0	9	213	152	61
PCT1128	MV	733	111	0	0	3	108	66	42
PCT1128	ED	146	59	0	0	6	53	42	11
PCT1128	TO	879	170	0	0	9	161	108	53
PCT1129	MV	786	129	0	0	6	123	89	34
PCT1129	ED	250	108	0	0	13	95	68	27
PCT1129	TO	1036	237	0	0	19	218	157	61
PCT1131	MV	693	103	0	0	8	95	59	36
PCT1131	ED	167	60	0	0	4	56	49	7
PCT1131	TO	860	163	0	0	12	151	108	43
PCT1132	MV	835	152	0	0	9	143	103	40
PCT1132	ED	197	59	0	0	0	59	38	21
PCT1132	TO	1032	211	0	0	9	202	141	61
PCT1133	MV	715	140	0	0	3	137	99	38
PCT1133	ED	160	74	0	0	3	71	51	20
PCT1133	TO	875	214	0	0	6	208	150	58
PCT1134	MV	584	122	0	0	5	117	64	53
PCT1134	ED	183	80	0	0	7	73	64	9
PCT1134	TO	767	202	0	0	12	190	128	62
PCT1135	MV	464	83	0	0	3	80	56	24
PCT1135	ED	92	50	0	0	1	49	40	9
PCT1135	TO	556	133	0	0	4	129	96	33
PCT1136	MV	709	152	0	0	8	144	101	43
PCT1136	ED	158	77	0	0	4	73	63	10
PCT1136	TO	867	229	0	0	12	217	164	53
PCT1141	MV	834	144	0	0	3	141	97	44
PCT1141	ED	222	123	0	0	4	119	92	27
PCT1141	TO	1056	267	0	0	7	260	189	71
PCT1142	MV	721	111	0	0	8	103	84	19
PCT1142	ED	175	87	0	0	3	84	73	11
PCT1142	TO	896	198	0	0	11	187	157	30
PCT1143	MV	822	152	0	0	9	143	99	44
PCT1143	ED	227	113	0	0	7	106	91	15
PCT1143	TO	1049	265	0	0	16	249	190	59
PCT1144	MV	725	110	0	0	4	106	68	38
PCT1144	ED	222	121	0	0	9	112	86	26
PCT1144	TO	947	231	0	0	13	218	154	64
PCT1145	MV	752	146	0	0	10	136	94	42
PCT1145	ED	153	114	0	0	8	106	83	23
PCT1145	TO	905	260	0	0	18	242	177	65
PCT1146	MV	837	143	0	0	8	135	95	40
PCT1146	ED	217	109	0	0	7	102	78	24
PCT1146	TO	1054	252	0	0	15	237	173	64
PCT1147	MV	671	100	0	0	3	97	65	32
PCT1147	ED	214	107	0	0	5	102	82	20
PCT1147	TO	885	207	0	0	8	199	147	52
PCT1148	MV	802	148	0	0	3	145	100	45
PCT1148	ED	226	116	0	0	8	108	85	23
PCT1148	TO	1028	264	0	0	11	253	185	68
PCT1149	MV	708	107	0	0	4	103	72	31
PCT1149	ED	231	118	0	0	9	109	83	26
PCT1149	TO	939	225	0	0	13	212	155	57
PCT1151	MV	0	0	0	0	0	0	0	0
PCT1151	ED	0	0	0	0	0	0	0	0
PCT1151	TO	0	0	0	0	0	0	0	0
PCT1152	MV	710	112	0	0	4	108	81	27
PCT1152	ED	180	85	0	0	7	78	58	20
PCT1152	TO	890	197	0	0	11	186	139	47
PCT1153	MV	730	114	0	0	8	106	76	30
PCT1153	ED	210	116	0	0	9	107	76	31
PCT1153	TO	940	230	0	0	17	213	152	61
PCT1154	MV	0	0	0	0	0	0	0	0
PCT1154	ED	0	0	0	0	0	0	0	0
PCT1154	TO	0	0	0	0	0	0	0	0
PCT7001	MV	630	112	0	0	6	106	88	18
PCT7001	ED	143	101	0	0	6	95	83	12
PCT7001	TO	773	213	0	0	12	201	171	30
PCT7002	MV	595	81	0	0	7	74	60	14
PCT7002	ED	119	88	0	0	3	85	73	12
PCT7002	TO	714	169	0	0	10	159	133	26
PCT7003	MV	759	147	0	0	4	143	120	23
PCT7003	ED	147	144	0	0	12	132	108	24
PCT7003	TO	906	291	0	0	16	275	228	47
PCT7004	MV	763	146	0	0	9	137	117	20
PCT7004	ED	150	142	0	0	9	133	110	23
PCT7004	TO	913	288	0	0	18	270	227	43
PCT7005	MV	696	142	0	0	6	136	122	14
PCT7005	ED	163	162	0	0	17	145	133	12
PCT7005	TO	859	304	0	0	23	281	255	26
PCT7006	MV	726	119	0	0	7	112	97	15
PCT7006	ED	206	149	0	0	11	138	114	24
PCT7006	TO	932	268	0	0	18	250	211	39
PCT7007	MV	775	145	0	0	7	138	115	23
PCT7007	ED	182	168	0	0	13	155	134	21
PCT7007	TO	957	313	0	0	20	293	249	44
PCT7008	MV	732	154	0	0	11	143	115	28
PCT7008	ED	177	189	0	0	11	178	152	26
PCT7008	TO	909	343	0	0	22	321	267	54
PCT7009	MV	749	141	0	0	9	132	100	32
PCT7009	ED	122	91	0	0	4	87	73	14
PCT7009	TO	871	232	0	0	13	219	173	46
PCT7011	MV	703	66	0	0	7	59	54	5
PCT7011	ED	270	87	0	0	4	83	74	9
PCT7011	TO	973	153	0	0	11	142	128	14
PCT7012	MV	996	192	0	0	15	177	142	35
PCT7012	ED	230	203	0	0	11	192	168	24
PCT7012	TO	1226	395	0	0	26	369	310	59
PCT7013	MV	983	122	0	0	3	119	105	14
PCT7013	ED	156	151	0	0	10	141	131	10
PCT7013	TO	1139	273	0	0	13	260	236	24
PCT7014	MV	608	90	0	0	4	86	73	13
PCT7014	ED	111	111	0	0	14	97	84	13
PCT7014	TO	719	201	0	0	18	183	157	26
PCT7015	MV	128	13	0	0	2	11	10	1
PCT7015	ED	-18	0	0	0	0	0	0	0
PCT7015	TO	110	13	0	0	2	11	10	1
PCT7016	MV	654	85	0	0	3	82	62	20
PCT7016	ED	278	75	0	0	7	68	58	10
PCT7016	TO	932	160	0	0	10	150	120	30
PCT7017	MV	539	52	0	0	3	49	41	8
PCT7017	ED	242	53	0	0	8	45	40	5
PCT7017	TO	781	105	0	0	11	94	81	13
PCT7018	MV	846	130	0	0	9	121	90	31
PCT7018	ED	201	56	0	0	4	52	46	6
PCT7018	TO	1047	186	0	0	13	173	136	37
PCT7019	MV	733	130	0	0	9	121	80	41
PCT7019	ED	167	73	0	0	8	65	54	11
PCT7019	TO	900	203	0	0	17	186	134	52
PCT7021	MV	674	78	0	0	7	71	59	12
PCT7021	ED	293	106	0	0	9	97	84	13
PCT7021	TO	967	184	0	0	16	168	143	25
PCT7022	MV	766	109	0	0	9	100	86	14
PCT7022	ED	197	54	0	0	2	52	48	4
PCT7022	TO	963	163	0	0	11	152	134	18
PCT7023	MV	684	142	0	0	3	139	108	31
PCT7023	ED	236	71	0	0	6	65	57	8
PCT7023	TO	920	213	0	0	9	204	165	39
PCT7024	MV	251	25	0	0	1	24	23	1
PCT7024	ED	190	20	0	0	3	17	17	0
PCT7024	TO	441	45	0	0	4	41	40	1
PCT7025	MV	316	41	0	0	1	40	35	5
PCT7025	ED	167	39	0	0	1	38	34	4
PCT7025	TO	483	80	0	0	2	78	69	9
PCT7026	MV	815	137	0	0	5	132	82	50
PCT7026	ED	195	72	0	0	4	68	52	16
PCT7026	TO	1010	209	0	0	9	200	134	66
PCT7027	MV	675	96	0	0	6	90	56	34
PCT7027	ED	221	96	0	0	8	88	69	19
PCT7027	TO	896	192	0	0	14	178	125	53
PCT7028	MV	584	85	0	0	5	80	63	17
PCT7028	ED	272	97	0	0	7	90	74	16
PCT7028	TO	856	182	0	0	12	170	137	33
PCT7029	MV	641	80	0	0	2	78	59	19
PCT7029	ED	268	39	0	0	2	37	32	5
PCT7029	TO	909	119	0	0	4	115	91	24
PCT7030	MV	654	128	0	0	3	125	75	50
PCT7030	ED	141	58	0	0	2	56	36	20
PCT7030	TO	795	186	0	0	5	181	111	70
PCT7031	MV	619	119	0	1	12	106	82	24
PCT7031	ED	75	48	0	0	6	42	33	9
PCT7031	TO	694	167	0	1	18	148	115	33
PCT7032	MV	639	112	0	0	8	104	81	23
PCT7032	ED	242	51	0	0	2	49	38	11
PCT7032	TO	881	163	0	0	10	153	119	34
PCT7033	MV	546	96	0	0	5	91	69	22
PCT7033	ED	232	86	0	0	7	79	62	17
PCT7033	TO	778	182	0	0	12	170	131	39
PCT7034	MV	618	52	0	0	5	47	45	2
PCT7034	ED	320	57	0	0	3	54	46	8
PCT7034	TO	938	109	0	0	8	101	91	10
PCT7035	MV	567	86	0	0	5	81	64	17
PCT7035	ED	152	52	0	0	5	47	41	6
PCT7035	TO	719	138	0	0	10	128	105	23
PCT7036	MV	780	108	0	0	2	106	63	43
PCT7036	ED	194	39	0	0	1	38	30	8
PCT7036	TO	974	147	0	0	3	144	93	51
PCT7037	MV	431	31	0	0	0	31	26	5
PCT7037	ED	315	38	0	0	5	33	31	2
PCT7037	TO	746	69	0	0	5	64	57	7
PCT7038	MV	757	145	0	0	8	137	91	46
PCT7038	ED	204	58	0	0	8	50	40	10
PCT7038	TO	961	203	0	0	16	187	131	56
PCT7039	MV	636	106	0	0	8	98	63	35
PCT7039	ED	201	104	0	0	6	98	69	29
PCT7039	TO	837	210	0	0	14	196	132	64
PCT7041	MV	70	13	0	0	1	12	8	4
PCT7041	ED	-4	0	0	0	0	0	0	0
PCT7041	TO	66	13	0	0	1	12	8	4
PCT7042	MV	514	88	0	0	3	85	62	23
PCT7042	ED	146	58	0	0	2	56	43	13
PCT7042	TO	660	146	0	0	5	141	105	36
PCT7043	MV	753	116	0	0	5	111	78	33
PCT7043	ED	225	78	0	0	3	75	56	19
PCT7043	TO	978	194	0	0	8	186	134	52
PCT7044	MV	584	67	0	0	2	65	44	21
PCT7044	ED	268	33	0	0	2	31	27	4
PCT7044	TO	852	100	0	0	4	96	71	25
PCT7045	MV	632	120	0	0	8	112	85	27
PCT7045	ED	154	53	0	0	2	51	34	17
PCT7045	TO	786	173	0	0	10	163	119	44
PCT7046	MV	334	45	0	0	2	43	27	16
PCT7046	ED	96	48	0	0	2	46	36	10
PCT7046	TO	430	93	0	0	4	89	63	26
PCT7047	MV	730	135	0	0	6	129	85	44
PCT7047	ED	153	62	0	0	4	58	47	11
PCT7047	TO	883	197	0	0	10	187	132	55
PCT7048	MV	684	108	0	0	5	103	85	18
PCT7048	ED	197	56	0	0	6	50	38	12
PCT7048	TO	881	164	0	0	11	153	123	30
PCT7049	MV	615	105	0	0	1	104	62	42
PCT7049	ED	211	70	0	0	4	66	53	13
PCT7049	TO	826	175	0	0	5	170	115	55
PCT7051	MV	715	129	0	0	8	121	66	55
PCT7051	ED	165	70	0	0	7	63	50	13
PCT7051	TO	880	199	0	0	15	184	116	68
PCT7052	MV	720	121	0	0	4	117	77	40
PCT7052	ED	186	84	0	0	5	79	68	11
PCT7052	TO	906	205	0	0	9	196	145	51
PCT7053	MV	542	102	0	0	11	91	75	16
PCT7053	ED	43	40	0	0	4	36	32	4
PCT7053	TO	585	142	0	0	15	127	107	20
PCT7054	MV	860	98	0	0	9	89	70	19
PCT7054	ED	276	105	0	0	5	100	73	27
PCT7054	TO	1136	203	0	0	14	189	143	46
PCT7055	MV	728	120	0	0	5	115	87	28
PCT7055	ED	98	76	0	0	7	69	60	9
PCT7055	TO	826	196	0	0	12	184	147	37
PCT7056	MV	617	85	0	0	5	80	69	11
PCT7056	ED	88	119	0	0	13	106	92	14
PCT7056	TO	705	204	0	0	18	186	161	25
PCT7101	MV	161	31	0	0	1	30	28	2
PCT7101	ED	-14	0	0	0	0	0	0	0
PCT7101	TO	147	31	0	0	1	30	28	2
PCT7201	MV	787	145	0	0	11	134	106	28
PCT7201	ED	148	98	0	0	12	86	73	13
PCT7201	TO	935	243	0	0	23	220	179	41
PCT7202	MV	706	136	0	0	7	129	101	28
PCT7202	ED	145	123	0	0	11	112	96	16
PCT7202	TO	851	259	0	0	18	241	197	44
PCT7203	MV	693	116	0	0	11	105	87	18
PCT7203	ED	186	148	0	0	18	130	111	19
PCT7203	TO	879	264	0	0	29	235	198	37
PCT7204	MV	771	164	0	0	18	146	117	29
PCT7204	ED	128	116	0	0	19	97	84	13
PCT7204	TO	899	280	0	0	37	243	201	42
PCT7205	MV	723	132	0	0	10	122	104	18
PCT7205	ED	148	133	0	0	14	119	96	23
PCT7205	TO	871	265	0	0	24	241	200	41
PCT7206	MV	298	41	0	0	3	38	31	7
PCT7206	ED	79	76	0	0	4	72	65	7
PCT7206	TO	377	117	0	0	7	110	96	14
PCT7207	MV	742	119	0	0	8	111	92	19
PCT7207	ED	125	117	0	0	9	108	96	12
PCT7207	TO	867	236	0	0	17	219	188	31
PCT7208	MV	491	92	0	0	16	76	54	22
PCT7208	ED	79	60	0	0	3	57	51	6
PCT7208	TO	570	152	0	0	19	133	105	28
PCT7209	MV	595	199	0	0	19	180	150	30
PCT7209	ED	52	63	0	0	4	59	48	11
PCT7209	TO	647	262	0	0	23	239	198	41
PCT7301	MV	810	129	0	0	6	123	100	23
PCT7301	ED	204	112	0	0	10	102	87	15
PCT7301	TO	1014	241	0	0	16	225	187	38
PCT7302	MV	713	175	0	0	11	164	127	37
PCT7302	ED	136	116	0	0	9	107	98	9
PCT7302	TO	849	291	0	0	20	271	225	46
PCT7303	MV	864	148	0	0	7	141	108	33
PCT7303	ED	204	141	0	0	10	131	114	17
PCT7303	TO	1068	289	0	0	17	272	222	50
PCT7304	MV	802	137	0	0	9	128	78	50
PCT7304	ED	199	163	0	0	10	153	136	17
PCT7304	TO	1001	300	0	0	19	281	214	67
PCT7305	MV	710	162	0	0	9	153	105	48
PCT7305	ED	157	141	0	0	10	131	106	25
PCT7305	TO	867	303	0	0	19	284	211	73
PCT7306	MV	800	122	0	0	9	113	85	28
PCT7306	ED	244	152	0	1	17	134	113	21
PCT7306	TO	1044	274	0	1	26	247	198	49
PCT7307	MV	604	96	0	0	6	90	60	30
PCT7307	ED	170	101	0	0	8	93	77	16
PCT7307	TO	774	197	0	0	14	183	137	46
PCT7308	MV	516	106	0	0	3	103	74	29
PCT7308	ED	109	126	0	0	8	118	98	20
PCT7308	TO	625	232	0	0	11	221	172	49
PCT7309	MV	690	116	0	0	9	107	87	20
PCT7309	ED	168	156	0	0	13	143	125	18
PCT7309	TO	858	272	0	0	22	250	212	38
PCT7311	MV	698	107	0	0	7	100	79	21
PCT7311	ED	208	169	0	0	9	160	143	17
PCT7311	TO	906	276	0	0	16	260	222	38
PCT7312	MV	697	150	0	0	8	142	112	30
PCT7312	ED	113	120	0	0	8	112	90	22
PCT7312	TO	810	270	0	0	16	254	202	52
PCT7313	MV	818	173	0	0	10	163	121	42
PCT7313	ED	185	115	0	0	15	100	87	13
PCT7313	TO	1003	288	0	0	25	263	208	55
PCT7314	MV	612	124	0	0	12	112	86	26
PCT7314	ED	147	56	0	0	7	49	41	8
PCT7314	TO	759	180	0	0	19	161	127	34
PCT7315	MV	568	82	0	0	3	79	59	20
PCT7315	ED	197	117	0	0	6	111	89	22
PCT7315	TO	765	199	0	0	9	190	148	42
PCT7316	MV	654	119	0	0	12	107	83	24
PCT7316	ED	178	100	0	0	12	88	82	6
PCT7316	TO	832	219	0	0	24	195	165	30
PCT7317	MV	744	146	0	0	10	136	102	34
PCT7317	ED	146	107	0	0	8	99	89	10
PCT7317	TO	890	253	0	0	18	235	191	44
PCT7318	MV	604	142	0	0	12	130	118	12
PCT7318	ED	119	99	0	0	12	87	67	20
PCT7318	TO	723	241	0	0	24	217	185	32
PCT7319	MV	858	111	0	0	5	106	85	21
PCT7319	ED	191	113	0	0	12	101	84	17
PCT7319	TO	1049	224	0	0	17	207	169	38
PCT7321	MV	557	86	0	0	11	75	52	23
PCT7321	ED	102	62	0	0	3	59	46	13
PCT7321	TO	659	148	0	0	14	134	98	36
PCT7322	MV	740	164	0	0	16	148	115	33
PCT7322	ED	148	25	0	0	0	25	23	2
PCT7322	TO	888	189	0	0	16	173	138	35
PCT7323	MV	788	128	0	0	10	118	96	22
PCT7323	ED	168	126	0	0	11	115	93	22
PCT7323	TO	956	254	0	0	21	233	189	44
PCT7324	MV	585	89	0	0	7	82	64	18
PCT7324	ED	152	88	0	0	5	83	68	15
PCT7324	TO	737	177	0	0	12	165	132	33
PCT7325	MV	712	115	0	0	11	104	82	22
PCT7325	ED	174	121	0	0	10	111	93	18
PCT7325	TO	886	236	0	0	21	215	175	40
PCT7326	MV	684	105	0	0	7	98	76	22
PCT7326	ED	175	116	0	0	13	103	90	13
PCT7326	TO	859	221	0	0	20	201	166	35
PCT7327	MV	561	130	0	0	14	116	85	31
PCT7327	ED	126	37	0	0	1	36	30	6
PCT7327	TO	687	167	0	0	15	152	115	37
PCT7328	MV	829	188	0	0	23	165	138	27
PCT7328	ED	173	46	0	0	6	40	35	5
PCT7328	TO	1002	234	0	0	29	205	173	32
PCT7329	MV	552	125	0	0	13	112	84	28
PCT7329	ED	99	56	0	0	3	53	46	7
PCT7329	TO	651	181	0	0	16	165	130	35
PCT7331	MV	710	171	0	0	10	161	132	29
PCT7331	ED	160	129	0	0	15	114	92	22
PCT7331	TO	870	300	0	0	25	275	224	51
PCT7332	MV	652	101	0	0	7	94	84	10
PCT7332	ED	138	113	0	0	3	110	99	11
PCT7332	TO	790	214	0	0	10	204	183	21
PCT7333	MV	821	143	0	0	16	127	103	24
PCT7333	ED	194	161	0	0	12	149	128	21
PCT7333	TO	1015	304	0	0	28	276	231	45
PCT7334	MV	684	117	0	0	5	112	99	13
PCT7334	ED	135	105	0	0	6	99	85	14
PCT7334	TO	819	222	0	0	11	211	184	27
PCT7335	MV	786	145	0	0	10	135	105	30
PCT7335	ED	148	144	0	0	11	133	123	10
PCT7335	TO	934	289	0	0	21	268	228	40
PCT7336	MV	779	147	0	0	9	138	106	32
PCT7336	ED	175	128	0	0	13	115	97	18
PCT7336	TO	954	275	0	0	22	253	203	50
PCT7337	MV	772	167	0	0	14	153	110	43
PCT7337	ED	125	84	0	0	6	78	65	13
PCT7337	TO	897	251	0	0	20	231	175	56
PCT7338	MV	768	189	0	0	11	178	140	38
PCT7338	ED	127	70	0	0	6	64	54	10
PCT7338	TO	895	259	0	0	17	242	194	48
PCT7339	MV	603	116	0	0	4	112	93	19
PCT7339	ED	152	89	0	0	4	85	76	9
PCT7339	TO	755	205	0	0	8	197	169	28
PCT7341	MV	673	100	0	0	7	93	64	29
PCT7341	ED	180	131	0	0	6	125	114	11
PCT7341	TO	853	231	0	0	13	218	178	40
PCT7342	MV	672	117	0	0	9	108	88	20
PCT7342	ED	232	200	0	1	13	186	164	22
PCT7342	TO	904	317	0	1	22	294	252	42
PCT7343	MV	553	88	0	0	6	82	75	7
PCT7343	ED	151	116	0	0	12	104	93	11
PCT7343	TO	704	204	0	0	18	186	168	18
PCT7344	MV	862	151	0	0	7	144	117	27
PCT7344	ED	202	160	0	0	7	153	133	20
PCT7344	TO	1064	311	0	0	14	297	250	47
PCT7345	MV	900	159	0	0	10	149	126	23
PCT7345	ED	214	170	0	0	11	159	142	17
PCT7345	TO	1114	329	0	0	21	308	268	40
PCT7346	MV	677	111	0	1	4	106	88	18
PCT7346	ED	212	126	0	0	13	113	102	11
PCT7346	TO	889	237	0	1	17	219	190	29
PCT7347	MV	827	152	0	1	14	137	124	13
PCT7347	ED	176	98	0	0	6	92	85	7
PCT7347	TO	1003	250	0	1	20	229	209	20
PCT7348	MV	644	122	0	0	7	115	97	18
PCT7348	ED	199	100	0	0	6	94	84	10
PCT7348	TO	843	222	0	0	13	209	181	28
PCT7349	MV	709	158	0	0	10	148	127	21
PCT7349	ED	203	104	0	0	6	98	90	8
PCT7349	TO	912	262	0	0	16	246	217	29
PCT7501	MV	455	75	0	0	3	72	52	20
PCT7501	ED	96	90	0	0	10	80	66	14
PCT7501	TO	551	165	0	0	13	152	118	34
PCT7502	MV	668	107	0	0	10	97	67	30
PCT7502	ED	121	99	0	0	11	88	77	11
PCT7502	TO	789	206	0	0	21	185	144	41
PCT7503	MV	610	112	0	0	10	102	83	19
PCT7503	ED	152	100	0	0	12	88	72	16
PCT7503	TO	762	212	0	0	22	190	155	35
PCT7504	MV	404	72	0	0	6	66	53	13
PCT7504	ED	84	52	0	0	7	45	41	4
PCT7504	TO	488	124	0	0	13	111	94	17
PCT7505	MV	729	198	0	0	11	187	175	12
PCT7505	ED	133	96	0	0	2	94	87	7
PCT7505	TO	862	294	0	0	13	281	262	19
PCT7506	MV	837	122	0	0	11	111	89	22
PCT7506	ED	163	111	0	0	8	103	99	4
PCT7506	TO	1000	233	0	0	19	214	188	26
PCT7507	MV	690	120	0	0	5	115	93	22
PCT7507	ED	266	95	0	0	3	92	76	16
PCT7507	TO	956	215	0	0	8	207	169	38
PCT7508	MV	617	164	0	0	14	150	130	20
PCT7508	ED	127	103	0	0	7	96	84	12
PCT7508	TO	744	267	0	0	21	246	214	32
PCT7509	MV	755	180	0	0	13	167	141	26
PCT7509	ED	174	145	0	0	8	137	121	16
PCT7509	TO	929	325	0	0	21	304	262	42
PCT7512	MV	473	102	0	0	9	93	77	16
PCT7512	ED	127	85	0	0	7	78	71	7
PCT7512	TO	600	187	0	0	16	171	148	23
PCT7513	MV	573	100	0	0	13	87	77	10
PCT7513	ED	233	107	0	0	16	91	82	9
PCT7513	TO	806	207	0	0	29	178	159	19
PCT7514	MV	707	110	0	0	10	100	82	18
PCT7514	ED	209	59	0	0	10	49	43	6
PCT7514	TO	916	169	0	0	20	149	125	24
PCT7515	MV	660	83	0	0	1	82	70	12
PCT7515	ED	204	90	0	0	12	78	70	8
PCT7515	TO	864	173	0	0	13	160	140	20
PCT7516	MV	771	175	0	0	12	163	139	24
PCT7516	ED	149	118	0	0	6	112	93	19
PCT7516	TO	920	293	0	0	18	275	232	43
PCT7517	MV	644	128	0	0	6	122	105	17
PCT7517	ED	224	179	0	0	12	167	147	20
PCT7517	TO	868	307	0	0	18	289	252	37
PCT7518	MV	707	105	0	0	7	98	84	14
PCT7518	ED	219	185	0	0	11	174	160	14
PCT7518	TO	926	290	0	0	18	272	244	28
PCT7519	MV	541	66	0	0	6	60	52	8
PCT7519	ED	174	136	0	0	5	131	118	13
PCT7519	TO	715	202	0	0	11	191	170	21
PCT7521	MV	595	100	0	1	5	94	89	5
PCT7521	ED	184	149	0	0	4	145	132	13
PCT7521	TO	779	249	0	1	9	239	221	18
PCT7522	MV	586	88	0	0	5	83	73	10
PCT7522	ED	173	158	0	0	15	143	131	12
PCT7522	TO	759	246	0	0	20	226	204	22
PCT7523	MV	561	79	0	0	10	69	62	7
PCT7523	ED	183	169	0	0	9	160	147	13
PCT7523	TO	744	248	0	0	19	229	209	20
PCT7524	MV	476	75	0	0	9	66	61	5
PCT7524	ED	148	102	0	0	6	96	90	6
PCT7524	TO	624	177	0	0	15	162	151	11
PCT7525	MV	592	74	0	0	6	68	58	10
PCT7525	ED	172	94	0	0	9	85	83	2
PCT7525	TO	764	168	0	0	15	153	141	12
PCT7526	MV	818	134	0	0	13	121	110	11
PCT7526	ED	170	147	0	0	13	134	126	8
PCT7526	TO	988	281	0	0	26	255	236	19
PCT7527	MV	536	93	0	0	3	90	76	14
PCT7527	ED	174	112	0	0	4	108	99	9
PCT7527	TO	710	205	0	0	7	198	175	23
PCT7529	MV	747	103	0	0	6	97	89	8
PCT7529	ED	156	185	0	0	8	177	165	12
PCT7529	TO	903	288	0	0	14	274	254	20
PCT7531	MV	713	80	0	0	6	74	70	4
PCT7531	ED	160	132	0	0	4	128	112	16
PCT7531	TO	873	212	0	0	10	202	182	20
PCT7532	MV	665	100	0	0	4	96	84	12
PCT7532	ED	170	126	0	0	9	117	98	19
PCT7532	TO	835	226	0	0	13	213	182	31
PCT7533	MV	774	117	0	0	8	109	100	9
PCT7533	ED	196	185	0	0	14	171	157	14
PCT7533	TO	970	302	0	0	22	280	257	23
PCT7534	MV	667	104	0	0	5	99	82	17
PCT7534	ED	236	177	0	0	15	162	149	13
PCT7534	TO	903	281	0	0	20	261	231	30
PCT7535	MV	604	91	0	0	6	85	77	8
PCT7535	ED	141	151	0	0	15	136	126	10
PCT7535	TO	745	242	0	0	21	221	203	18
PCT7536	MV	669	91	0	0	2	89	79	10
PCT7536	ED	164	170	0	1	14	155	137	18
PCT7536	TO	833	261	0	1	16	244	216	28
PCT7537	MV	616	78	0	0	8	70	64	6
PCT7537	ED	129	148	0	0	11	137	128	9
PCT7537	TO	745	226	0	0	19	207	192	15
PCT7538	MV	561	100	0	0	8	92	80	12
PCT7538	ED	190	172	0	0	10	162	142	20
PCT7538	TO	751	272	0	0	18	254	222	32
PCT7539	MV	694	92	0	0	6	86	82	4
PCT7539	ED	227	187	0	0	13	174	161	13
PCT7539	TO	921	279	0	0	19	260	243	17
PCT7541	MV	597	82	0	0	6	76	67	9
PCT7541	ED	173	159	0	0	12	147	130	17
PCT7541	TO	770	241	0	0	18	223	197	26
PCT7542	MV	630	86	0	0	3	83	68	15
PCT7542	ED	194	166	0	0	7	159	141	18
PCT7542	TO	824	252	0	0	10	242	209	33
PCT7543	MV	692	108	0	0	5	103	94	9
PCT7543	ED	232	138	0	0	10	128	112	16
PCT7543	TO	924	246	0	0	15	231	206	25
PCT7544	MV	731	128	0	0	11	117	107	10
PCT7544	ED	168	159	0	0	10	149	139	10
PCT7544	TO	899	287	0	0	21	266	246	20
PCT7545	MV	720	134	0	0	8	126	117	9
PCT7545	ED	175	146	0	1	11	134	122	12
PCT7545	TO	895	280	0	1	19	260	239	21
PCT7546	MV	769	105	0	0	8	97	89	8
PCT7546	ED	184	209	0	0	17	192	171	21
PCT7546	TO	953	314	0	0	25	289	260	29
PCT7547	MV	791	131	0	0	10	121	109	12
PCT7547	ED	190	172	0	0	11	161	155	6
PCT7547	TO	981	303	0	0	21	282	264	18
PCT7548	MV	801	150	0	0	5	145	126	19
PCT7548	ED	250	201	0	0	10	191	175	16
PCT7548	TO	1051	351	0	0	15	336	301	35
PCT7549	MV	659	137	0	0	7	130	108	22
PCT7549	ED	147	140	0	0	13	127	116	11
PCT7549	TO	806	277	0	0	20	257	224	33
PCT7551	MV	586	76	0	0	3	73	65	8
PCT7551	ED	137	171	0	0	8	163	147	16
PCT7551	TO	723	247	0	0	11	236	212	24
PCT7552	MV	561	94	0	0	6	88	79	9
PCT7552	ED	124	127	0	0	11	116	99	17
PCT7552	TO	685	221	0	0	17	204	178	26
PCT7553	MV	210	38	0	1	0	37	31	6
PCT7553	ED	-19	0	0	0	0	0	0	0
PCT7553	TO	191	38	0	1	0	37	31	6
PCT7554	MV	653	106	0	0	7	99	83	16
PCT7554	ED	168	177	0	0	15	162	146	16
PCT7554	TO	821	283	0	0	22	261	229	32
PCT7555	MV	662	126	0	0	10	116	99	17
PCT7555	ED	210	210	0	0	18	192	174	18
PCT7555	TO	872	336	0	0	28	308	273	35
PCT7556	MV	813	158	0	0	7	151	128	23
PCT7556	ED	153	165	0	0	10	155	129	26
PCT7556	TO	966	323	0	0	17	306	257	49
PCT7601	MV	484	94	0	0	6	88	82	6
PCT7601	ED	193	89	0	1	10	78	68	10
PCT7601	TO	677	183	0	1	16	166	150	16
PCT7602	MV	653	120	0	0	7	113	104	9
PCT7602	ED	233	103	0	0	9	94	85	9
PCT7602	TO	886	223	0	0	16	207	189	18
PCT7603	MV	610	119	0	0	8	111	94	17
PCT7603	ED	205	167	0	0	12	155	137	18
PCT7603	TO	815	286	0	0	20	266	231	35
PCT7604	MV	684	116	0	0	7	109	95	14
PCT7604	ED	260	133	0	0	14	119	102	17
PCT7604	TO	944	249	0	0	21	228	197	31
PCT7605	MV	466	94	0	1	6	87	73	14
PCT7605	ED	195	62	0	0	6	56	52	4
PCT7605	TO	661	156	0	1	12	143	125	18
PCT7606	MV	671	114	0	0	11	103	91	12
PCT7606	ED	212	79	0	0	6	73	64	9
PCT7606	TO	883	193	0	0	17	176	155	21
PCT7607	MV	707	119	0	0	8	111	93	18
PCT7607	ED	212	100	0	0	4	96	85	11
PCT7607	TO	919	219	0	0	12	207	178	29
PCT7608	MV	279	67	0	0	5	62	50	12
PCT7608	ED	101	19	0	0	0	19	18	1
PCT7608	TO	380	86	0	0	5	81	68	13
PCT7609	MV	698	178	0	0	15	163	145	18
PCT7609	ED	186	49	0	1	5	43	37	6
PCT7609	TO	884	227	0	1	20	206	182	24
PCT7611	MV	586	126	0	0	11	115	101	14
PCT7611	ED	202	43	0	0	2	41	37	4
PCT7611	TO	788	169	0	0	13	156	138	18
PCT7612	MV	452	95	0	0	3	92	77	15
PCT7612	ED	105	29	0	0	1	28	20	8
PCT7612	TO	557	124	0	0	4	120	97	23
PCT7613	MV	629	100	0	0	6	94	84	10
PCT7613	ED	254	86	0	0	5	81	74	7
PCT7613	TO	883	186	0	0	11	175	158	17
PCT7614	MV	708	109	0	0	10	99	86	13
PCT7614	ED	208	78	0	0	4	74	58	16
PCT7614	TO	916	187	0	0	14	173	144	29
PCT7615	MV	510	75	0	0	3	72	57	15
PCT7615	ED	240	58	0	0	4	54	46	8
PCT7615	TO	750	133	0	0	7	126	103	23
PCT7616	MV	750	77	0	0	6	71	63	8
PCT7616	ED	86	86	0	0	7	79	73	6
PCT7616	TO	836	163	0	0	13	150	136	14
PCT7617	MV	583	113	0	0	14	99	88	11
PCT7617	ED	169	42	0	0	7	35	28	7
PCT7617	TO	752	155	0	0	21	134	116	18
PCT7618	MV	762	133	0	0	6	127	101	26
PCT7618	ED	152	84	0	0	9	75	65	10
PCT7618	TO	914	217	0	0	15	202	166	36
PCT7619	MV	932	158	0	0	10	148	120	28
PCT7619	ED	175	117	0	0	9	108	96	12
PCT7619	TO	1107	275	0	0	19	256	216	40
PCT7621	MV	1000	177	0	0	14	163	138	25
PCT7621	ED	155	103	0	0	10	93	79	14
PCT7621	TO	1155	280	0	0	24	256	217	39
PCT7622	MV	695	100	0	0	3	97	93	4
PCT7622	ED	265	73	0	0	9	64	60	4
PCT7622	TO	960	173	0	0	12	161	153	8
PCT7623	MV	762	99	0	1	7	91	84	7
PCT7623	ED	242	98	0	0	9	89	81	8
PCT7623	TO	1004	197	0	1	16	180	165	15
PCT7624	MV	649	118	0	0	4	114	99	15
PCT7624	ED	226	72	0	0	11	61	60	1
PCT7624	TO	875	190	0	0	15	175	159	16
PCT7625	MV	747	265	0	0	28	237	199	38
PCT7625	ED	75	34	0	0	1	33	32	1
PCT7625	TO	822	299	0	0	29	270	231	39
PCT7626	MV	944	158	0	0	13	145	124	21
PCT7626	ED	129	105	0	0	4	101	94	7
PCT7626	TO	1073	263	0	0	17	246	218	28
PCT7627	MV	456	81	0	0	6	75	57	18
PCT7627	ED	68	57	0	0	6	51	42	9
PCT7627	TO	524	138	0	0	12	126	99	27
PCT7628	MV	716	116	0	0	5	111	99	12
PCT7628	ED	222	110	0	0	2	108	95	13
PCT7628	TO	938	226	0	0	7	219	194	25
PCT7629	MV	685	100	0	0	11	89	81	8
PCT7629	ED	168	86	0	0	5	81	72	9
PCT7629	TO	853	186	0	0	16	170	153	17
PCT7631	MV	1007	164	0	0	7	157	132	25
PCT7631	ED	212	110	0	0	8	102	89	13
PCT7631	TO	1219	274	0	0	15	259	221	38
PCT7632	MV	995	154	0	0	7	147	122	25
PCT7632	ED	176	128	0	0	8	120	107	13
PCT7632	TO	1171	282	0	0	15	267	229	38
PCT7633	MV	608	134	0	0	12	122	102	20
PCT7633	ED	127	96	0	0	6	90	83	7
PCT7633	TO	735	230	0	0	18	212	185	27
PCT7634	MV	704	162	0	0	12	150	127	23
PCT7634	ED	186	101	0	0	9	92	81	11
PCT7634	TO	890	263	0	0	21	242	208	34
PCT7635	MV	662	103	0	0	4	99	78	21
PCT7635	ED	191	62	0	0	4	58	49	9
PCT7635	TO	853	165	0	0	8	157	127	30
PCT7636	MV	797	130	0	0	8	122	98	24
PCT7636	ED	162	107	0	0	7	100	81	19
PCT7636	TO	959	237	0	0	15	222	179	43
PCT7637	MV	746	143	0	0	12	131	94	37
PCT7637	ED	122	98	0	0	10	88	76	12
PCT7637	TO	868	241	0	0	22	219	170	49
PCT7638	MV	806	156	0	0	6	150	114	36
PCT7638	ED	83	87	0	0	8	79	55	24
PCT7638	TO	889	243	0	0	14	229	169	60
PCT7639	MV	888	138	0	0	11	127	94	33
PCT7639	ED	134	132	0	0	23	109	92	17
PCT7639	TO	1022	270	0	0	34	236	186	50
PCT7641	MV	817	182	0	0	13	169	126	43
PCT7641	ED	134	92	0	0	4	88	75	13
PCT7641	TO	951	274	0	0	17	257	201	56
PCT7642	MV	646	92	0	0	5	87	74	13
PCT7642	ED	119	79	0	0	15	64	58	6
PCT7642	TO	765	171	0	0	20	151	132	19
PCT7643	MV	808	177	0	0	9	168	136	32
PCT7643	ED	133	105	0	0	10	95	84	11
PCT7643	TO	941	282	0	0	19	263	220	43
PCT7644	MV	1013	141	0	0	10	131	108	23
PCT7644	ED	163	142	0	0	10	132	120	12
PCT7644	TO	1176	283	0	0	20	263	228	35
PCT7645	MV	595	127	0	1	7	119	91	28
PCT7645	ED	61	56	0	0	6	50	43	7
PCT7645	TO	656	183	0	1	13	169	134	35
PCT7646	MV	1029	157	0	0	14	143	108	35
PCT7646	ED	124	133	0	0	16	117	105	12
PCT7646	TO	1153	290	0	0	30	260	213	47
PCT7647	MV	721	85	0	0	4	81	66	15
PCT7647	ED	266	79	0	0	5	74	69	5
PCT7647	TO	987	164	0	0	9	155	135	20
PCT7648	MV	2	0	0	0	0	0	0	0
PCT7648	ED	0	0	0	0	0	0	0	0
PCT7648	TO	2	0	0	0	0	0	0	0
PCT7649	MV	714	127	0	0	5	122	103	19
PCT7649	ED	186	78	0	0	5	73	60	13
PCT7649	TO	900	205	0	0	10	195	163	32
PCT7651	MV	833	124	0	0	6	118	101	17
PCT7651	ED	114	72	0	0	5	67	57	10
PCT7651	TO	947	196	0	0	11	185	158	27
PCT7652	MV	530	77	0	0	4	73	57	16
PCT7652	ED	105	86	0	0	5	81	73	8
PCT7652	TO	635	163	0	0	9	154	130	24
PCT7653	MV	749	107	0	0	16	91	87	4
PCT7653	ED	90	79	0	0	7	72	60	12
PCT7653	TO	839	186	0	0	23	163	147	16
PCT7654	MV	407	66	0	0	6	60	49	11
PCT7654	ED	59	83	0	0	7	76	70	6
PCT7654	TO	466	149	0	0	13	136	119	17
PCT7655	MV	578	92	0	0	4	88	73	15
PCT7655	ED	101	59	0	0	9	50	44	6
PCT7655	TO	679	151	0	0	13	138	117	21
PCT7656	MV	603	130	0	0	8	122	102	20
PCT7656	ED	35	40	0	0	3	37	24	13
PCT7656	TO	638	170	0	0	11	159	126	33
PCT7657	MV	559	75	0	0	4	71	54	17
PCT7657	ED	39	61	0	0	5	56	49	7
PCT7657	TO	598	136	0	0	9	127	103	24
PCT7701	MV	868	190	0	0	17	173	137	36
PCT7701	ED	196	173	0	0	8	165	147	18
PCT7701	TO	1064	363	0	0	25	338	284	54
PCT7702	MV	623	125	0	0	5	120	84	36
PCT7702	ED	133	103	0	0	9	94	74	20
PCT7702	TO	756	228	0	0	14	214	158	56
PCT7703	MV	187	42	0	0	0	42	39	3
PCT7703	ED	-13	0	0	0	0	0	0	0
PCT7703	TO	174	42	0	0	0	42	39	3
PCT7704	MV	798	186	0	0	11	175	114	61
PCT7704	ED	204	173	0	0	2	171	125	46
PCT7704	TO	1002	359	0	0	13	346	239	107
PCT7705	MV	467	119	0	0	5	114	82	32
PCT7705	ED	128	110	0	0	9	101	80	21
PCT7705	TO	595	229	0	0	14	215	162	53
PCT7706	MV	686	177	0	0	8	169	135	34
PCT7706	ED	180	162	0	0	8	154	120	34
PCT7706	TO	866	339	0	0	16	323	255	68
PCT7707	MV	683	148	0	0	7	141	104	37
PCT7707	ED	189	179	0	0	7	172	128	44
PCT7707	TO	872	327	0	0	14	313	232	81
PCT7708	MV	710	182	0	0	11	171	123	48
PCT7708	ED	165	152	0	0	13	139	115	24
PCT7708	TO	875	334	0	0	24	310	238	72
PCT7709	MV	322	67	0	0	3	64	53	11
PCT7709	ED	84	90	0	0	7	83	71	12
PCT7709	TO	406	157	0	0	10	147	124	23
PCT7711	MV	657	127	0	0	7	120	83	37
PCT7711	ED	154	125	0	0	4	121	106	15
PCT7711	TO	811	252	0	0	11	241	189	52
PCT7712	MV	423	81	0	0	3	78	61	17
PCT7712	ED	109	106	0	0	7	99	82	17
PCT7712	TO	532	187	0	0	10	177	143	34
PCT7801	MV	821	162	0	0	6	156	117	39
PCT7801	ED	153	190	0	0	11	179	140	39
PCT7801	TO	974	352	0	0	17	335	257	78
PCT7802	MV	646	154	0	0	13	141	121	20
PCT7802	ED	152	157	0	1	6	150	137	13
PCT7802	TO	798	311	0	1	19	291	258	33
PCT7803	MV	717	166	0	0	5	161	128	33
PCT7803	ED	114	128	0	0	10	118	100	18
PCT7803	TO	831	294	0	0	15	279	228	51
PCT7804	MV	729	148	0	0	10	138	125	13
PCT7804	ED	156	180	0	0	17	163	147	16
PCT7804	TO	885	328	0	0	27	301	272	29
PCT7805	MV	641	142	0	0	14	128	108	20
PCT7805	ED	159	155	0	0	11	144	133	11
PCT7805	TO	800	297	0	0	25	272	241	31
PCT7806	MV	601	99	0	0	6	93	82	11
PCT7806	ED	154	152	0	0	11	141	122	19
PCT7806	TO	755	251	0	0	17	234	204	30
PCT7807	MV	642	137	0	0	3	134	125	9
PCT7807	ED	185	174	0	0	12	162	151	11
PCT7807	TO	827	311	0	0	15	296	276	20
PCT7808	MV	525	91	0	0	3	88	72	16
PCT7808	ED	129	129	0	0	12	117	106	11
PCT7808	TO	654	220	0	0	15	205	178	27
PCT7809	MV	624	132	0	0	11	121	112	9
PCT7809	ED	140	135	0	0	13	122	118	4
PCT7809	TO	764	267	0	0	24	243	230	13
PCT7811	MV	575	94	0	0	10	84	77	7
PCT7811	ED	183	155	0	0	10	145	130	15
PCT7811	TO	758	249	0	0	20	229	207	22
PCT7812	MV	680	146	0	0	12	134	116	18
PCT7812	ED	217	163	0	0	5	158	137	21
PCT7812	TO	897	309	0	0	17	292	253	39
PCT7813	MV	836	171	0	0	11	160	139	21
PCT7813	ED	232	214	0	0	16	198	175	23
PCT7813	TO	1068	385	0	0	27	358	314	44
PCT7814	MV	660	99	0	0	4	95	80	15
PCT7814	ED	241	118	0	0	8	110	102	8
PCT7814	TO	901	217	0	0	12	205	182	23
PCT7815	MV	749	167	0	0	17	150	127	23
PCT7815	ED	168	176	0	0	9	167	153	14
PCT7815	TO	917	343	0	0	26	317	280	37
PCT7816	MV	721	164	0	0	19	145	125	20
PCT7816	ED	151	149	0	0	6	143	121	22
PCT7816	TO	872	313	0	0	25	288	246	42
PCT7817	MV	648	149	0	0	4	145	129	16
PCT7817	ED	190	182	0	1	7	174	154	20
PCT7817	TO	838	331	0	1	11	319	283	36
PCT7818	MV	667	126	0	0	7	119	103	16
PCT7818	ED	172	149	0	0	7	142	133	9
PCT7818	TO	839	275	0	0	14	261	236	25
PCT7819	MV	632	120	0	0	7	113	95	18
PCT7819	ED	142	89	0	0	5	84	79	5
PCT7819	TO	774	209	0	0	12	197	174	23
PCT7821	MV	806	155	0	0	9	146	125	21
PCT7821	ED	170	189	0	0	10	179	161	18
PCT7821	TO	976	344	0	0	19	325	286	39
PCT7822	MV	673	140	0	1	9	130	113	17
PCT7822	ED	219	222	0	0	21	201	166	35
PCT7822	TO	892	362	0	1	30	331	279	52
PCT7823	MV	703	159	0	0	7	152	131	21
PCT7823	ED	180	188	0	0	4	184	167	17
PCT7823	TO	883	347	0	0	11	336	298	38
PCT7824	MV	613	104	0	0	4	100	82	18
PCT7824	ED	155	158	0	0	13	145	133	12
PCT7824	TO	768	262	0	0	17	245	215	30
PCT7825	MV	457	82	0	0	4	78	75	3
PCT7825	ED	151	130	0	0	3	127	111	16
PCT7825	TO	608	212	0	0	7	205	186	19
PCT7826	MV	485	82	0	0	6	76	69	7
PCT7826	ED	205	162	0	0	11	151	139	12
PCT7826	TO	690	244	0	0	17	227	208	19
PCT7827	MV	601	80	0	0	6	74	63	11
PCT7827	ED	225	145	0	0	12	133	123	10
PCT7827	TO	826	225	0	0	18	207	186	21
PCT7828	MV	855	178	0	0	13	165	130	35
PCT7828	ED	173	177	0	0	17	160	137	23
PCT7828	TO	1028	355	0	0	30	325	267	58
PCT7829	MV	740	151	0	0	5	146	121	25
PCT7829	ED	151	151	0	0	4	147	132	15
PCT7829	TO	891	302	0	0	9	293	253	40
PCT7831	MV	762	174	0	0	13	161	135	26
PCT7831	ED	140	137	0	0	7	130	111	19
PCT7831	TO	902	311	0	0	20	291	246	45
PCT7832	MV	662	154	0	0	10	144	123	21
PCT7832	ED	119	127	0	0	7	120	106	14
PCT7832	TO	781	281	0	0	17	264	229	35
PCT7833	MV	585	102	0	0	4	98	83	15
PCT7833	ED	148	145	0	0	15	130	116	14
PCT7833	TO	733	247	0	0	19	228	199	29
PCT7834	MV	696	109	0	0	8	101	93	8
PCT7834	ED	198	175	0	0	12	163	148	15
PCT7834	TO	894	284	0	0	20	264	241	23
PCT7835	MV	720	158	0	0	8	150	126	24
PCT7835	ED	143	147	0	0	10	137	117	20
PCT7835	TO	863	305	0	0	18	287	243	44
PCT7836	MV	849	209	0	0	9	200	161	39
PCT7836	ED	194	169	0	0	6	163	133	30
PCT7836	TO	1043	378	0	0	15	363	294	69
PCT7837	MV	717	140	0	0	13	127	103	24
PCT7837	ED	206	198	0	0	7	191	168	23
PCT7837	TO	923	338	0	0	20	318	271	47
PCT7838	MV	752	174	0	0	11	163	129	34
PCT7838	ED	143	155	0	0	9	146	126	20
PCT7838	TO	895	329	0	0	20	309	255	54
PCT7839	MV	731	156	0	0	9	147	117	30
PCT7839	ED	130	136	0	0	8	128	113	15
PCT7839	TO	861	292	0	0	17	275	230	45
PCT7841	MV	752	138	0	0	7	131	110	21
PCT7841	ED	198	207	0	0	9	198	176	22
PCT7841	TO	950	345	0	0	16	329	286	43
PCT7842	MV	701	114	0	0	5	109	99	10
PCT7842	ED	178	154	0	0	9	145	130	15
PCT7842	TO	879	268	0	0	14	254	229	25
PCT7843	MV	545	88	0	0	3	85	70	15
PCT7843	ED	184	163	0	0	11	152	135	17
PCT7843	TO	729	251	0	0	14	237	205	32
PCT7844	MV	499	84	0	0	6	78	71	7
PCT7844	ED	152	136	0	0	11	125	111	14
PCT7844	TO	651	220	0	0	17	203	182	21
PCT7845	MV	675	129	0	0	3	126	110	16
PCT7845	ED	205	177	0	0	10	167	140	27
PCT7845	TO	880	306	0	0	13	293	250	43
PCT7846	MV	735	147	0	0	9	138	111	27
PCT7846	ED	173	166	0	0	12	154	130	24
PCT7846	TO	908	313	0	0	21	292	241	51
PCT7847	MV	698	142	0	0	6	136	112	24
PCT7847	ED	193	181	0	0	7	174	146	28
PCT7847	TO	891	323	0	0	13	310	258	52
PCT7848	MV	663	131	0	0	2	129	106	23
PCT7848	ED	184	168	0	0	17	151	129	22
PCT7848	TO	847	299	0	0	19	280	235	45
PCT7849	MV	729	141	0	0	11	130	113	17
PCT7849	ED	172	186	0	0	12	174	158	16
PCT7849	TO	901	327	0	0	23	304	271	33
PCT7851	MV	413	113	0	0	8	105	74	31
PCT7851	ED	113	84	0	0	7	77	57	20
PCT7851	TO	526	197	0	0	15	182	131	51
PCT7852	MV	532	139	0	0	10	129	106	23
PCT7852	ED	112	103	0	0	7	96	80	16
PCT7852	TO	644	242	0	0	17	225	186	39
PCT7853	MV	694	136	0	0	9	127	111	16
PCT7853	ED	161	137	0	0	9	128	108	20
PCT7853	TO	855	273	0	0	18	255	219	36
PCT7854	MV	703	138	0	0	10	128	105	23
PCT7854	ED	175	172	0	0	10	162	142	20
PCT7854	TO	878	310	0	0	20	290	247	43
PCT7855	MV	760	150	0	0	13	137	113	24
PCT7855	ED	214	202	0	0	16	186	167	19
PCT7855	TO	974	352	0	0	29	323	280	43
PCT7856	MV	643	106	0	0	5	101	84	17
PCT7856	ED	204	193	0	0	12	181	156	25
PCT7856	TO	847	299	0	0	17	282	240	42
PCT7857	MV	745	144	0	0	12	132	109	23
PCT7857	ED	161	153	0	0	8	145	135	10
PCT7857	TO	906	297	0	0	20	277	244	33
PCT7858	MV	618	120	0	0	9	111	100	11
PCT7858	ED	161	147	0	0	8	139	121	18
PCT7858	TO	779	267	0	0	17	250	221	29
PCT7859	MV	747	152	0	0	6	146	121	25
PCT7859	ED	152	165	0	0	18	147	118	29
PCT7859	TO	899	317	0	0	24	293	239	54
PCT7861	MV	699	144	0	0	7	137	108	29
PCT7861	ED	164	171	0	0	8	163	143	20
PCT7861	TO	863	315	0	0	15	300	251	49
PCT7862	MV	669	143	0	0	10	133	113	20
PCT7862	ED	195	197	0	0	10	187	170	17
PCT7862	TO	864	340	0	0	20	320	283	37
PCT7863	MV	690	102	0	0	4	98	79	19
PCT7863	ED	211	205	0	0	11	194	165	29
PCT7863	TO	901	307	0	0	15	292	244	48
PCT7864	MV	660	115	0	0	8	107	85	22
PCT7864	ED	154	157	0	0	13	144	120	24
PCT7864	TO	814	272	0	0	21	251	205	46
PCT7865	MV	677	132	0	0	7	125	102	23
PCT7865	ED	163	157	0	0	9	148	121	27
PCT7865	TO	840	289	0	0	16	273	223	50
PCT7866	MV	689	173	0	0	6	167	120	47
PCT7866	ED	159	141	0	0	8	133	103	30
PCT7866	TO	848	314	0	0	14	300	223	77
PCT7867	MV	763	179	0	0	11	168	142	26
PCT7867	ED	215	182	0	0	11	171	145	26
PCT7867	TO	978	361	0	0	22	339	287	52
PCT7868	MV	657	157	0	0	5	152	132	20
PCT7868	ED	219	161	0	0	11	150	128	22
PCT7868	TO	876	318	0	0	16	302	260	42
PCT7869	MV	682	157	0	0	9	148	123	25
PCT7869	ED	179	189	0	0	11	178	160	18
PCT7869	TO	861	346	0	0	20	326	283	43
PCT7871	MV	701	153	0	0	7	146	120	26
PCT7871	ED	201	157	0	1	10	146	117	29
PCT7871	TO	902	310	0	1	17	292	237	55
PCT7872	MV	675	149	0	0	7	142	114	28
PCT7872	ED	199	185	0	0	8	177	149	28
PCT7872	TO	874	334	0	0	15	319	263	56
PCT7873	MV	687	135	0	0	6	129	112	17
PCT7873	ED	204	212	0	0	15	197	172	25
PCT7873	TO	891	347	0	0	21	326	284	42
PCT7874	MV	370	58	0	0	5	53	44	9
PCT7874	ED	119	107	0	0	5	102	85	17
PCT7874	TO	489	165	0	0	10	155	129	26
PCT7875	MV	500	83	0	0	4	79	63	16
PCT7875	ED	147	114	0	0	5	109	93	16
PCT7875	TO	647	197	0	0	9	188	156	32
PCT7876	MV	462	93	0	0	8	85	73	12
PCT7876	ED	106	91	0	0	10	81	75	6
PCT7876	TO	568	184	0	0	18	166	148	18
PCT7901	MV	399	81	0	0	3	78	69	9
PCT7901	ED	150	65	0	0	2	63	56	7
PCT7901	TO	549	146	0	0	5	141	125	16
PCT7902	MV	678	102	0	0	8	94	77	17
PCT7902	ED	234	139	0	0	7	132	120	12
PCT7902	TO	912	241	0	0	15	226	197	29
PCT7903	MV	620	107	0	0	11	96	90	6
PCT7903	ED	232	123	0	0	9	114	106	8
PCT7903	TO	852	230	0	0	20	210	196	14
PCT7904	MV	675	104	0	0	5	99	89	10
PCT7904	ED	162	115	0	0	8	107	96	11
PCT7904	TO	837	219	0	0	13	206	185	21
PCT7905	MV	683	145	0	0	8	137	119	18
PCT7905	ED	192	183	0	0	8	175	162	13
PCT7905	TO	875	328	0	0	16	312	281	31
PCT7906	MV	596	79	0	0	2	77	64	13
PCT7906	ED	190	115	0	0	12	103	95	8
PCT7906	TO	786	194	0	0	14	180	159	21
PCT7907	MV	702	112	0	0	6	106	89	17
PCT7907	ED	240	163	0	0	15	148	131	17
PCT7907	TO	942	275	0	0	21	254	220	34
PCT7908	MV	748	142	0	0	8	134	124	10
PCT7908	ED	244	169	0	0	14	155	150	5
PCT7908	TO	992	311	0	0	22	289	274	15
PCT7909	MV	558	89	0	0	7	82	69	13
PCT7909	ED	185	140	0	0	5	135	127	8
PCT7909	TO	743	229	0	0	12	217	196	21
PCT7911	MV	666	107	0	0	6	101	82	19
PCT7911	ED	205	129	0	0	6	123	109	14
PCT7911	TO	871	236	0	0	12	224	191	33
PCT7912	MV	799	118	0	0	10	108	102	6
PCT7912	ED	260	176	0	0	18	158	150	8
PCT7912	TO	1059	294	0	0	28	266	252	14
PCT7913	MV	658	123	0	0	4	119	99	20
PCT7913	ED	265	212	0	0	6	206	185	21
PCT7913	TO	923	335	0	0	10	325	284	41
PCT7914	MV	715	106	0	0	6	100	82	18
PCT7914	ED	187	140	0	0	12	128	109	19
PCT7914	TO	902	246	0	0	18	228	191	37
PCT7915	MV	604	87	0	0	6	81	74	7
PCT7915	ED	239	181	0	0	3	178	161	17
PCT7915	TO	843	268	0	0	9	259	235	24
PCT7916	MV	637	100	0	0	3	97	83	14
PCT7916	ED	221	160	0	0	10	150	142	8
PCT7916	TO	858	260	0	0	13	247	225	22
PCT7917	MV	714	112	0	0	5	107	90	17
PCT7917	ED	273	187	0	0	6	181	170	11
PCT7917	TO	987	299	0	0	11	288	260	28
PCT7918	MV	594	79	0	0	1	78	74	4
PCT7918	ED	230	143	0	0	6	137	123	14
PCT7918	TO	824	222	0	0	7	215	197	18
PCT7919	MV	608	102	0	0	3	99	83	16
PCT7919	ED	258	175	0	0	8	167	157	10
PCT7919	TO	866	277	0	0	11	266	240	26
PCT7921	MV	679	113	0	0	6	107	96	11
PCT7921	ED	232	101	0	0	6	95	84	11
PCT7921	TO	911	214	0	0	12	202	180	22
PCT7922	MV	644	114	0	0	4	110	93	17
PCT7922	ED	214	155	0	0	10	145	133	12
PCT7922	TO	858	269	0	0	14	255	226	29
PCT7923	MV	665	108	0	0	6	102	79	23
PCT7923	ED	215	170	0	0	10	160	142	18
PCT7923	TO	880	278	0	0	16	262	221	41
PCT7924	MV	648	93	0	0	2	91	68	23
PCT7924	ED	203	124	0	0	8	116	104	12
PCT7924	TO	851	217	0	0	10	207	172	35
PCT7925	MV	434	81	0	0	4	77	65	12
PCT7925	ED	110	89	0	0	6	83	75	8
PCT7925	TO	544	170	0	0	10	160	140	20
PCT7926	MV	610	97	0	0	9	88	75	13
PCT7926	ED	178	150	0	0	6	144	123	21
PCT7926	TO	788	247	0	0	15	232	198	34
PCT7927	MV	579	106	0	0	9	97	82	15
PCT7927	ED	163	152	0	0	5	147	131	16
PCT7927	TO	742	258	0	0	14	244	213	31
PCT7928	MV	700	130	0	0	7	123	109	14
PCT7928	ED	217	208	0	0	7	201	181	20
PCT7928	TO	917	338	0	0	14	324	290	34
PCT7929	MV	678	128	0	0	10	118	98	20
PCT7929	ED	169	170	0	0	6	164	147	17
PCT7929	TO	847	298	0	0	16	282	245	37
PCT7931	MV	609	114	0	0	4	110	95	15
PCT7931	ED	142	149	0	0	7	142	125	17
PCT7931	TO	751	263	0	0	11	252	220	32
PCT7932	MV	442	98	0	0	5	93	66	27
PCT7932	ED	119	95	0	0	8	87	76	11
PCT7932	TO	561	193	0	0	13	180	142	38
PCT7933	MV	9	2	0	0	0	2	2	0
PCT7933	ED	-1	0	0	0	0	0	0	0
PCT7933	TO	8	2	0	0	0	2	2	0
PCT7934	MV	701	140	0	0	12	128	115	13
PCT7934	ED	183	154	0	0	17	137	124	13
PCT7934	TO	884	294	0	0	29	265	239	26
PCT7935	MV	715	138	0	0	7	131	116	15
PCT7935	ED	228	225	0	0	13	212	195	17
PCT7935	TO	943	363	0	0	20	343	311	32
PCT7936	MV	619	119	0	0	8	111	100	11
PCT7936	ED	237	220	0	1	10	209	187	22
PCT7936	TO	856	339	0	1	18	320	287	33
PCT7937	MV	697	143	0	0	6	137	123	14
PCT7937	ED	203	171	0	0	7	164	145	19
PCT7937	TO	900	314	0	0	13	301	268	33
PCT7938	MV	536	105	0	0	5	100	84	16
PCT7938	ED	215	120	0	0	7	113	98	15
PCT7938	TO	751	225	0	0	12	213	182	31
PCT7939	MV	480	76	0	0	5	71	55	16
PCT7939	ED	206	191	0	0	11	180	163	17
PCT7939	TO	686	267	0	0	16	251	218	33
PCT7941	MV	574	92	0	0	12	80	70	10
PCT7941	ED	198	170	0	0	9	161	139	22
PCT7941	TO	772	262	0	0	21	241	209	32
PCT7942	MV	658	134	0	0	4	130	110	20
PCT7942	ED	274	141	0	0	4	137	121	16
PCT7942	TO	932	275	0	0	8	267	231	36
PCT7943	MV	686	128	0	0	4	124	103	21
PCT7943	ED	214	156	0	0	12	144	117	27
PCT7943	TO	900	284	0	0	16	268	220	48
PCT7944	MV	583	104	0	0	7	97	83	14
PCT7944	ED	231	196	0	0	12	184	155	29
PCT7944	TO	814	300	0	0	19	281	238	43
PCT7945	MV	725	116	0	0	7	109	91	18
PCT7945	ED	229	82	0	0	7	75	68	7
PCT7945	TO	954	198	0	0	14	184	159	25
PCT7946	MV	779	161	0	0	10	151	94	57
PCT7946	ED	206	114	0	0	7	107	83	24
PCT7946	TO	985	275	0	0	17	258	177	81
PCT7947	MV	791	160	0	0	11	149	99	50
PCT7947	ED	195	93	0	0	4	89	66	23
PCT7947	TO	986	253	0	0	15	238	165	73
PCT7948	MV	730	151	0	0	12	139	99	40
PCT7948	ED	200	119	0	0	4	115	89	26
PCT7948	TO	930	270	0	0	16	254	188	66
PCT7949	MV	483	107	0	0	4	103	60	43
PCT7949	ED	107	56	0	0	6	50	35	15
PCT7949	TO	590	163	0	0	10	153	95	58
PCT7951	MV	729	149	0	0	7	142	82	60
PCT7951	ED	158	90	0	0	4	86	66	20
PCT7951	TO	887	239	0	0	11	228	148	80
PCT7952	MV	730	105	0	0	6	99	55	44
PCT7952	ED	182	86	0	0	7	79	57	22
PCT7952	TO	912	191	0	0	13	178	112	66
PCT7953	MV	668	136	0	0	5	131	85	46
PCT7953	ED	162	106	0	0	4	102	65	37
PCT7953	TO	830	242	0	0	9	233	150	83
PCT7954	MV	0	0	0	0	0	0	0	0
PCT7954	ED	0	0	0	0	0	0	0	0
PCT7954	TO	0	0	0	0	0	0	0	0
PCT7955	MV	774	120	0	0	3	117	76	41
PCT7955	ED	173	97	0	0	11	86	61	25
PCT7955	TO	947	217	0	0	14	203	137	66
PCT7956	MV	699	102	0	0	1	101	65	36
PCT7956	ED	170	39	0	0	2	37	31	6
PCT7956	TO	869	141	0	0	3	138	96	42
PCT7957	MV	537	101	0	0	7	94	72	22
PCT7957	ED	136	83	0	0	5	78	66	12
PCT7957	TO	673	184	0	0	12	172	138	34
PCT7958	MV	320	36	0	0	3	33	25	8
PCT7958	ED	-23	0	0	0	0	0	0	0
PCT7958	TO	297	36	0	0	3	33	25	8
PCT7959	MV	537	86	0	0	5	81	71	10
PCT7959	ED	149	65	0	0	6	59	54	5
PCT7959	TO	686	151	0	0	11	140	125	15
PCT9001	MV	313	39	0	0	0	39	34	5
PCT9001	ED	-29	0	0	0	0	0	0	0
PCT9001	TO	284	39	0	0	0	39	34	5
PCT9101	MV	711	162	0	0	8	154	110	44
PCT9101	ED	202	150	0	0	4	146	123	23
PCT9101	TO	913	312	0	0	12	300	233	67
PCT9102	MV	785	134	0	0	4	130	99	31
PCT9102	ED	207	126	0	0	3	123	102	21
PCT9102	TO	992	260	0	0	7	253	201	52
PCT9103	MV	717	147	0	0	11	136	107	29
PCT9103	ED	240	153	0	0	12	141	105	36
PCT9103	TO	957	300	0	0	23	277	212	65
PCT9104	MV	808	143	0	0	11	132	108	24
PCT9104	ED	222	152	0	0	7	145	121	24
PCT9104	TO	1030	295	0	0	18	277	229	48
PCT9105	MV	719	152	0	0	8	144	109	35
PCT9105	ED	199	173	0	0	12	161	129	32
PCT9105	TO	918	325	0	0	20	305	238	67
PCT9106	MV	745	149	0	0	11	138	101	37
PCT9106	ED	201	178	0	0	12	166	150	16
PCT9106	TO	946	327	0	0	23	304	251	53
PCT9107	MV	635	124	0	0	7	117	94	23
PCT9107	ED	209	118	0	0	9	109	99	10
PCT9107	TO	844	242	0	0	16	226	193	33
PCT9108	MV	610	104	0	0	13	91	76	15
PCT9108	ED	200	136	0	0	8	128	114	14
PCT9108	TO	810	240	0	0	21	219	190	29
PCT9109	MV	672	103	0	0	8	95	76	19
PCT9109	ED	211	162	0	0	5	157	128	29
PCT9109	TO	883	265	0	0	13	252	204	48
PCT9111	MV	638	123	0	0	14	109	88	21
PCT9111	ED	196	134	0	0	10	124	106	18
PCT9111	TO	834	257	0	0	24	233	194	39
PCT9112	MV	742	129	0	0	6	123	99	24
PCT9112	ED	219	160	0	0	11	149	131	18
PCT9112	TO	961	289	0	0	17	272	230	42
PCT9113	MV	795	126	0	0	7	119	86	33
PCT9113	ED	209	180	0	0	14	166	131	35
PCT9113	TO	1004	306	0	0	21	285	217	68
PCT9114	MV	657	107	0	0	6	101	80	21
PCT9114	ED	233	147	0	0	11	136	122	14
PCT9114	TO	890	254	0	0	17	237	202	35
PCT9115	MV	697	122	0	0	10	112	92	20
PCT9115	ED	184	155	0	0	15	140	120	20
PCT9115	TO	881	277	0	0	25	252	212	40
PCT9116	MV	781	129	0	0	6	123	92	31
PCT9116	ED	180	148	0	0	11	137	112	25
PCT9116	TO	961	277	0	0	17	260	204	56
PCT9117	MV	628	139	0	0	7	132	96	36
PCT9117	ED	172	158	0	0	7	151	120	31
PCT9117	TO	800	297	0	0	14	283	216	67
PCT9118	MV	738	105	0	0	6	99	67	32
PCT9118	ED	246	165	0	0	12	153	126	27
PCT9118	TO	984	270	0	0	18	252	193	59
PCT9119	MV	703	152	0	0	11	141	102	39
PCT9119	ED	197	120	0	0	15	105	90	15
PCT9119	TO	900	272	0	0	26	246	192	54
PCT9121	MV	733	114	0	0	4	110	80	30
PCT9121	ED	220	141	0	0	8	133	101	32
PCT9121	TO	953	255	0	0	12	243	181	62
PCT9122	MV	773	143	0	0	10	133	88	45
PCT9122	ED	194	122	0	0	12	110	90	20
PCT9122	TO	967	265	0	0	22	243	178	65
PCT9123	MV	661	121	0	0	7	114	78	36
PCT9123	ED	191	139	0	0	9	130	114	16
PCT9123	TO	852	260	0	0	16	244	192	52
PCT9124	MV	734	131	0	0	4	127	91	36
PCT9124	ED	169	118	0	0	6	112	89	23
PCT9124	TO	903	249	0	0	10	239	180	59
PCT9125	MV	680	132	0	0	4	128	99	29
PCT9125	ED	189	124	0	0	8	116	104	12
PCT9125	TO	869	256	0	0	12	244	203	41
PCT9126	MV	817	172	0	0	7	165	112	53
PCT9126	ED	196	152	0	0	7	145	119	26
PCT9126	TO	1013	324	0	0	14	310	231	79
PCT9127	MV	748	141	0	0	6	135	108	27
PCT9127	ED	223	184	0	0	9	175	147	28
PCT9127	TO	971	325	0	0	15	310	255	55
PCT9128	MV	626	93	0	0	6	87	72	15
PCT9128	ED	192	166	0	0	14	152	129	23
PCT9128	TO	818	259	0	0	20	239	201	38
PCT9129	MV	586	107	0	0	5	102	75	27
PCT9129	ED	152	129	0	0	8	121	107	14
PCT9129	TO	738	236	0	0	13	223	182	41
PCT9131	MV	596	119	0	0	4	115	81	34
PCT9131	ED	138	111	0	0	6	105	86	19
PCT9131	TO	734	230	0	0	10	220	167	53
PCT9132	MV	628	85	0	0	4	81	77	4
PCT9132	ED	193	130	0	0	7	123	106	17
PCT9132	TO	821	215	0	0	11	204	183	21
PCT9133	MV	806	172	0	0	11	161	137	24
PCT9133	ED	211	157	0	0	11	146	122	24
PCT9133	TO	1017	329	0	0	22	307	259	48
PCT9134	MV	734	121	0	0	5	116	65	51
PCT9134	ED	157	102	0	0	9	93	75	18
PCT9134	TO	891	223	0	0	14	209	140	69
PCT9135	MV	639	134	0	0	8	126	98	28
PCT9135	ED	183	125	0	0	6	119	88	31
PCT9135	TO	822	259	0	0	14	245	186	59
PCT9136	MV	706	124	0	0	4	120	81	39
PCT9136	ED	212	139	0	0	14	125	103	22
PCT9136	TO	918	263	0	0	18	245	184	61
PCT9137	MV	804	153	0	0	14	139	104	35
PCT9137	ED	211	133	0	0	5	128	108	20
PCT9137	TO	1015	286	0	0	19	267	212	55
PCT9138	MV	769	157	0	0	7	150	102	48
PCT9138	ED	176	119	0	0	10	109	100	9
PCT9138	TO	945	276	0	0	17	259	202	57
PCT9139	MV	826	158	0	0	7	151	108	43
PCT9139	ED	192	141	0	0	10	131	109	22
PCT9139	TO	1018	299	0	0	17	282	217	65
PCT9141	MV	788	160	0	0	13	147	108	39
PCT9141	ED	185	144	0	0	9	135	112	23
PCT9141	TO	973	304	0	0	22	282	220	62
PCT9142	MV	747	146	0	0	10	136	105	31
PCT9142	ED	239	162	0	0	13	149	121	28
PCT9142	TO	986	308	0	0	23	285	226	59
PCT9143	MV	703	149	0	0	11	138	99	39
PCT9143	ED	211	150	0	0	3	147	115	32
PCT9143	TO	914	299	0	0	14	285	214	71
PCT9144	MV	765	152	0	0	10	142	104	38
PCT9144	ED	205	177	0	0	8	169	149	20
PCT9144	TO	970	329	0	0	18	311	253	58
PCT9145	MV	680	117	0	0	6	111	84	27
PCT9145	ED	195	157	0	0	9	148	117	31
PCT9145	TO	875	274	0	0	15	259	201	58
PCT9146	MV	725	120	0	0	13	107	82	25
PCT9146	ED	160	143	0	0	14	129	106	23
PCT9146	TO	885	263	0	0	27	236	188	48
PCT9147	MV	763	111	0	0	4	107	79	28
PCT9147	ED	227	161	0	0	6	155	127	28
PCT9147	TO	990	272	0	0	10	262	206	56
PCT9148	MV	778	135	0	0	6	129	101	28
PCT9148	ED	236	177	0	0	14	163	145	18
PCT9148	TO	1014	312	0	0	20	292	246	46
PCT9149	MV	808	124	0	0	8	116	85	31
PCT9149	ED	183	240	0	0	13	227	196	31
PCT9149	TO	991	364	0	0	21	343	281	62
PCT9151	MV	691	133	0	0	8	125	109	16
PCT9151	ED	170	111	0	0	5	106	87	19
PCT9151	TO	861	244	0	0	13	231	196	35
PCT9152	MV	544	63	0	0	2	61	51	10
PCT9152	ED	193	124	0	0	8	116	103	13
PCT9152	TO	737	187	0	0	10	177	154	23
PCT9201	MV	784	110	0	0	3	107	103	4
PCT9201	ED	187	166	0	0	6	160	142	18
PCT9201	TO	971	276	0	0	9	267	245	22
PCT9202	MV	819	126	0	0	12	114	102	12
PCT9202	ED	177	164	0	0	10	154	128	26
PCT9202	TO	996	290	0	0	22	268	230	38
PCT9203	MV	847	142	0	0	14	128	88	40
PCT9203	ED	155	120	0	0	15	105	66	39
PCT9203	TO	1002	262	0	0	29	233	154	79
PCT9204	MV	686	115	0	0	11	104	76	28
PCT9204	ED	176	138	0	0	9	129	98	31
PCT9204	TO	862	253	0	0	20	233	174	59
PCT9205	MV	620	119	0	0	16	103	91	12
PCT9205	ED	116	92	0	0	11	81	60	21
PCT9205	TO	736	211	0	0	27	184	151	33
PCT9206	MV	741	141	0	0	10	131	83	48
PCT9206	ED	188	149	0	0	22	127	98	29
PCT9206	TO	929	290	0	0	32	258	181	77
PCT9207	MV	824	129	0	0	10	119	88	31
PCT9207	ED	165	130	0	0	11	119	92	27
PCT9207	TO	989	259	0	0	21	238	180	58
PCT9208	MV	806	127	0	0	10	117	87	30
PCT9208	ED	181	127	0	0	12	115	96	19
PCT9208	TO	987	254	0	0	22	232	183	49
PCT9209	MV	615	100	0	0	7	93	64	29
PCT9209	ED	156	119	0	0	13	106	83	23
PCT9209	TO	771	219	0	0	20	199	147	52
PCT9211	MV	730	114	0	0	11	103	73	30
PCT9211	ED	161	132	0	0	16	116	87	29
PCT9211	TO	891	246	0	0	27	219	160	59
PCT9212	MV	670	100	0	0	1	99	70	29
PCT9212	ED	138	114	0	0	18	96	78	18
PCT9212	TO	808	214	0	0	19	195	148	47
PCT9213	MV	774	138	0	0	10	128	87	41
PCT9213	ED	163	130	0	0	14	116	100	16
PCT9213	TO	937	268	0	0	24	244	187	57
PCT9214	MV	514	95	0	0	7	88	69	19
PCT9214	ED	113	103	0	0	11	92	70	22
PCT9214	TO	627	198	0	0	18	180	139	41
PCT9215	MV	523	97	0	0	3	94	67	27
PCT9215	ED	121	100	0	0	11	89	70	19
PCT9215	TO	644	197	0	0	14	183	137	46
PCT9216	MV	668	95	0	0	8	87	62	25
PCT9216	ED	156	125	0	0	8	117	91	26
PCT9216	TO	824	220	0	0	16	204	153	51
PCT9217	MV	587	89	0	0	3	86	70	16
PCT9217	ED	118	87	0	0	5	82	61	21
PCT9217	TO	705	176	0	0	8	168	131	37
PCT9218	MV	649	97	0	0	6	91	57	34
PCT9218	ED	167	112	0	0	5	107	88	19
PCT9218	TO	816	209	0	0	11	198	145	53
PCT9219	MV	643	95	0	0	5	90	75	15
PCT9219	ED	147	116	0	0	7	109	92	17
PCT9219	TO	790	211	0	0	12	199	167	32
PCT9221	MV	561	144	0	0	6	138	87	51
PCT9221	ED	90	99	0	0	8	91	70	21
PCT9221	TO	651	243	0	0	14	229	157	72
PCT9222	MV	773	145	0	0	14	131	97	34
PCT9222	ED	137	116	0	0	9	107	81	26
PCT9222	TO	910	261	0	0	23	238	178	60
PCT9223	MV	557	124	0	0	8	116	82	34
PCT9223	ED	110	59	0	0	6	53	39	14
PCT9223	TO	667	183	0	0	14	169	121	48
PCT9224	MV	767	173	0	0	9	164	123	41
PCT9224	ED	182	151	0	0	14	137	103	34
PCT9224	TO	949	324	0	0	23	301	226	75
PCT9225	MV	757	109	0	0	10	99	79	20
PCT9225	ED	169	156	0	0	18	138	116	22
PCT9225	TO	926	265	0	0	28	237	195	42
PCT9226	MV	739	140	0	0	14	126	101	25
PCT9226	ED	157	143	0	0	8	135	117	18
PCT9226	TO	896	283	0	0	22	261	218	43
PCT9227	MV	605	150	0	0	9	141	107	34
PCT9227	ED	124	114	0	0	4	110	85	25
PCT9227	TO	729	264	0	0	13	251	192	59
PCT9228	MV	577	114	0	1	9	104	81	23
PCT9228	ED	161	141	0	0	6	135	116	19
PCT9228	TO	738	255	0	1	15	239	197	42
PCT9229	MV	460	106	0	0	14	92	75	17
PCT9229	ED	119	106	0	0	2	104	90	14
PCT9229	TO	579	212	0	0	16	196	165	31
PCT9231	MV	725	133	0	0	11	122	93	29
PCT9231	ED	237	208	0	0	13	195	173	22
PCT9231	TO	962	341	0	0	24	317	266	51
PCT9232	MV	608	98	0	0	5	93	70	23
PCT9232	ED	126	140	0	0	10	130	102	28
PCT9232	TO	734	238	0	0	15	223	172	51
PCT9233	MV	668	140	0	0	6	134	91	43
PCT9233	ED	150	141	0	0	15	126	107	19
PCT9233	TO	818	281	0	0	21	260	198	62
PCT9234	MV	643	134	0	0	6	128	96	32
PCT9234	ED	91	112	0	0	13	99	79	20
PCT9234	TO	734	246	0	0	19	227	175	52
PCT9235	MV	703	143	0	0	8	135	89	46
PCT9235	ED	160	140	0	0	10	130	103	27
PCT9235	TO	863	283	0	0	18	265	192	73
PCT9236	MV	538	114	0	0	10	104	84	20
PCT9236	ED	135	101	0	0	11	90	73	17
PCT9236	TO	673	215	0	0	21	194	157	37
PCT9237	MV	778	129	0	0	6	123	88	35
PCT9237	ED	119	134	0	0	8	126	105	21
PCT9237	TO	897	263	0	0	14	249	193	56
PCT9238	MV	686	126	0	0	15	111	89	22
PCT9238	ED	119	118	0	0	15	103	86	17
PCT9238	TO	805	244	0	0	30	214	175	39
PCT9239	MV	740	176	0	0	17	159	126	33
PCT9239	ED	124	117	0	0	7	110	93	17
PCT9239	TO	864	293	0	0	24	269	219	50
PCT9241	MV	819	156	0	0	6	150	124	26
PCT9241	ED	141	139	0	0	10	129	114	15
PCT9241	TO	960	295	0	0	16	279	238	41
PCT9242	MV	771	125	0	0	12	113	83	30
PCT9242	ED	172	155	0	0	15	140	115	25
PCT9242	TO	943	280	0	0	27	253	198	55
PCT9243	MV	480	75	0	0	9	66	50	16
PCT9243	ED	123	113	0	0	13	100	87	13
PCT9243	TO	603	188	0	0	22	166	137	29
PCT9244	MV	753	114	0	0	11	103	85	18
PCT9244	ED	157	121	0	0	8	113	98	15
PCT9244	TO	910	235	0	0	19	216	183	33
PCT9245	MV	615	105	0	0	9	96	79	17
PCT9245	ED	99	91	0	0	9	82	70	12
PCT9245	TO	714	196	0	0	18	178	149	29
PCT9246	MV	815	161	0	0	11	150	114	36
PCT9246	ED	155	140	0	0	18	122	111	11
PCT9246	TO	970	301	0	0	29	272	225	47
PCT9247	MV	761	139	0	0	6	133	101	32
PCT9247	ED	151	156	0	0	20	136	114	22
PCT9247	TO	912	295	0	0	26	269	215	54
PCT9248	MV	755	130	0	0	10	120	105	15
PCT9248	ED	152	145	0	0	13	132	118	14
PCT9248	TO	907	275	0	0	23	252	223	29
PCT9249	MV	724	137	0	0	8	129	108	21
PCT9249	ED	191	171	0	0	15	156	129	27
PCT9249	TO	915	308	0	0	23	285	237	48
PCT9251	MV	792	143	0	0	9	134	106	28
PCT9251	ED	174	179	0	0	9	170	133	37
PCT9251	TO	966	322	0	0	18	304	239	65
PCT9252	MV	809	162	0	0	6	156	124	32
PCT9252	ED	144	127	0	0	9	118	105	13
PCT9252	TO	953	289	0	0	15	274	229	45
PCT9253	MV	599	100	0	0	5	95	72	23
PCT9253	ED	162	116	0	0	8	108	93	15
PCT9253	TO	761	216	0	0	13	203	165	38
PCT9254	MV	756	162	0	0	4	158	128	30
PCT9254	ED	165	155	0	0	17	138	120	18
PCT9254	TO	921	317	0	0	21	296	248	48
PCT9255	MV	435	52	0	0	2	50	39	11
PCT9255	ED	115	112	0	0	11	101	84	17
PCT9255	TO	550	164	0	0	13	151	123	28
PCT9256	MV	365	61	0	0	2	59	44	15
PCT9256	ED	97	74	0	0	7	67	58	9
PCT9256	TO	462	135	0	0	9	126	102	24
PCT9257	MV	356	36	0	0	5	31	26	5
PCT9257	ED	-36	0	0	0	0	0	0	0
PCT9257	TO	320	36	0	0	5	31	26	5
PCT9258	MV	582	114	0	0	6	108	91	17
PCT9258	ED	121	103	0	0	5	98	92	6
PCT9258	TO	703	217	0	0	11	206	183	23
PCT9401	MV	790	129	0	0	8	121	101	20
PCT9401	ED	248	176	0	0	11	165	149	16
PCT9401	TO	1038	305	0	0	19	286	250	36
PCT9402	MV	772	120	0	0	8	112	85	27
PCT9402	ED	245	159	0	0	11	148	126	22
PCT9402	TO	1017	279	0	0	19	260	211	49
PCT9403	MV	731	125	0	0	4	121	80	41
PCT9403	ED	190	123	0	0	8	115	107	8
PCT9403	TO	921	248	0	0	12	236	187	49
PCT9404	MV	751	115	0	0	11	104	76	28
PCT9404	ED	193	154	0	0	8	146	117	29
PCT9404	TO	944	269	0	0	19	250	193	57
PCT9405	MV	626	106	0	0	7	99	74	25
PCT9405	ED	154	104	0	0	5	99	76	23
PCT9405	TO	780	210	0	0	12	198	150	48
PCT9406	MV	694	111	0	0	7	104	74	30
PCT9406	ED	189	150	0	0	6	144	110	34
PCT9406	TO	883	261	0	0	13	248	184	64
PCT9407	MV	712	123	0	0	9	114	94	20
PCT9407	ED	201	131	0	0	13	118	96	22
PCT9407	TO	913	254	0	0	22	232	190	42
PCT9408	MV	708	104	0	0	7	97	82	15
PCT9408	ED	155	125	0	0	9	116	103	13
PCT9408	TO	863	229	0	0	16	213	185	28
PCT9409	MV	443	81	0	0	3	78	62	16
PCT9409	ED	158	127	0	0	5	122	109	13
PCT9409	TO	601	208	0	0	8	200	171	29
PCT9411	MV	815	106	0	0	5	101	88	13
PCT9411	ED	192	135	0	0	7	128	109	19
PCT9411	TO	1007	241	0	0	12	229	197	32
PCT9412	MV	667	128	0	0	4	124	76	48
PCT9412	ED	203	138	0	0	9	129	106	23
PCT9412	TO	870	266	0	0	13	253	182	71
PCT9413	MV	756	130	0	0	7	123	80	43
PCT9413	ED	180	127	0	0	6	121	99	22
PCT9413	TO	936	257	0	0	13	244	179	65
PCT9414	MV	733	156	0	1	7	148	102	46
PCT9414	ED	187	107	0	0	6	101	85	16
PCT9414	TO	920	263	0	1	13	249	187	62
PCT9415	MV	633	112	0	0	6	106	82	24
PCT9415	ED	155	96	0	0	6	90	78	12
PCT9415	TO	788	208	0	0	12	196	160	36
PCT9416	MV	768	157	0	0	9	148	100	48
PCT9416	ED	231	143	0	0	4	139	111	28
PCT9416	TO	999	300	0	0	13	287	211	76
PCT9417	MV	628	143	0	0	6	137	87	50
PCT9417	ED	146	110	0	0	4	106	80	26
PCT9417	TO	774	253	0	0	10	243	167	76
PCT9418	MV	627	129	0	0	10	119	81	38
PCT9418	ED	192	122	0	0	7	115	81	34
PCT9418	TO	819	251	0	0	17	234	162	72
PCT9419	MV	736	144	0	0	6	138	96	42
PCT9419	ED	173	107	0	0	8	99	69	30
PCT9419	TO	909	251	0	0	14	237	165	72
PCT9421	MV	751	128	0	0	6	122	70	52
PCT9421	ED	174	112	0	0	6	106	76	30
PCT9421	TO	925	240	0	0	12	228	146	82
PCT9422	MV	831	153	0	0	12	141	101	40
PCT9422	ED	270	145	0	0	8	137	113	24
PCT9422	TO	1101	298	0	0	20	278	214	64
PCT9423	MV	710	100	0	0	4	96	64	32
PCT9423	ED	194	121	0	0	9	112	90	22
PCT9423	TO	904	221	0	0	13	208	154	54
PCT9424	MV	795	136	0	0	6	130	95	35
PCT9424	ED	214	114	0	0	7	107	82	25
PCT9424	TO	1009	250	0	0	13	237	177	60
PCT9425	MV	789	134	0	0	10	124	90	34
PCT9425	ED	187	114	0	0	7	107	83	24
PCT9425	TO	976	248	0	0	17	231	173	58
PCT9426	MV	693	110	0	0	11	99	63	36
PCT9426	ED	160	104	0	0	11	93	64	29
PCT9426	TO	853	214	0	0	22	192	127	65
PCT9427	MV	795	154	0	0	7	147	76	71
PCT9427	ED	192	115	0	0	14	101	74	27
PCT9427	TO	987	269	0	0	21	248	150	98
PCT9428	MV	809	136	0	0	6	130	100	30
PCT9428	ED	181	113	0	0	8	105	86	19
PCT9428	TO	990	249	0	0	14	235	186	49
PCT9429	MV	705	120	0	0	4	116	76	40
PCT9429	ED	201	124	0	0	13	111	85	26
PCT9429	TO	906	244	0	0	17	227	161	66
PCT9431	MV	831	154	0	0	12	142	86	56
PCT9431	ED	205	125	0	0	5	120	90	30
PCT9431	TO	1036	279	0	0	17	262	176	86
PCT9432	MV	742	134	0	0	7	127	80	47
PCT9432	ED	216	117	0	0	7	110	88	22
PCT9432	TO	958	251	0	0	14	237	168	69
PCT9433	MV	790	155	0	0	13	142	83	59
PCT9433	ED	168	93	0	0	3	90	62	28
PCT9433	TO	958	248	0	0	16	232	145	87
PCT9434	MV	779	132	0	0	6	126	74	52
PCT9434	ED	233	162	0	0	18	144	119	25
PCT9434	TO	1012	294	0	0	24	270	193	77
PCT9435	MV	774	141	0	0	4	137	90	47
PCT9435	ED	230	157	0	0	7	150	109	41
PCT9435	TO	1004	298	0	0	11	287	199	88
PCT9436	MV	840	154	0	0	6	148	93	55
PCT9436	ED	228	129	0	0	10	119	89	30
PCT9436	TO	1068	283	0	0	16	267	182	85
PCT9437	MV	733	192	0	0	7	185	119	66
PCT9437	ED	194	130	0	0	3	127	98	29
PCT9437	TO	927	322	0	0	10	312	217	95
PCT9438	MV	833	179	0	0	8	171	104	67
PCT9438	ED	156	83	0	0	6	77	55	22
PCT9438	TO	989	262	0	0	14	248	159	89
PCT9439	MV	718	123	0	0	6	117	77	40
PCT9439	ED	199	111	0	0	9	102	76	26
PCT9439	TO	917	234	0	0	15	219	153	66
PCT9441	MV	772	134	0	0	8	126	85	41
PCT9441	ED	199	125	0	0	14	111	87	24
PCT9441	TO	971	259	0	0	22	237	172	65
PCT9442	MV	825	133	0	0	14	119	65	54
PCT9442	ED	215	156	0	0	9	147	115	32
PCT9442	TO	1040	289	0	0	23	266	180	86
PCT9443	MV	758	142	0	0	7	135	89	46
PCT9443	ED	197	109	0	0	4	105	79	26
PCT9443	TO	955	251	0	0	11	240	168	72
PCT9444	MV	760	144	0	0	5	139	87	52
PCT9444	ED	205	94	0	0	6	88	71	17
PCT9444	TO	965	238	0	0	11	227	158	69
PCT9445	MV	820	143	0	0	8	135	82	53
PCT9445	ED	176	113	0	0	8	105	81	24
PCT9445	TO	996	256	0	0	16	240	163	77
PCT9446	MV	899	178	0	0	10	168	95	73
PCT9446	ED	217	145	0	0	12	133	108	25
PCT9446	TO	1116	323	0	0	22	301	203	98
PCT9447	MV	726	127	0	0	10	117	82	35
PCT9447	ED	195	143	0	0	11	132	106	26
PCT9447	TO	921	270	0	0	21	249	188	61
PCT9448	MV	737	143	0	0	5	138	85	53
PCT9448	ED	203	127	0	0	7	120	101	19
PCT9448	TO	940	270	0	0	12	258	186	72
PCT9449	MV	717	132	0	0	5	127	74	53
PCT9449	ED	164	96	0	0	5	91	69	22
PCT9449	TO	881	228	0	0	10	218	143	75
PCT9451	MV	353	55	0	0	1	54	35	19
PCT9451	ED	88	54	0	0	4	50	37	13
PCT9451	TO	441	109	0	0	5	104	72	32
PCT9452	MV	646	108	0	0	7	101	70	31
PCT9452	ED	196	134	0	0	7	127	87	40
PCT9452	TO	842	242	0	0	14	228	157	71
PCT9453	MV	408	99	0	0	5	94	60	34
PCT9453	ED	116	70	0	0	5	65	48	17
PCT9453	TO	524	169	0	0	10	159	108	51
PCT9501	MV	158	36	0	1	4	31	28	3
PCT9501	ED	-8	0	0	0	0	0	0	0
PCT9501	TO	150	36	0	1	4	31	28	3
PCT9502	MV	291	41	0	0	2	39	32	7
PCT9502	ED	-40	0	0	0	0	0	0	0
PCT9502	TO	251	41	0	0	2	39	32	7
PCT9503	MV	549	109	0	0	14	95	88	7
PCT9503	ED	151	82	0	0	5	77	73	4
PCT9503	TO	700	191	0	0	19	172	161	11
PCT9505	MV	589	112	0	0	9	103	89	14
PCT9505	ED	176	110	0	0	7	103	92	11
PCT9505	TO	765	222	0	0	16	206	181	25
PCT9506	MV	547	76	0	0	5	71	59	12
PCT9506	ED	207	128	0	0	9	119	109	10
PCT9506	TO	754	204	0	0	14	190	168	22
PCT9507	MV	556	90	0	0	10	80	72	8
PCT9507	ED	160	152	0	0	14	138	121	17
PCT9507	TO	716	242	0	0	24	218	193	25
PCT9508	MV	627	101	0	0	4	97	89	8
PCT9508	ED	153	132	0	0	11	121	111	10
PCT9508	TO	780	233	0	0	15	218	200	18
PCT9509	MV	585	85	0	0	2	83	73	10
PCT9509	ED	142	121	0	0	7	114	109	5
PCT9509	TO	727	206	0	0	9	197	182	15
PCT9511	MV	456	56	0	0	5	51	40	11
PCT9511	ED	178	120	0	0	6	114	98	16
PCT9511	TO	634	176	0	0	11	165	138	27
PCT9512	MV	614	97	0	0	10	87	68	19
PCT9512	ED	163	132	0	0	3	129	119	10
PCT9512	TO	777	229	0	0	13	216	187	29
PCT9513	MV	686	104	0	0	6	98	92	6
PCT9513	ED	191	126	0	0	7	119	110	9
PCT9513	TO	877	230	0	0	13	217	202	15
PCT9514	MV	713	95	0	0	7	88	76	12
PCT9514	ED	183	167	0	0	14	153	140	13
PCT9514	TO	896	262	0	0	21	241	216	25
PCT9515	MV	541	94	0	0	6	88	79	9
PCT9515	ED	171	133	0	0	12	121	103	18
PCT9515	TO	712	227	0	0	18	209	182	27
PCT9516	MV	705	128	0	0	9	119	95	24
PCT9516	ED	184	157	0	0	6	151	118	33
PCT9516	TO	889	285	0	0	15	270	213	57
PCT9517	MV	624	125	0	0	11	114	95	19
PCT9517	ED	164	135	0	0	15	120	104	16
PCT9517	TO	788	260	0	0	26	234	199	35
PCT9518	MV	641	87	0	0	7	80	66	14
PCT9518	ED	147	146	0	0	5	141	127	14
PCT9518	TO	788	233	0	0	12	221	193	28
PCT9519	MV	692	105	0	0	5	100	86	14
PCT9519	ED	199	170	0	0	16	154	135	19
PCT9519	TO	891	275	0	0	21	254	221	33
PCT9521	MV	684	115	0	0	5	110	90	20
PCT9521	ED	217	190	0	0	12	178	161	17
PCT9521	TO	901	305	0	0	17	288	251	37
PCT9701	MV	498	95	0	0	6	89	70	19
PCT9701	ED	156	135	0	0	4	131	117	14
PCT9701	TO	654	230	0	0	10	220	187	33
PCT9702	MV	553	88	0	0	4	84	70	14
PCT9702	ED	167	143	0	0	2	141	123	18
PCT9702	TO	720	231	0	0	6	225	193	32
PCT9703	MV	808	144	0	0	10	134	88	46
PCT9703	ED	183	142	0	0	7	135	107	28
PCT9703	TO	991	286	0	0	17	269	195	74
PCT9704	MV	759	150	0	0	12	138	108	30
PCT9704	ED	200	196	0	0	12	184	154	30
PCT9704	TO	959	346	0	0	24	322	262	60
PCT9705	MV	752	155	0	0	9	146	112	34
PCT9705	ED	177	142	0	0	8	134	120	14
PCT9705	TO	929	297	0	0	17	280	232	48
PCT9706	MV	57	7	0	0	0	7	7	0
PCT9706	ED	-8	0	0	0	0	0	0	0
PCT9706	TO	49	7	0	0	0	7	7	0
PCT9707	MV	686	138	0	0	9	129	86	43
PCT9707	ED	140	101	0	0	7	94	72	22
PCT9707	TO	826	239	0	0	16	223	158	65
PCT9708	MV	785	159	0	0	17	142	98	44
PCT9708	ED	176	157	0	0	5	152	127	25
PCT9708	TO	961	316	0	0	22	294	225	69
PCT9709	MV	829	139	0	0	7	132	83	49
PCT9709	ED	211	178	0	0	5	173	125	48
PCT9709	TO	1040	317	0	0	12	305	208	97
PCT9711	MV	502	119	0	0	4	115	78	37
PCT9711	ED	144	138	0	0	6	132	96	36
PCT9711	TO	646	257	0	0	10	247	174	73
PCT9712	MV	534	125	0	0	9	116	82	34
PCT9712	ED	127	116	0	0	1	115	86	29
PCT9712	TO	661	241	0	0	10	231	168	63
PCT9713	MV	746	157	0	0	9	148	99	49
PCT9713	ED	204	137	0	0	9	128	85	43
PCT9713	TO	950	294	0	0	18	276	184	92
PCT9714	MV	792	181	0	0	11	170	101	69
PCT9714	ED	159	133	0	0	4	129	94	35
PCT9714	TO	951	314	0	0	15	299	195	104
PCT9715	MV	449	100	0	0	4	96	56	40
PCT9715	ED	130	134	0	0	4	130	101	29
PCT9715	TO	579	234	0	0	8	226	157	69
PCT9716	MV	743	152	0	0	8	144	100	44
PCT9716	ED	223	164	0	0	12	152	116	36
PCT9716	TO	966	316	0	0	20	296	216	80
PCT9717	MV	750	138	0	0	4	134	101	33
PCT9717	ED	227	144	0	0	8	136	102	34
PCT9717	TO	977	282	0	0	12	270	203	67
PCT9718	MV	742	171	0	0	10	161	124	37
PCT9718	ED	159	144	0	0	4	140	104	36
PCT9718	TO	901	315	0	0	14	301	228	73
PCT9719	MV	747	153	0	0	9	144	100	44
PCT9719	ED	173	150	0	0	6	144	108	36
PCT9719	TO	920	303	0	0	15	288	208	80
PCT9721	MV	498	91	0	0	1	90	69	21
PCT9721	ED	164	133	0	1	4	128	95	33
PCT9721	TO	662	224	0	1	5	218	164	54
PCT9722	MV	511	135	0	0	6	129	94	35
PCT9722	ED	86	76	0	0	5	71	57	14
PCT9722	TO	597	211	0	0	11	200	151	49
PCT9723	MV	434	107	0	0	4	103	48	55
PCT9723	ED	74	44	0	0	4	40	24	16
PCT9723	TO	508	151	0	0	8	143	72	71
PCT9724	MV	847	189	0	0	8	181	106	75
PCT9724	ED	173	99	0	1	4	94	65	29
PCT9724	TO	1020	288	0	1	12	275	171	104
PCT9725	MV	800	166	0	0	7	159	86	73
PCT9725	ED	171	95	0	0	7	88	53	35
PCT9725	TO	971	261	0	0	14	247	139	108
PCT9726	MV	523	62	0	0	4	58	46	12
PCT9726	ED	93	102	0	0	6	96	83	13
PCT9726	TO	616	164	0	0	10	154	129	25
PCT9727	MV	400	89	0	0	2	87	53	34
PCT9727	ED	60	33	0	0	2	31	22	9
PCT9727	TO	460	122	0	0	4	118	75	43
PCT9728	MV	750	178	0	0	5	173	113	60
PCT9728	ED	213	137	0	0	8	129	91	38
PCT9728	TO	963	315	0	0	13	302	204	98
PCT9729	MV	654	148	0	0	8	140	89	51
PCT9729	ED	164	128	0	0	5	123	90	33
PCT9729	TO	818	276	0	0	13	263	179	84
PCT9731	MV	436	86	0	0	6	80	39	41
PCT9731	ED	143	111	0	0	3	108	82	26
PCT9731	TO	579	197	0	0	9	188	121	67
PCT9732	MV	78	16	0	0	0	16	11	5
PCT9732	ED	-5	0	0	0	0	0	0	0
PCT9732	TO	73	16	0	0	0	16	11	5
PCT9733	MV	260	55	0	0	2	53	45	8
PCT9733	ED	-20	0	0	0	0	0	0	0
PCT9733	TO	240	55	0	0	2	53	45	8
PCT9734	MV	473	111	0	0	5	106	76	30
PCT9734	ED	131	109	0	0	2	107	78	29
PCT9734	TO	604	220	0	0	7	213	154	59
PCT9735	MV	650	140	0	0	5	135	96	39
PCT9735	ED	170	132	0	0	18	114	89	25
PCT9735	TO	820	272	0	0	23	249	185	64
PCT9736	MV	585	126	0	0	9	117	82	35
PCT9736	ED	151	151	0	0	9	142	113	29
PCT9736	TO	736	277	0	0	18	259	195	64
PCT9737	MV	636	172	0	0	7	165	117	48
PCT9737	ED	155	135	0	0	5	130	109	21
PCT9737	TO	791	307	0	0	12	295	226	69
PCT9738	MV	684	152	0	0	13	139	109	30
PCT9738	ED	154	64	0	0	5	59	49	10
PCT9738	TO	838	216	0	0	18	198	158	40
PCT9739	MV	619	86	0	0	0	86	74	12
PCT9739	ED	170	88	0	0	2	86	82	4
PCT9739	TO	789	174	0	0	2	172	156	16
PCT9741	MV	326	15	0	0	1	14	14	0
PCT9741	ED	115	10	0	0	2	8	8	0
PCT9741	TO	441	25	0	0	3	22	22	0
PCT9742	MV	529	86	0	0	2	84	44	40
PCT9742	ED	166	98	0	0	4	94	72	22
PCT9742	TO	695	184	0	0	6	178	116	62
PCT9743	MV	891	161	0	0	8	153	115	38
PCT9743	ED	249	170	0	0	13	157	139	18
PCT9743	TO	1140	331	0	0	21	310	254	56
PCT9744	MV	739	141	0	0	8	133	107	26
PCT9744	ED	204	121	0	0	11	110	95	15
PCT9744	TO	943	262	0	0	19	243	202	41
PCT9745	MV	745	120	0	0	7	113	99	14
PCT9745	ED	247	128	0	0	11	117	111	6
PCT9745	TO	992	248	0	0	18	230	210	20
PCT9746	MV	711	146	0	0	3	143	105	38
PCT9746	ED	192	118	0	0	7	111	88	23
PCT9746	TO	903	264	0	0	10	254	193	61
PCT9747	MV	766	132	0	0	6	126	86	40
PCT9747	ED	210	145	0	0	11	134	107	27
PCT9747	TO	976	277	0	0	17	260	193	67
PCT9748	MV	746	149	0	0	5	144	113	31
PCT9748	ED	167	116	0	0	6	110	81	29
PCT9748	TO	913	265	0	0	11	254	194	60
PCT9749	MV	747	99	0	0	3	96	72	24
PCT9749	ED	191	108	0	0	2	106	83	23
PCT9749	TO	938	207	0	0	5	202	155	47
PCT9751	MV	854	174	0	0	12	162	114	48
PCT9751	ED	217	151	0	0	15	136	104	32
PCT9751	TO	1071	325	0	0	27	298	218	80
PCT9752	MV	563	145	0	0	8	137	86	51
PCT9752	ED	134	108	0	0	4	104	80	24
PCT9752	TO	697	253	0	0	12	241	166	75
PCT9753	MV	615	108	0	0	6	102	83	19
PCT9753	ED	147	123	0	0	1	122	101	21
PCT9753	TO	762	231	0	0	7	224	184	40
PCT9754	MV	542	104	0	2	7	95	77	18
PCT9754	ED	165	113	0	0	6	107	93	14
PCT9754	TO	707	217	0	2	13	202	170	32
PCT9755	MV	441	86	0	0	7	79	58	21
PCT9755	ED	139	99	0	0	3	96	75	21
PCT9755	TO	580	185	0	0	10	175	133	42
PCT9756	MV	798	158	0	0	10	148	81	67
PCT9756	ED	169	106	0	0	6	100	78	22
PCT9756	TO	967	264	0	0	16	248	159	89
PCT9801	MV	320	63	0	0	6	57	46	11
PCT9801	ED	88	52	0	0	4	48	42	6
PCT9801	TO	408	115	0	0	10	105	88	17
PCT9900	MV	0	0	0	0	0	0	0	0
PCT9900	ED	0	0	0	0	0	0	0	0
PCT9900	TO	0	0	0	0	0	0	0	0
PCT9901	MV	0	0	0	0	0	0	0	0
PCT9901	ED	0	0	0	0	0	0	0	0
PCT9901	TO	0	0	0	0	0	0	0	0
PCT9902	MV	0	0	0	0	0	0	0	0
PCT9902	ED	0	0	0	0	0	0	0	0
PCT9902	TO	0	0	0	0	0	0	0	0
CONG12	MV	354748	63860	0	12	3969	59879	47072	12807
CONG12	ED	91100	65251	0	10	4495	60746	51811	8935
CONG12	TO	445848	129111	0	22	8464	120625	98883	21742
CONG14	MV	46263	8566	0	4	405	8157	5635	2522
CONG14	ED	11788	6926	0	3	391	6532	5193	1339
CONG14	TO	58051	15492	0	7	796	14689	10828	3861
ASSM17	MV	232212	41818	0	9	2603	39206	31840	7366
ASSM17	ED	60210	41964	0	10	2883	39071	33963	5108
ASSM17	TO	292422	83782	0	19	5486	78277	65803	12474
ASSM19	MV	168799	30608	0	7	1771	28830	20867	7963
ASSM19	ED	42678	30213	0	3	2003	28207	23041	5166
ASSM19	TO	211477	60821	0	10	3774	57037	43908	13129
SUPV1	MV	33800	6168	0	0	363	5805	4373	1432
SUPV1	ED	9316	6893	0	0	439	6454	5404	1050
SUPV1	TO	43116	13061	0	0	802	12259	9777	2482
SUPV2	MV	41378	7543	0	1	548	6994	5391	1603
SUPV2	ED	8668	7551	0	0	662	6889	5699	1190
SUPV2	TO	50046	15094	0	1	1210	13883	11090	2793
SUPV3	MV	31862	5929	0	2	420	5507	4339	1168
SUPV3	ED	7515	5109	0	2	392	4715	4076	639
SUPV3	TO	39377	11038	0	4	812	10222	8415	1807
SUPV4	MV	34929	6292	0	1	344	5947	3970	1977
SUPV4	ED	9165	5869	0	0	376	5493	4339	1154
SUPV4	TO	44094	12161	0	1	720	11440	8309	3131
SUPV5	MV	41848	6933	0	3	474	6456	5592	864
SUPV5	ED	11052	8955	0	2	632	8321	7476	845
SUPV5	TO	52900	15888	0	5	1106	14777	13068	1709
SUPV6	MV	35635	6264	0	3	427	5834	4874	960
SUPV6	ED	8060	4327	0	2	366	3959	3464	495
SUPV6	TO	43695	10591	0	5	793	9793	8338	1455
SUPV7	MV	38007	7748	0	2	404	7342	5185	2157
SUPV7	ED	9436	7178	0	2	369	6807	5382	1425
SUPV7	TO	47443	14926	0	4	773	14149	10567	3582
SUPV8	MV	46274	9322	0	1	554	8767	7361	1406
SUPV8	ED	11903	11078	0	3	694	10381	9072	1309
SUPV8	TO	58177	20400	0	4	1248	19148	16433	2715
SUPV9	MV	33102	5788	0	0	319	5469	4420	1049
SUPV9	ED	10161	7052	0	1	403	6648	5855	793
SUPV9	TO	43263	12840	0	1	722	12117	10275	1842
SUPV10	MV	33679	5334	0	1	291	5042	3835	1207
SUPV10	ED	9434	4180	0	0	305	3875	3237	638
SUPV10	TO	43113	9514	0	1	596	8917	7072	1845
SUPV11	MV	30497	5105	0	2	230	4873	3367	1506
SUPV11	ED	8178	3985	0	1	248	3736	3000	736
SUPV11	TO	38675	9090	0	3	478	8609	6367	2242
NEIG1	MV	15417	2302	0	1	134	2167	1616	551
NEIG1	ED	5068	1543	0	0	113	1430	1177	253
NEIG1	TO	20485	3845	0	1	247	3597	2793	804
NEIG2	MV	14005	2518	0	0	203	2315	1803	512
NEIG2	ED	3262	2161	0	1	183	1977	1680	297
NEIG2	TO	17267	4679	0	1	386	4292	3483	809
NEIG3	MV	21971	4094	0	3	288	3803	3214	589
NEIG3	ED	6048	3247	0	3	239	3005	2645	360
NEIG3	TO	28019	7341	0	6	527	6808	5859	949
NEIG4	MV	5619	1283	0	0	65	1218	987	231
NEIG4	ED	1441	1236	0	1	88	1147	938	209
NEIG4	TO	7060	2519	0	1	153	2365	1925	440
NEIG5	MV	22639	3890	0	0	188	3702	2568	1134
NEIG5	ED	5954	2958	0	0	185	2773	2201	572
NEIG5	TO	28593	6848	0	0	373	6475	4769	1706
NEIG6	MV	11497	1751	0	1	103	1647	1455	192
NEIG6	ED	2365	2735	0	1	186	2548	2304	244
NEIG6	TO	13862	4486	0	2	289	4195	3759	436
NEIG7	MV	9723	1535	0	2	61	1472	998	474
NEIG7	ED	2672	1293	0	1	75	1217	1002	215
NEIG7	TO	12395	2828	0	3	136	2689	2000	689
NEIG8	MV	7616	1294	0	1	77	1216	1011	205
NEIG8	ED	2042	1820	0	0	119	1701	1499	202
NEIG8	TO	9658	3114	0	1	196	2917	2510	407
NEIG9	MV	6608	1199	0	0	60	1139	804	335
NEIG9	ED	1650	921	0	1	65	855	709	146
NEIG9	TO	8258	2120	0	1	125	1994	1513	481
NEIG10	MV	8150	1365	0	0	73	1292	1027	265
NEIG10	ED	1872	1658	0	0	113	1545	1327	218
NEIG10	TO	10022	3023	0	0	186	2837	2354	483
NEIG11	MV	33459	5852	0	0	456	5396	4153	1243
NEIG11	ED	5981	5701	0	0	541	5160	4245	915
NEIG11	TO	39440	11553	0	0	997	10556	8398	2158
NEIG12	MV	23496	3892	0	0	217	3675	3171	504
NEIG12	ED	7509	5267	0	0	327	4940	4485	455
NEIG12	TO	31005	9159	0	0	544	8615	7656	959
NEIG14	MV	6784	1294	0	0	81	1213	1044	169
NEIG14	ED	1949	1783	0	1	92	1690	1509	181
NEIG14	TO	8733	3077	0	1	173	2903	2553	350
NEIG15	MV	5763	1099	0	0	61	1038	754	284
NEIG15	ED	1325	1007	0	0	73	934	805	129
NEIG15	TO	7088	2106	0	0	134	1972	1559	413
NEIG13	MV	13536	2683	0	0	155	2528	2079	449
NEIG13	ED	3452	3361	0	0	196	3165	2742	423
NEIG13	TO	16988	6044	0	0	351	5693	4821	872
NEIG26	MV	7824	1429	0	0	73	1356	882	474
NEIG26	ED	1808	941	0	0	56	885	662	223
NEIG26	TO	9632	2370	0	0	129	2241	1544	697
NEIG16	MV	14588	2407	0	0	152	2255	1869	386
NEIG16	ED	2768	2400	0	0	187	2213	1924	289
NEIG16	TO	17356	4807	0	0	339	4468	3793	675
NEIG17	MV	29398	5395	0	0	320	5075	3825	1250
NEIG17	ED	8227	5965	0	0	380	5585	4664	921
NEIG17	TO	37625	11360	0	0	700	10660	8489	2171
NEIG19	MV	7156	1337	0	0	75	1262	1052	210
NEIG19	ED	2415	1863	0	0	106	1757	1520	237
NEIG19	TO	9571	3200	0	0	181	3019	2572	447
NEIG18	MV	6453	1319	0	1	87	1231	912	319
NEIG18	ED	1568	1453	0	0	97	1356	1134	222
NEIG18	TO	8021	2772	0	1	184	2587	2046	541
NEIG20	MV	20838	3692	0	2	236	3454	2848	606
NEIG20	ED	4239	2417	0	0	206	2211	1927	284
NEIG20	TO	25077	6109	0	2	442	5665	4775	890
NEIG21	MV	34486	6211	0	1	341	5869	3908	1961
NEIG21	ED	9007	5742	0	0	371	5371	4230	1141
NEIG21	TO	43493	11953	0	1	712	11240	8138	3102
NEIG22	MV	15344	3230	0	1	195	3034	2571	463
NEIG22	ED	3549	3598	0	2	218	3378	2987	391
NEIG22	TO	18893	6828	0	3	413	6412	5558	854
NEIG23	MV	6627	1071	0	0	48	1023	687	336
NEIG23	ED	1861	598	0	0	45	553	428	125
NEIG23	TO	8488	1669	0	0	93	1576	1115	461
NEIG24	MV	28380	6028	0	2	318	5708	4027	1681
NEIG24	ED	6994	5659	0	1	283	5375	4190	1185
NEIG24	TO	35374	11687	0	3	601	11083	8217	2866
NEIG25	MV	23634	4256	0	1	307	3948	3442	506
NEIG25	ED	7862	4850	0	1	342	4507	4070	437
NEIG25	TO	31496	9106	0	2	649	8455	7512	943
