area_id	subtotal_type	RSReg	RSCst	RSRej	RSOvr	RSUnd	RSTot	11:YES	12:NO
ALLPCTS	TO	503899	281773	0	57	28620	253096	138873	114223
ALLPCTS	ED	101053	84584	0	15	9495	75074	44291	30783
ALLPCTS	MV	402846	197189	0	42	19125	178022	94582	83440
PCT1101	MV	448	215	0	0	24	191	116	75
PCT1101	ED	114	61	0	0	8	53	36	17
PCT1101	TO	562	276	0	0	32	244	152	92
PCT1102	MV	774	369	0	0	26	343	165	178
PCT1102	ED	230	162	0	0	15	147	86	61
PCT1102	TO	1004	531	0	0	41	490	251	239
PCT1103	MV	749	371	0	0	21	350	197	153
PCT1103	ED	222	144	0	0	11	133	77	56
PCT1103	TO	971	515	0	0	32	483	274	209
PCT1104	MV	751	343	0	0	32	311	191	120
PCT1104	ED	267	122	0	0	7	115	76	39
PCT1104	TO	1018	465	0	0	39	426	267	159
PCT1106	MV	598	255	0	0	25	230	125	105
PCT1106	ED	173	97	0	0	7	90	47	43
PCT1106	TO	771	352	0	0	32	320	172	148
PCT1107	MV	612	287	0	0	21	266	135	131
PCT1107	ED	139	76	0	0	9	67	35	32
PCT1107	TO	751	363	0	0	30	333	170	163
PCT1108	MV	725	360	0	0	29	331	187	144
PCT1108	ED	198	116	0	0	15	101	64	37
PCT1108	TO	923	476	0	0	44	432	251	181
PCT1109	MV	653	284	0	0	21	263	140	123
PCT1109	ED	169	99	0	0	8	91	55	36
PCT1109	TO	822	383	0	0	29	354	195	159
PCT1111	MV	849	354	0	0	34	320	180	140
PCT1111	ED	197	118	0	0	10	108	72	36
PCT1111	TO	1046	472	0	0	44	428	252	176
PCT1112	MV	643	278	0	0	19	259	152	107
PCT1112	ED	159	79	0	0	6	73	52	21
PCT1112	TO	802	357	0	0	25	332	204	128
PCT1113	MV	675	286	0	0	26	260	143	117
PCT1113	ED	120	65	0	0	8	57	38	19
PCT1113	TO	795	351	0	0	34	317	181	136
PCT1114	MV	769	328	0	0	28	300	181	119
PCT1114	ED	222	98	0	0	14	84	56	28
PCT1114	TO	991	426	0	0	42	384	237	147
PCT1115	MV	743	295	0	0	24	271	155	116
PCT1115	ED	193	89	0	0	8	81	54	27
PCT1115	TO	936	384	0	0	32	352	209	143
PCT1116	MV	715	308	0	0	30	278	177	101
PCT1116	ED	216	119	0	0	10	109	77	32
PCT1116	TO	931	427	0	0	40	387	254	133
PCT1117	MV	665	258	0	0	23	235	143	92
PCT1117	ED	181	72	0	0	5	67	52	15
PCT1117	TO	846	330	0	0	28	302	195	107
PCT1118	MV	846	357	0	0	19	338	194	144
PCT1118	ED	219	106	0	0	17	89	53	36
PCT1118	TO	1065	463	0	0	36	427	247	180
PCT1119	MV	659	303	0	0	19	284	166	118
PCT1119	ED	138	75	0	0	7	68	50	18
PCT1119	TO	797	378	0	0	26	352	216	136
PCT1121	MV	556	268	0	0	32	236	134	102
PCT1121	ED	149	87	0	0	8	79	49	30
PCT1121	TO	705	355	0	0	40	315	183	132
PCT1122	MV	519	245	0	0	24	221	113	108
PCT1122	ED	118	71	0	0	8	63	35	28
PCT1122	TO	637	316	0	0	32	284	148	136
PCT1123	MV	730	257	0	0	22	235	137	98
PCT1123	ED	208	89	0	0	5	84	67	17
PCT1123	TO	938	346	0	0	27	319	204	115
PCT1124	MV	630	246	0	0	10	236	145	91
PCT1124	ED	199	76	0	0	4	72	52	20
PCT1124	TO	829	322	0	0	14	308	197	111
PCT1125	MV	919	364	0	1	44	319	193	126
PCT1125	ED	178	68	0	0	11	57	42	15
PCT1125	TO	1097	432	0	1	55	376	235	141
PCT1126	MV	812	308	0	0	26	282	165	117
PCT1126	ED	200	68	0	0	5	63	40	23
PCT1126	TO	1012	376	0	0	31	345	205	140
PCT1127	MV	743	293	0	0	19	274	136	138
PCT1127	ED	222	101	0	0	8	93	55	38
PCT1127	TO	965	394	0	0	27	367	191	176
PCT1128	MV	734	287	0	0	27	260	144	116
PCT1128	ED	145	59	0	0	7	52	37	15
PCT1128	TO	879	346	0	0	34	312	181	131
PCT1129	MV	790	314	0	1	27	286	175	111
PCT1129	ED	246	109	0	0	15	94	63	31
PCT1129	TO	1036	423	0	1	42	380	238	142
PCT1131	MV	694	280	0	1	35	244	112	132
PCT1131	ED	166	61	0	0	8	53	29	24
PCT1131	TO	860	341	0	1	43	297	141	156
PCT1132	MV	839	370	0	0	32	338	180	158
PCT1132	ED	193	60	0	0	3	57	26	31
PCT1132	TO	1032	430	0	0	35	395	206	189
PCT1133	MV	716	334	0	0	20	314	154	160
PCT1133	ED	159	74	0	0	5	69	36	33
PCT1133	TO	875	408	0	0	25	383	190	193
PCT1134	MV	585	293	0	0	21	272	129	143
PCT1134	ED	182	80	0	0	8	72	51	21
PCT1134	TO	767	373	0	0	29	344	180	164
PCT1135	MV	465	218	0	0	15	203	105	98
PCT1135	ED	91	51	0	0	4	47	25	22
PCT1135	TO	556	269	0	0	19	250	130	120
PCT1136	MV	710	340	0	0	19	321	185	136
PCT1136	ED	157	79	0	0	5	74	45	29
PCT1136	TO	867	419	0	0	24	395	230	165
PCT1141	MV	836	393	0	0	30	363	199	164
PCT1141	ED	220	124	0	0	7	117	73	44
PCT1141	TO	1056	517	0	0	37	480	272	208
PCT1142	MV	721	324	0	0	39	285	177	108
PCT1142	ED	175	87	0	0	5	82	59	23
PCT1142	TO	896	411	0	0	44	367	236	131
PCT1143	MV	824	360	0	0	39	321	202	119
PCT1143	ED	225	116	0	0	11	105	74	31
PCT1143	TO	1049	476	0	0	50	426	276	150
PCT1144	MV	727	326	0	0	24	302	172	130
PCT1144	ED	220	121	0	0	12	109	60	49
PCT1144	TO	947	447	0	0	36	411	232	179
PCT1145	MV	753	411	0	0	34	377	207	170
PCT1145	ED	152	114	0	1	10	103	73	30
PCT1145	TO	905	525	0	1	44	480	280	200
PCT1146	MV	839	364	0	0	26	338	206	132
PCT1146	ED	215	110	0	0	9	101	69	32
PCT1146	TO	1054	474	0	0	35	439	275	164
PCT1147	MV	673	309	0	0	19	290	174	116
PCT1147	ED	212	108	0	0	13	95	62	33
PCT1147	TO	885	417	0	0	32	385	236	149
PCT1148	MV	804	368	0	0	32	336	190	146
PCT1148	ED	224	119	0	0	11	108	67	41
PCT1148	TO	1028	487	0	0	43	444	257	187
PCT1149	MV	710	319	0	0	37	282	144	138
PCT1149	ED	229	119	0	0	10	109	75	34
PCT1149	TO	939	438	0	0	47	391	219	172
PCT1152	MV	710	313	0	0	32	281	172	109
PCT1152	ED	180	87	0	0	8	79	47	32
PCT1152	TO	890	400	0	0	40	360	219	141
PCT1153	MV	730	285	0	0	36	249	151	98
PCT1153	ED	210	117	0	0	11	106	53	53
PCT1153	TO	940	402	0	0	47	355	204	151
PCT7001	MV	632	329	0	0	25	304	153	151
PCT7001	ED	141	105	0	0	7	98	59	39
PCT7001	TO	773	434	0	0	32	402	212	190
PCT7002	MV	598	267	0	0	32	235	129	106
PCT7002	ED	116	90	0	0	6	84	52	32
PCT7002	TO	714	357	0	0	38	319	181	138
PCT7003	MV	759	432	0	0	44	388	208	180
PCT7003	ED	147	144	0	0	15	129	75	54
PCT7003	TO	906	576	0	0	59	517	283	234
PCT7004	MV	764	416	0	1	35	380	189	191
PCT7004	ED	149	146	0	0	17	129	70	59
PCT7004	TO	913	562	0	1	52	509	259	250
PCT7005	MV	698	350	0	0	32	318	168	150
PCT7005	ED	161	163	0	0	23	140	88	52
PCT7005	TO	859	513	0	0	55	458	256	202
PCT7006	MV	729	360	0	0	40	320	197	123
PCT7006	ED	203	153	0	0	11	142	103	39
PCT7006	TO	932	513	0	0	51	462	300	162
PCT7007	MV	777	437	0	0	41	396	205	191
PCT7007	ED	180	174	0	0	18	156	95	61
PCT7007	TO	957	611	0	0	59	552	300	252
PCT7008	MV	732	367	0	0	42	325	168	157
PCT7008	ED	177	194	0	0	18	176	106	70
PCT7008	TO	909	561	0	0	60	501	274	227
PCT7009	MV	752	390	0	0	30	360	202	158
PCT7009	ED	119	95	0	0	7	88	50	38
PCT7009	TO	871	485	0	0	37	448	252	196
PCT7011	MV	704	231	0	0	21	210	103	107
PCT7011	ED	269	88	0	0	5	83	49	34
PCT7011	TO	973	319	0	0	26	293	152	141
PCT7012	MV	999	487	0	0	48	439	250	189
PCT7012	ED	227	209	0	0	19	190	106	84
PCT7012	TO	1226	696	0	0	67	629	356	273
PCT7013	MV	984	427	0	0	39	388	224	164
PCT7013	ED	155	157	0	0	21	136	78	58
PCT7013	TO	1139	584	0	0	60	524	302	222
PCT7014	MV	610	303	0	1	31	271	126	145
PCT7014	ED	109	115	0	0	19	96	55	41
PCT7014	TO	719	418	0	1	50	367	181	186
PCT7015	MV	128	40	0	0	6	34	23	11
PCT7015	ED	-18	0	0	0	0	0	0	0
PCT7015	TO	110	40	0	0	6	34	23	11
PCT7016	MV	655	239	0	0	23	216	112	104
PCT7016	ED	277	79	0	0	7	72	46	26
PCT7016	TO	932	318	0	0	30	288	158	130
PCT7017	MV	543	180	0	0	26	154	92	62
PCT7017	ED	238	53	0	0	12	41	21	20
PCT7017	TO	781	233	0	0	38	195	113	82
PCT7018	MV	847	357	0	0	36	321	166	155
PCT7018	ED	200	56	0	0	5	51	37	14
PCT7018	TO	1047	413	0	0	41	372	203	169
PCT7019	MV	734	355	0	0	29	326	168	158
PCT7019	ED	166	74	0	0	8	66	41	25
PCT7019	TO	900	429	0	0	37	392	209	183
PCT7021	MV	679	271	0	0	32	239	150	89
PCT7021	ED	288	108	0	0	12	96	61	35
PCT7021	TO	967	379	0	0	44	335	211	124
PCT7022	MV	770	312	0	0	36	276	160	116
PCT7022	ED	193	55	0	0	3	52	39	13
PCT7022	TO	963	367	0	0	39	328	199	129
PCT7023	MV	687	331	0	0	30	301	172	129
PCT7023	ED	233	72	0	0	6	66	39	27
PCT7023	TO	920	403	0	0	36	367	211	156
PCT7024	MV	251	50	0	0	4	46	26	20
PCT7024	ED	190	20	0	0	4	16	12	4
PCT7024	TO	441	70	0	0	8	62	38	24
PCT7025	MV	316	95	0	0	7	88	49	39
PCT7025	ED	167	39	0	0	2	37	21	16
PCT7025	TO	483	134	0	0	9	125	70	55
PCT7026	MV	819	336	0	0	29	307	163	144
PCT7026	ED	191	72	0	0	7	65	39	26
PCT7026	TO	1010	408	0	0	36	372	202	170
PCT7027	MV	677	270	0	0	31	239	140	99
PCT7027	ED	219	99	0	0	10	89	49	40
PCT7027	TO	896	369	0	0	41	328	189	139
PCT7028	MV	585	220	0	0	19	201	124	77
PCT7028	ED	271	100	0	0	12	88	60	28
PCT7028	TO	856	320	0	0	31	289	184	105
PCT7029	MV	642	209	0	0	30	179	101	78
PCT7029	ED	267	40	0	0	1	39	16	23
PCT7029	TO	909	249	0	0	31	218	117	101
PCT7030	MV	654	274	0	0	19	255	127	128
PCT7030	ED	141	59	0	0	1	58	34	24
PCT7030	TO	795	333	0	0	20	313	161	152
PCT7031	MV	622	263	0	0	24	239	143	96
PCT7031	ED	72	49	0	0	8	41	21	20
PCT7031	TO	694	312	0	0	32	280	164	116
PCT7032	MV	643	266	0	0	26	240	130	110
PCT7032	ED	238	54	0	0	4	50	30	20
PCT7032	TO	881	320	0	0	30	290	160	130
PCT7033	MV	549	214	0	0	21	193	111	82
PCT7033	ED	229	86	0	0	9	77	49	28
PCT7033	TO	778	300	0	0	30	270	160	110
PCT7034	MV	620	142	0	0	22	120	74	46
PCT7034	ED	318	60	0	0	4	56	34	22
PCT7034	TO	938	202	0	0	26	176	108	68
PCT7035	MV	567	237	0	0	24	213	103	110
PCT7035	ED	152	54	0	0	7	47	29	18
PCT7035	TO	719	291	0	0	31	260	132	128
PCT7036	MV	781	263	0	0	31	232	126	106
PCT7036	ED	193	39	0	0	1	38	23	15
PCT7036	TO	974	302	0	0	32	270	149	121
PCT7037	MV	434	63	0	0	4	59	39	20
PCT7037	ED	312	38	0	0	6	32	22	10
PCT7037	TO	746	101	0	0	10	91	61	30
PCT7038	MV	758	308	0	0	29	279	143	136
PCT7038	ED	203	60	0	0	10	50	25	25
PCT7038	TO	961	368	0	0	39	329	168	161
PCT7039	MV	636	243	0	0	27	216	100	116
PCT7039	ED	201	104	0	0	4	100	65	35
PCT7039	TO	837	347	0	0	31	316	165	151
PCT7041	MV	70	29	0	0	7	22	13	9
PCT7041	ED	-4	0	0	0	0	0	0	0
PCT7041	TO	66	29	0	0	7	22	13	9
PCT7042	MV	514	222	0	0	18	204	117	87
PCT7042	ED	146	62	0	0	1	61	42	19
PCT7042	TO	660	284	0	0	19	265	159	106
PCT7043	MV	754	295	0	0	27	268	172	96
PCT7043	ED	224	79	0	0	4	75	48	27
PCT7043	TO	978	374	0	0	31	343	220	123
PCT7044	MV	586	149	0	0	5	144	76	68
PCT7044	ED	266	36	0	0	3	33	26	7
PCT7044	TO	852	185	0	0	8	177	102	75
PCT7045	MV	632	267	0	0	28	239	140	99
PCT7045	ED	154	53	0	0	5	48	26	22
PCT7045	TO	786	320	0	0	33	287	166	121
PCT7046	MV	334	132	0	0	14	118	63	55
PCT7046	ED	96	48	0	0	3	45	24	21
PCT7046	TO	430	180	0	0	17	163	87	76
PCT7047	MV	733	315	0	0	27	288	152	136
PCT7047	ED	150	62	0	0	6	56	36	20
PCT7047	TO	883	377	0	0	33	344	188	156
PCT7048	MV	685	267	0	0	21	246	148	98
PCT7048	ED	196	59	0	0	5	54	32	22
PCT7048	TO	881	326	0	0	26	300	180	120
PCT7049	MV	616	247	0	0	23	224	121	103
PCT7049	ED	210	71	0	0	9	62	31	31
PCT7049	TO	826	318	0	0	32	286	152	134
PCT7051	MV	715	306	0	0	24	282	143	139
PCT7051	ED	165	70	0	0	8	62	43	19
PCT7051	TO	880	376	0	0	32	344	186	158
PCT7052	MV	722	296	0	0	14	282	142	140
PCT7052	ED	184	88	0	0	7	81	42	39
PCT7052	TO	906	384	0	0	21	363	184	179
PCT7053	MV	542	227	0	0	38	189	88	101
PCT7053	ED	43	42	0	0	4	38	21	17
PCT7053	TO	585	269	0	0	42	227	109	118
PCT7054	MV	863	310	0	1	31	278	158	120
PCT7054	ED	273	109	0	0	5	104	61	43
PCT7054	TO	1136	419	0	1	36	382	219	163
PCT7055	MV	732	292	0	0	23	269	151	118
PCT7055	ED	94	78	0	0	9	69	40	29
PCT7055	TO	826	370	0	0	32	338	191	147
PCT7056	MV	618	275	0	1	29	245	117	128
PCT7056	ED	87	122	0	0	14	108	64	44
PCT7056	TO	705	397	0	1	43	353	181	172
PCT7101	MV	162	99	0	0	8	91	49	42
PCT7101	ED	-15	4	0	0	2	2	2	0
PCT7101	TO	147	103	0	0	10	93	51	42
PCT7201	MV	788	383	0	0	40	343	151	192
PCT7201	ED	147	170	0	0	29	141	70	71
PCT7201	TO	935	553	0	0	69	484	221	263
PCT7202	MV	708	308	0	0	30	278	121	157
PCT7202	ED	143	158	0	0	20	138	74	64
PCT7202	TO	851	466	0	0	50	416	195	221
PCT7203	MV	693	321	0	0	46	275	125	150
PCT7203	ED	186	187	0	0	29	158	78	80
PCT7203	TO	879	508	0	0	75	433	203	230
PCT7204	MV	773	422	0	0	55	367	155	212
PCT7204	ED	126	157	0	0	34	123	58	65
PCT7204	TO	899	579	0	0	89	490	213	277
PCT7205	MV	724	360	0	0	33	327	152	175
PCT7205	ED	147	177	0	0	23	154	72	82
PCT7205	TO	871	537	0	0	56	481	224	257
PCT7206	MV	299	129	0	0	12	117	56	61
PCT7206	ED	78	106	0	0	13	93	52	41
PCT7206	TO	377	235	0	0	25	210	108	102
PCT7207	MV	744	333	0	0	32	301	157	144
PCT7207	ED	123	154	0	0	20	134	84	50
PCT7207	TO	867	487	0	0	52	435	241	194
PCT7208	MV	492	253	0	0	35	218	101	117
PCT7208	ED	78	97	0	0	14	83	49	34
PCT7208	TO	570	350	0	0	49	301	150	151
PCT7209	MV	595	341	0	0	45	296	105	191
PCT7209	ED	52	75	0	0	9	66	31	35
PCT7209	TO	647	416	0	0	54	362	136	226
PCT7301	MV	813	319	0	0	31	288	169	119
PCT7301	ED	201	143	0	0	15	128	76	52
PCT7301	TO	1014	462	0	0	46	416	245	171
PCT7302	MV	713	352	0	0	37	315	158	157
PCT7302	ED	136	140	0	0	17	123	65	58
PCT7302	TO	849	492	0	0	54	438	223	215
PCT7303	MV	869	376	0	0	35	341	190	151
PCT7303	ED	199	172	0	1	28	143	83	60
PCT7303	TO	1068	548	0	1	63	484	273	211
PCT7304	MV	802	366	0	0	40	326	143	183
PCT7304	ED	199	185	0	0	15	170	96	74
PCT7304	TO	1001	551	0	0	55	496	239	257
PCT7305	MV	713	386	0	0	38	348	147	201
PCT7305	ED	154	155	0	0	19	136	71	65
PCT7305	TO	867	541	0	0	57	484	218	266
PCT7306	MV	801	374	0	0	54	320	145	175
PCT7306	ED	243	194	0	0	32	162	96	66
PCT7306	TO	1044	568	0	0	86	482	241	241
PCT7307	MV	605	272	0	0	19	253	129	124
PCT7307	ED	169	130	0	0	20	110	60	50
PCT7307	TO	774	402	0	0	39	363	189	174
PCT7308	MV	520	257	0	0	17	240	113	127
PCT7308	ED	105	158	0	0	22	136	68	68
PCT7308	TO	625	415	0	0	39	376	181	195
PCT7309	MV	691	324	0	0	40	284	133	151
PCT7309	ED	167	191	0	0	30	161	95	66
PCT7309	TO	858	515	0	0	70	445	228	217
PCT7311	MV	698	333	0	0	25	308	133	175
PCT7311	ED	208	218	0	0	32	186	105	81
PCT7311	TO	906	551	0	0	57	494	238	256
PCT7312	MV	700	395	0	0	45	350	148	202
PCT7312	ED	110	162	0	0	21	141	61	80
PCT7312	TO	810	557	0	0	66	491	209	282
PCT7313	MV	819	373	0	0	33	340	186	154
PCT7313	ED	184	163	0	0	28	135	86	49
PCT7313	TO	1003	536	0	0	61	475	272	203
PCT7314	MV	612	226	0	0	28	198	131	67
PCT7314	ED	147	85	0	0	11	74	48	26
PCT7314	TO	759	311	0	0	39	272	179	93
PCT7315	MV	570	206	0	0	20	186	98	88
PCT7315	ED	195	135	0	0	15	120	71	49
PCT7315	TO	765	341	0	0	35	306	169	137
PCT7316	MV	654	261	0	0	31	230	134	96
PCT7316	ED	178	131	0	0	19	112	75	37
PCT7316	TO	832	392	0	0	50	342	209	133
PCT7317	MV	744	350	0	0	31	319	153	166
PCT7317	ED	146	114	0	0	17	97	59	38
PCT7317	TO	890	464	0	0	48	416	212	204
PCT7318	MV	605	293	0	0	36	257	135	122
PCT7318	ED	118	108	0	0	21	87	45	42
PCT7318	TO	723	401	0	0	57	344	180	164
PCT7319	MV	861	345	0	0	38	307	153	154
PCT7319	ED	188	185	0	0	32	153	79	74
PCT7319	TO	1049	530	0	0	70	460	232	228
PCT7321	MV	557	202	0	0	25	177	87	90
PCT7321	ED	102	85	0	0	12	73	41	32
PCT7321	TO	659	287	0	0	37	250	128	122
PCT7322	MV	742	294	0	1	44	249	160	89
PCT7322	ED	146	50	0	0	7	43	36	7
PCT7322	TO	888	344	0	1	51	292	196	96
PCT7323	MV	790	368	0	0	51	317	144	173
PCT7323	ED	166	160	0	0	24	136	75	61
PCT7323	TO	956	528	0	0	75	453	219	234
PCT7324	MV	587	260	0	0	35	225	124	101
PCT7324	ED	150	89	0	0	13	76	38	38
PCT7324	TO	737	349	0	0	48	301	162	139
PCT7325	MV	714	327	0	0	39	288	155	133
PCT7325	ED	172	124	0	0	18	106	60	46
PCT7325	TO	886	451	0	0	57	394	215	179
PCT7326	MV	685	304	0	0	35	269	152	117
PCT7326	ED	174	159	0	0	27	132	70	62
PCT7326	TO	859	463	0	0	62	401	222	179
PCT7327	MV	561	230	0	0	33	197	119	78
PCT7327	ED	126	49	0	0	5	44	22	22
PCT7327	TO	687	279	0	0	38	241	141	100
PCT7328	MV	829	333	0	0	64	269	170	99
PCT7328	ED	173	67	0	0	14	53	39	14
PCT7328	TO	1002	400	0	0	78	322	209	113
PCT7329	MV	556	227	0	0	24	203	80	123
PCT7329	ED	95	78	0	0	8	70	31	39
PCT7329	TO	651	305	0	0	32	273	111	162
PCT7331	MV	710	361	0	0	40	321	132	189
PCT7331	ED	160	162	0	0	27	135	61	74
PCT7331	TO	870	523	0	0	67	456	193	263
PCT7332	MV	654	264	0	0	31	233	140	93
PCT7332	ED	136	149	0	0	13	136	95	41
PCT7332	TO	790	413	0	0	44	369	235	134
PCT7333	MV	822	390	0	0	35	355	202	153
PCT7333	ED	193	224	0	0	28	196	121	75
PCT7333	TO	1015	614	0	0	63	551	323	228
PCT7334	MV	688	307	0	0	23	284	170	114
PCT7334	ED	131	135	0	0	13	122	88	34
PCT7334	TO	819	442	0	0	36	406	258	148
PCT7335	MV	788	389	0	0	42	347	170	177
PCT7335	ED	146	191	0	0	24	167	97	70
PCT7335	TO	934	580	0	0	66	514	267	247
PCT7336	MV	779	405	0	0	39	366	177	189
PCT7336	ED	175	178	0	0	30	148	87	61
PCT7336	TO	954	583	0	0	69	514	264	250
PCT7337	MV	772	386	0	0	47	339	146	193
PCT7337	ED	125	112	0	0	11	101	55	46
PCT7337	TO	897	498	0	0	58	440	201	239
PCT7338	MV	770	360	0	0	38	322	184	138
PCT7338	ED	125	91	0	0	12	79	55	24
PCT7338	TO	895	451	0	0	50	401	239	162
PCT7339	MV	605	270	0	0	24	246	141	105
PCT7339	ED	150	122	0	0	8	114	69	45
PCT7339	TO	755	392	0	0	32	360	210	150
PCT7341	MV	675	291	0	1	33	257	164	93
PCT7341	ED	178	160	0	1	14	145	100	45
PCT7341	TO	853	451	0	2	47	402	264	138
PCT7342	MV	674	324	0	0	26	298	176	122
PCT7342	ED	230	245	0	0	25	220	141	79
PCT7342	TO	904	569	0	0	51	518	317	201
PCT7343	MV	554	252	0	0	22	230	141	89
PCT7343	ED	150	150	0	0	21	129	89	40
PCT7343	TO	704	402	0	0	43	359	230	129
PCT7344	MV	863	392	0	0	29	363	183	180
PCT7344	ED	201	211	0	0	28	183	111	72
PCT7344	TO	1064	603	0	0	57	546	294	252
PCT7345	MV	904	434	0	0	36	398	235	163
PCT7345	ED	210	217	0	0	30	187	114	73
PCT7345	TO	1114	651	0	0	66	585	349	236
PCT7346	MV	681	288	0	0	29	259	182	77
PCT7346	ED	208	174	0	0	25	149	112	37
PCT7346	TO	889	462	0	0	54	408	294	114
PCT7347	MV	833	371	0	0	37	334	235	99
PCT7347	ED	170	123	0	0	13	110	75	35
PCT7347	TO	1003	494	0	0	50	444	310	134
PCT7348	MV	650	279	0	0	26	253	162	91
PCT7348	ED	193	116	0	0	9	107	69	38
PCT7348	TO	843	395	0	0	35	360	231	129
PCT7349	MV	710	316	0	1	26	289	158	131
PCT7349	ED	202	145	0	0	22	123	79	44
PCT7349	TO	912	461	0	1	48	412	237	175
PCT7501	MV	456	248	0	0	36	212	83	129
PCT7501	ED	95	116	0	0	17	99	48	51
PCT7501	TO	551	364	0	0	53	311	131	180
PCT7502	MV	668	315	0	0	35	280	145	135
PCT7502	ED	121	143	0	0	24	119	75	44
PCT7502	TO	789	458	0	0	59	399	220	179
PCT7503	MV	614	286	0	0	32	254	155	99
PCT7503	ED	148	138	0	0	25	113	64	49
PCT7503	TO	762	424	0	0	57	367	219	148
PCT7504	MV	404	175	0	0	17	158	90	68
PCT7504	ED	84	84	0	0	14	70	45	25
PCT7504	TO	488	259	0	0	31	228	135	93
PCT7505	MV	729	405	0	0	46	359	157	202
PCT7505	ED	133	130	0	0	14	116	53	63
PCT7505	TO	862	535	0	0	60	475	210	265
PCT7506	MV	842	364	0	0	40	324	196	128
PCT7506	ED	158	162	0	0	18	144	107	37
PCT7506	TO	1000	526	0	0	58	468	303	165
PCT7507	MV	694	289	0	0	23	266	176	90
PCT7507	ED	262	133	0	0	11	122	82	40
PCT7507	TO	956	422	0	0	34	388	258	130
PCT7508	MV	618	373	0	0	39	334	193	141
PCT7508	ED	126	118	0	0	12	106	66	40
PCT7508	TO	744	491	0	0	51	440	259	181
PCT7509	MV	756	399	0	0	33	366	216	150
PCT7509	ED	173	169	0	0	21	148	91	57
PCT7509	TO	929	568	0	0	54	514	307	207
PCT7512	MV	475	248	0	0	28	220	111	109
PCT7512	ED	125	89	0	0	10	79	49	30
PCT7512	TO	600	337	0	0	38	299	160	139
PCT7513	MV	575	248	0	0	34	214	143	71
PCT7513	ED	231	143	0	0	25	118	91	27
PCT7513	TO	806	391	0	0	59	332	234	98
PCT7514	MV	709	242	0	0	40	202	138	64
PCT7514	ED	207	76	0	0	18	58	35	23
PCT7514	TO	916	318	0	0	58	260	173	87
PCT7515	MV	663	322	0	1	25	296	183	113
PCT7515	ED	201	114	0	0	20	94	62	32
PCT7515	TO	864	436	0	1	45	390	245	145
PCT7516	MV	773	423	0	0	34	389	214	175
PCT7516	ED	147	131	0	0	7	124	60	64
PCT7516	TO	920	554	0	0	41	513	274	239
PCT7517	MV	645	362	0	0	45	317	203	114
PCT7517	ED	223	234	0	0	28	206	132	74
PCT7517	TO	868	596	0	0	73	523	335	188
PCT7518	MV	708	392	0	0	39	353	200	153
PCT7518	ED	218	247	0	0	26	221	149	72
PCT7518	TO	926	639	0	0	65	574	349	225
PCT7519	MV	543	260	0	0	27	233	142	91
PCT7519	ED	172	172	0	0	15	157	109	48
PCT7519	TO	715	432	0	0	42	390	251	139
PCT7521	MV	597	319	0	0	26	293	182	111
PCT7521	ED	182	205	0	0	18	187	117	70
PCT7521	TO	779	524	0	0	44	480	299	181
PCT7522	MV	588	301	0	1	27	273	155	118
PCT7522	ED	171	192	0	0	26	166	110	56
PCT7522	TO	759	493	0	1	53	439	265	174
PCT7523	MV	564	285	0	0	34	251	152	99
PCT7523	ED	180	221	0	0	20	201	133	68
PCT7523	TO	744	506	0	0	54	452	285	167
PCT7524	MV	480	228	0	0	23	205	144	61
PCT7524	ED	144	130	0	0	15	115	74	41
PCT7524	TO	624	358	0	0	38	320	218	102
PCT7525	MV	594	246	0	0	34	212	134	78
PCT7525	ED	170	130	0	0	21	109	65	44
PCT7525	TO	764	376	0	0	55	321	199	122
PCT7526	MV	826	395	0	0	45	350	190	160
PCT7526	ED	162	219	0	0	26	193	120	73
PCT7526	TO	988	614	0	0	71	543	310	233
PCT7527	MV	538	296	0	0	26	270	172	98
PCT7527	ED	172	126	0	0	10	116	73	43
PCT7527	TO	710	422	0	0	36	386	245	141
PCT7529	MV	749	366	0	0	33	333	200	133
PCT7529	ED	154	231	0	0	25	206	134	72
PCT7529	TO	903	597	0	0	58	539	334	205
PCT7531	MV	714	336	0	0	24	312	205	107
PCT7531	ED	159	179	0	0	12	167	107	60
PCT7531	TO	873	515	0	0	36	479	312	167
PCT7532	MV	668	329	0	0	29	300	166	134
PCT7532	ED	167	185	0	0	20	165	113	52
PCT7532	TO	835	514	0	0	49	465	279	186
PCT7533	MV	776	405	0	0	42	363	240	123
PCT7533	ED	194	252	0	0	28	224	158	66
PCT7533	TO	970	657	0	0	70	587	398	189
PCT7534	MV	670	376	0	1	36	339	203	136
PCT7534	ED	233	231	0	0	26	205	150	55
PCT7534	TO	903	607	0	1	62	544	353	191
PCT7535	MV	606	300	0	0	33	267	176	91
PCT7535	ED	139	199	0	0	31	168	117	51
PCT7535	TO	745	499	0	0	64	435	293	142
PCT7536	MV	670	346	0	0	25	321	206	115
PCT7536	ED	163	216	0	0	22	194	107	87
PCT7536	TO	833	562	0	0	47	515	313	202
PCT7537	MV	619	301	0	0	28	273	148	125
PCT7537	ED	126	197	0	0	19	178	113	65
PCT7537	TO	745	498	0	0	47	451	261	190
PCT7538	MV	562	322	0	0	35	287	160	127
PCT7538	ED	189	212	0	0	28	184	127	57
PCT7538	TO	751	534	0	0	63	471	287	184
PCT7539	MV	696	374	0	0	33	341	178	163
PCT7539	ED	225	215	0	0	18	197	144	53
PCT7539	TO	921	589	0	0	51	538	322	216
PCT7541	MV	600	295	0	0	36	259	147	112
PCT7541	ED	170	214	0	0	30	184	125	59
PCT7541	TO	770	509	0	0	66	443	272	171
PCT7542	MV	632	324	0	0	25	299	197	102
PCT7542	ED	192	200	0	0	14	186	130	56
PCT7542	TO	824	524	0	0	39	485	327	158
PCT7543	MV	694	371	0	0	31	340	210	130
PCT7543	ED	230	173	0	0	25	148	105	43
PCT7543	TO	924	544	0	0	56	488	315	173
PCT7544	MV	731	389	0	0	46	343	202	141
PCT7544	ED	168	207	0	0	23	184	123	61
PCT7544	TO	899	596	0	0	69	527	325	202
PCT7545	MV	723	385	0	0	38	347	189	158
PCT7545	ED	172	192	0	0	23	169	113	56
PCT7545	TO	895	577	0	0	61	516	302	214
PCT7546	MV	770	418	0	0	40	378	233	145
PCT7546	ED	183	255	0	0	29	226	135	91
PCT7546	TO	953	673	0	0	69	604	368	236
PCT7547	MV	798	427	0	0	38	389	268	121
PCT7547	ED	183	227	0	0	27	200	140	60
PCT7547	TO	981	654	0	0	65	589	408	181
PCT7548	MV	802	450	0	0	33	417	239	178
PCT7548	ED	249	259	0	1	27	231	153	78
PCT7548	TO	1051	709	0	1	60	648	392	256
PCT7549	MV	660	358	0	0	39	319	194	125
PCT7549	ED	146	170	0	0	25	145	91	54
PCT7549	TO	806	528	0	0	64	464	285	179
PCT7551	MV	587	304	0	0	22	282	158	124
PCT7551	ED	136	178	0	0	19	159	92	67
PCT7551	TO	723	482	0	0	41	441	250	191
PCT7552	MV	561	285	0	0	36	249	131	118
PCT7552	ED	124	168	0	0	27	141	79	62
PCT7552	TO	685	453	0	0	63	390	210	180
PCT7553	MV	211	95	0	0	10	85	48	37
PCT7553	ED	-20	7	0	0	1	6	4	2
PCT7553	TO	191	102	0	0	11	91	52	39
PCT7554	MV	653	381	0	0	37	344	162	182
PCT7554	ED	168	216	0	0	20	196	89	107
PCT7554	TO	821	597	0	0	57	540	251	289
PCT7555	MV	662	416	0	0	52	364	197	167
PCT7555	ED	210	244	0	0	29	215	116	99
PCT7555	TO	872	660	0	0	81	579	313	266
PCT7556	MV	812	513	0	0	42	471	225	246
PCT7556	ED	154	214	0	0	30	184	95	89
PCT7556	TO	966	727	0	0	72	655	320	335
PCT7601	MV	485	207	0	0	21	186	124	62
PCT7601	ED	192	112	0	0	14	98	73	25
PCT7601	TO	677	319	0	0	35	284	197	87
PCT7602	MV	654	276	0	0	25	251	168	83
PCT7602	ED	232	128	0	0	15	113	83	30
PCT7602	TO	886	404	0	0	40	364	251	113
PCT7603	MV	615	295	0	0	31	264	186	78
PCT7603	ED	200	174	0	0	16	158	117	41
PCT7603	TO	815	469	0	0	47	422	303	119
PCT7604	MV	685	270	0	0	20	250	192	58
PCT7604	ED	259	164	0	0	30	134	104	30
PCT7604	TO	944	434	0	0	50	384	296	88
PCT7605	MV	468	192	0	0	24	168	111	57
PCT7605	ED	193	84	0	0	9	75	58	17
PCT7605	TO	661	276	0	0	33	243	169	74
PCT7606	MV	673	267	0	0	34	233	157	76
PCT7606	ED	210	99	0	0	8	91	71	20
PCT7606	TO	883	366	0	0	42	324	228	96
PCT7607	MV	712	288	0	0	21	267	178	89
PCT7607	ED	207	127	0	0	9	118	81	37
PCT7607	TO	919	415	0	0	30	385	259	126
PCT7608	MV	279	96	0	0	11	85	57	28
PCT7608	ED	101	26	0	0	1	25	19	6
PCT7608	TO	380	122	0	0	12	110	76	34
PCT7609	MV	699	286	0	0	38	248	176	72
PCT7609	ED	185	69	0	0	11	58	46	12
PCT7609	TO	884	355	0	0	49	306	222	84
PCT7611	MV	586	235	0	0	21	214	164	50
PCT7611	ED	202	47	0	0	4	43	37	6
PCT7611	TO	788	282	0	0	25	257	201	56
PCT7612	MV	452	216	0	1	16	199	120	79
PCT7612	ED	105	47	0	0	6	41	27	14
PCT7612	TO	557	263	0	1	22	240	147	93
PCT7613	MV	634	244	0	0	23	221	154	67
PCT7613	ED	249	107	0	0	11	96	77	19
PCT7613	TO	883	351	0	0	34	317	231	86
PCT7614	MV	713	254	0	0	30	224	149	75
PCT7614	ED	203	114	0	0	10	104	74	30
PCT7614	TO	916	368	0	0	40	328	223	105
PCT7615	MV	510	165	0	0	17	148	103	45
PCT7615	ED	240	81	0	0	9	72	59	13
PCT7615	TO	750	246	0	0	26	220	162	58
PCT7616	MV	754	330	0	1	41	288	114	174
PCT7616	ED	82	144	0	0	22	122	62	60
PCT7616	TO	836	474	0	1	63	410	176	234
PCT7617	MV	583	222	0	0	32	190	137	53
PCT7617	ED	169	67	0	0	13	54	39	15
PCT7617	TO	752	289	0	0	45	244	176	68
PCT7618	MV	763	365	0	0	22	343	196	147
PCT7618	ED	151	114	0	0	15	99	54	45
PCT7618	TO	914	479	0	0	37	442	250	192
PCT7619	MV	937	439	0	0	38	401	217	184
PCT7619	ED	170	169	0	0	23	146	91	55
PCT7619	TO	1107	608	0	0	61	547	308	239
PCT7621	MV	1006	443	0	0	36	407	222	185
PCT7621	ED	149	150	0	0	21	129	80	49
PCT7621	TO	1155	593	0	0	57	536	302	234
PCT7622	MV	697	215	0	0	16	199	127	72
PCT7622	ED	263	98	0	0	14	84	61	23
PCT7622	TO	960	313	0	0	30	283	188	95
PCT7623	MV	767	256	0	1	25	230	156	74
PCT7623	ED	237	143	0	0	20	123	94	29
PCT7623	TO	1004	399	0	1	45	353	250	103
PCT7624	MV	652	209	0	0	21	188	116	72
PCT7624	ED	223	97	0	0	15	82	60	22
PCT7624	TO	875	306	0	0	36	270	176	94
PCT7625	MV	749	394	0	0	64	330	212	118
PCT7625	ED	73	39	0	0	1	38	26	12
PCT7625	TO	822	433	0	0	65	368	238	130
PCT7626	MV	944	401	0	0	48	353	129	224
PCT7626	ED	129	134	0	0	15	119	57	62
PCT7626	TO	1073	535	0	0	63	472	186	286
PCT7627	MV	457	196	0	0	20	176	59	117
PCT7627	ED	67	65	0	0	10	55	23	32
PCT7627	TO	524	261	0	0	30	231	82	149
PCT7628	MV	718	332	0	0	24	308	195	113
PCT7628	ED	220	156	0	0	16	140	90	50
PCT7628	TO	938	488	0	0	40	448	285	163
PCT7629	MV	691	276	0	0	26	250	155	95
PCT7629	ED	162	131	0	0	14	117	74	43
PCT7629	TO	853	407	0	0	40	367	229	138
PCT7631	MV	1009	441	0	1	39	401	212	189
PCT7631	ED	210	159	0	0	18	141	85	56
PCT7631	TO	1219	600	0	1	57	542	297	245
PCT7632	MV	1002	414	0	1	29	384	223	161
PCT7632	ED	169	188	0	0	18	170	104	66
PCT7632	TO	1171	602	0	1	47	554	327	227
PCT7633	MV	609	278	0	0	26	252	145	107
PCT7633	ED	126	108	0	0	15	93	51	42
PCT7633	TO	735	386	0	0	41	345	196	149
PCT7634	MV	704	344	0	0	48	296	179	117
PCT7634	ED	186	143	0	0	27	116	73	43
PCT7634	TO	890	487	0	0	75	412	252	160
PCT7635	MV	665	274	0	0	19	255	116	139
PCT7635	ED	188	83	0	0	10	73	34	39
PCT7635	TO	853	357	0	0	29	328	150	178
PCT7636	MV	798	330	0	0	31	299	142	157
PCT7636	ED	161	155	0	0	21	134	71	63
PCT7636	TO	959	485	0	0	52	433	213	220
PCT7637	MV	747	344	0	0	40	304	111	193
PCT7637	ED	121	145	0	0	26	119	50	69
PCT7637	TO	868	489	0	0	66	423	161	262
PCT7638	MV	806	372	0	0	48	324	120	204
PCT7638	ED	83	132	0	0	15	117	35	82
PCT7638	TO	889	504	0	0	63	441	155	286
PCT7639	MV	889	396	0	0	40	356	144	212
PCT7639	ED	133	154	0	0	32	122	56	66
PCT7639	TO	1022	550	0	0	72	478	200	278
PCT7641	MV	817	400	0	0	29	371	160	211
PCT7641	ED	134	141	0	0	12	129	63	66
PCT7641	TO	951	541	0	0	41	500	223	277
PCT7642	MV	647	311	0	0	44	267	144	123
PCT7642	ED	118	129	0	1	27	101	65	36
PCT7642	TO	765	440	0	1	71	368	209	159
PCT7643	MV	810	433	0	0	34	399	224	175
PCT7643	ED	131	115	0	0	19	96	52	44
PCT7643	TO	941	548	0	0	53	495	276	219
PCT7644	MV	1014	404	0	0	48	356	160	196
PCT7644	ED	162	186	0	0	21	165	115	50
PCT7644	TO	1176	590	0	0	69	521	275	246
PCT7645	MV	595	286	0	0	26	260	97	163
PCT7645	ED	61	96	0	0	14	82	46	36
PCT7645	TO	656	382	0	0	40	342	143	199
PCT7646	MV	1032	485	0	0	54	431	193	238
PCT7646	ED	121	179	0	0	38	141	88	53
PCT7646	TO	1153	664	0	0	92	572	281	291
PCT7647	MV	724	211	0	0	9	202	153	49
PCT7647	ED	263	117	0	0	8	109	82	27
PCT7647	TO	987	328	0	0	17	311	235	76
PCT7648	MV	2	1	0	0	1	0	0	0
PCT7648	TO	2	1	0	0	1	0	0	0
PCT7649	MV	723	286	0	0	18	268	142	126
PCT7649	ED	177	108	0	0	12	96	64	32
PCT7649	TO	900	394	0	0	30	364	206	158
PCT7651	MV	834	332	0	0	37	295	127	168
PCT7651	ED	113	110	0	0	13	97	32	65
PCT7651	TO	947	442	0	0	50	392	159	233
PCT7652	MV	535	208	0	0	23	185	89	96
PCT7652	ED	100	98	0	0	10	88	52	36
PCT7652	TO	635	306	0	0	33	273	141	132
PCT7653	MV	750	335	0	0	48	287	133	154
PCT7653	ED	89	95	0	1	11	83	35	48
PCT7653	TO	839	430	0	1	59	370	168	202
PCT7654	MV	413	191	0	0	13	178	92	86
PCT7654	ED	53	91	0	0	15	76	47	29
PCT7654	TO	466	282	0	0	28	254	139	115
PCT7655	MV	583	215	0	0	18	197	89	108
PCT7655	ED	96	84	0	0	19	65	27	38
PCT7655	TO	679	299	0	0	37	262	116	146
PCT7656	MV	603	308	0	0	37	271	65	206
PCT7656	ED	35	67	0	0	14	53	13	40
PCT7656	TO	638	375	0	0	51	324	78	246
PCT7657	MV	561	269	0	1	31	237	76	161
PCT7657	ED	37	89	0	0	14	75	37	38
PCT7657	TO	598	358	0	1	45	312	113	199
PCT7701	MV	868	481	0	0	55	426	247	179
PCT7701	ED	196	175	0	0	21	154	90	64
PCT7701	TO	1064	656	0	0	76	580	337	243
PCT7702	MV	623	377	0	0	29	348	148	200
PCT7702	ED	133	107	0	0	7	100	52	48
PCT7702	TO	756	484	0	0	36	448	200	248
PCT7703	MV	187	71	0	0	7	64	51	13
PCT7703	ED	-13	0	0	0	0	0	0	0
PCT7703	TO	174	71	0	0	7	64	51	13
PCT7704	MV	798	490	0	0	47	443	186	257
PCT7704	ED	204	175	0	0	11	164	65	99
PCT7704	TO	1002	665	0	0	58	607	251	356
PCT7705	MV	470	285	0	0	19	266	108	158
PCT7705	ED	125	110	0	0	13	97	40	57
PCT7705	TO	595	395	0	0	32	363	148	215
PCT7706	MV	687	447	0	0	40	407	196	211
PCT7706	ED	179	163	0	0	15	148	59	89
PCT7706	TO	866	610	0	0	55	555	255	300
PCT7707	MV	683	432	0	0	40	392	185	207
PCT7707	ED	189	179	0	0	12	167	76	91
PCT7707	TO	872	611	0	0	52	559	261	298
PCT7708	MV	710	462	0	0	52	410	187	223
PCT7708	ED	165	154	0	0	18	136	69	67
PCT7708	TO	875	616	0	0	70	546	256	290
PCT7709	MV	324	194	0	0	13	181	99	82
PCT7709	ED	82	90	0	0	6	84	53	31
PCT7709	TO	406	284	0	0	19	265	152	113
PCT7711	MV	658	379	0	0	39	340	169	171
PCT7711	ED	153	126	0	0	9	117	70	47
PCT7711	TO	811	505	0	0	48	457	239	218
PCT7712	MV	425	258	0	0	17	241	137	104
PCT7712	ED	107	109	0	0	9	100	58	42
PCT7712	TO	532	367	0	0	26	341	195	146
PCT7801	MV	823	479	0	0	41	438	216	222
PCT7801	ED	151	196	0	0	18	178	90	88
PCT7801	TO	974	675	0	0	59	616	306	310
PCT7802	MV	646	402	0	0	37	365	191	174
PCT7802	ED	152	160	0	0	16	144	86	58
PCT7802	TO	798	562	0	0	53	509	277	232
PCT7803	MV	718	476	0	0	41	435	206	229
PCT7803	ED	113	129	0	0	16	113	65	48
PCT7803	TO	831	605	0	0	57	548	271	277
PCT7804	MV	734	463	0	0	60	403	208	195
PCT7804	ED	151	182	0	0	26	156	77	79
PCT7804	TO	885	645	0	0	86	559	285	274
PCT7805	MV	644	400	0	0	43	357	189	168
PCT7805	ED	156	157	0	0	16	141	98	43
PCT7805	TO	800	557	0	0	59	498	287	211
PCT7806	MV	602	361	0	1	36	324	169	155
PCT7806	ED	153	154	0	0	15	139	88	51
PCT7806	TO	755	515	0	1	51	463	257	206
PCT7807	MV	642	363	0	0	29	334	194	140
PCT7807	ED	185	176	0	0	20	156	105	51
PCT7807	TO	827	539	0	0	49	490	299	191
PCT7808	MV	525	296	0	0	31	265	156	109
PCT7808	ED	129	132	0	0	18	114	69	45
PCT7808	TO	654	428	0	0	49	379	225	154
PCT7809	MV	624	351	0	0	26	325	208	117
PCT7809	ED	140	137	0	0	9	128	85	43
PCT7809	TO	764	488	0	0	35	453	293	160
PCT7811	MV	582	311	0	0	30	281	173	108
PCT7811	ED	176	157	0	0	8	149	98	51
PCT7811	TO	758	468	0	0	38	430	271	159
PCT7812	MV	680	369	0	0	37	332	184	148
PCT7812	ED	217	168	0	0	19	149	98	51
PCT7812	TO	897	537	0	0	56	481	282	199
PCT7813	MV	843	483	0	0	29	454	293	161
PCT7813	ED	225	217	0	0	24	193	140	53
PCT7813	TO	1068	700	0	0	53	647	433	214
PCT7814	MV	660	281	0	0	24	257	177	80
PCT7814	ED	241	120	0	0	15	105	82	23
PCT7814	TO	901	401	0	0	39	362	259	103
PCT7815	MV	749	465	0	0	54	411	223	188
PCT7815	ED	168	181	0	0	16	165	106	59
PCT7815	TO	917	646	0	0	70	576	329	247
PCT7816	MV	724	472	0	0	43	429	221	208
PCT7816	ED	148	151	0	0	10	141	75	66
PCT7816	TO	872	623	0	0	53	570	296	274
PCT7817	MV	652	396	0	0	26	370	211	159
PCT7817	ED	186	185	0	0	15	170	107	63
PCT7817	TO	838	581	0	0	41	540	318	222
PCT7818	MV	668	393	0	0	26	367	206	161
PCT7818	ED	171	150	0	0	12	138	85	53
PCT7818	TO	839	543	0	0	38	505	291	214
PCT7819	MV	635	352	0	0	31	321	192	129
PCT7819	ED	139	91	0	0	8	83	56	27
PCT7819	TO	774	443	0	0	39	404	248	156
PCT7821	MV	806	519	0	0	37	482	258	224
PCT7821	ED	170	190	0	0	12	178	95	83
PCT7821	TO	976	709	0	0	49	660	353	307
PCT7822	MV	673	395	0	0	33	362	205	157
PCT7822	ED	219	224	0	0	28	196	120	76
PCT7822	TO	892	619	0	0	61	558	325	233
PCT7823	MV	706	410	0	0	35	375	209	166
PCT7823	ED	177	189	0	0	6	183	131	52
PCT7823	TO	883	599	0	0	41	558	340	218
PCT7824	MV	615	335	0	0	36	299	157	142
PCT7824	ED	153	158	0	0	19	139	90	49
PCT7824	TO	768	493	0	0	55	438	247	191
PCT7825	MV	457	252	0	0	22	230	138	92
PCT7825	ED	151	132	0	0	6	126	83	43
PCT7825	TO	608	384	0	0	28	356	221	135
PCT7826	MV	486	263	0	0	17	246	142	104
PCT7826	ED	204	163	0	0	15	148	98	50
PCT7826	TO	690	426	0	0	32	394	240	154
PCT7827	MV	607	318	0	0	27	291	177	114
PCT7827	ED	219	147	0	0	15	132	98	34
PCT7827	TO	826	465	0	0	42	423	275	148
PCT7828	MV	857	478	0	1	46	431	245	186
PCT7828	ED	171	183	0	0	23	160	93	67
PCT7828	TO	1028	661	0	1	69	591	338	253
PCT7829	MV	742	466	0	0	43	423	226	197
PCT7829	ED	149	151	0	0	8	143	87	56
PCT7829	TO	891	617	0	0	51	566	313	253
PCT7831	MV	763	485	0	0	52	433	210	223
PCT7831	ED	139	139	0	0	11	128	75	53
PCT7831	TO	902	624	0	0	63	561	285	276
PCT7832	MV	663	413	0	0	41	372	206	166
PCT7832	ED	118	128	0	0	9	119	70	49
PCT7832	TO	781	541	0	0	50	491	276	215
PCT7833	MV	587	343	0	0	28	315	176	139
PCT7833	ED	146	146	0	0	20	126	74	52
PCT7833	TO	733	489	0	0	48	441	250	191
PCT7834	MV	700	375	0	0	40	335	186	149
PCT7834	ED	194	179	0	0	22	157	104	53
PCT7834	TO	894	554	0	0	62	492	290	202
PCT7835	MV	721	428	0	0	30	398	221	177
PCT7835	ED	142	148	0	0	14	134	85	49
PCT7835	TO	863	576	0	0	44	532	306	226
PCT7836	MV	850	505	0	0	40	465	281	184
PCT7836	ED	193	171	0	0	11	160	96	64
PCT7836	TO	1043	676	0	0	51	625	377	248
PCT7837	MV	718	424	0	0	56	368	161	207
PCT7837	ED	205	202	0	0	23	179	97	82
PCT7837	TO	923	626	0	0	79	547	258	289
PCT7838	MV	752	493	0	0	48	445	219	226
PCT7838	ED	143	158	0	0	18	140	85	55
PCT7838	TO	895	651	0	0	66	585	304	281
PCT7839	MV	731	456	0	0	45	411	196	215
PCT7839	ED	130	140	0	0	15	125	63	62
PCT7839	TO	861	596	0	0	60	536	259	277
PCT7841	MV	752	458	0	0	42	416	225	191
PCT7841	ED	198	207	0	0	15	192	105	87
PCT7841	TO	950	665	0	0	57	608	330	278
PCT7842	MV	702	394	0	0	36	358	225	133
PCT7842	ED	177	155	0	0	9	146	87	59
PCT7842	TO	879	549	0	0	45	504	312	192
PCT7843	MV	546	295	0	0	22	273	163	110
PCT7843	ED	183	165	0	0	15	150	100	50
PCT7843	TO	729	460	0	0	37	423	263	160
PCT7844	MV	499	281	0	0	22	259	158	101
PCT7844	ED	152	137	0	0	14	123	85	38
PCT7844	TO	651	418	0	0	36	382	243	139
PCT7845	MV	676	405	0	0	38	367	191	176
PCT7845	ED	204	178	0	0	15	163	81	82
PCT7845	TO	880	583	0	0	53	530	272	258
PCT7846	MV	736	464	0	0	48	416	191	225
PCT7846	ED	172	171	0	0	24	147	78	69
PCT7846	TO	908	635	0	0	72	563	269	294
PCT7847	MV	698	429	0	0	60	369	215	154
PCT7847	ED	193	183	0	0	10	173	97	76
PCT7847	TO	891	612	0	0	70	542	312	230
PCT7848	MV	665	437	0	0	32	405	199	206
PCT7848	ED	182	169	0	0	23	146	78	68
PCT7848	TO	847	606	0	0	55	551	277	274
PCT7849	MV	729	443	0	1	39	403	200	203
PCT7849	ED	172	188	0	0	19	169	101	68
PCT7849	TO	901	631	0	1	58	572	301	271
PCT7851	MV	414	272	0	0	28	244	84	160
PCT7851	ED	112	85	0	0	14	71	15	56
PCT7851	TO	526	357	0	0	42	315	99	216
PCT7852	MV	533	350	0	0	42	308	155	153
PCT7852	ED	111	103	0	0	11	92	46	46
PCT7852	TO	644	453	0	0	53	400	201	199
PCT7853	MV	694	394	0	0	41	353	176	177
PCT7853	ED	161	139	0	0	11	128	60	68
PCT7853	TO	855	533	0	0	52	481	236	245
PCT7854	MV	703	430	0	1	46	383	183	200
PCT7854	ED	175	173	0	0	14	159	84	75
PCT7854	TO	878	603	0	1	60	542	267	275
PCT7855	MV	763	451	0	0	49	402	192	210
PCT7855	ED	211	204	0	0	25	179	95	84
PCT7855	TO	974	655	0	0	74	581	287	294
PCT7856	MV	643	376	0	0	27	349	181	168
PCT7856	ED	204	193	0	0	18	175	105	70
PCT7856	TO	847	569	0	0	45	524	286	238
PCT7857	MV	748	437	0	1	40	396	202	194
PCT7857	ED	158	156	0	0	13	143	83	60
PCT7857	TO	906	593	0	1	53	539	285	254
PCT7858	MV	622	349	0	0	34	315	191	124
PCT7858	ED	157	151	0	0	13	138	94	44
PCT7858	TO	779	500	0	0	47	453	285	168
PCT7859	MV	747	464	0	0	45	419	201	218
PCT7859	ED	152	167	0	0	21	146	82	64
PCT7859	TO	899	631	0	0	66	565	283	282
PCT7861	MV	699	432	0	1	36	395	200	195
PCT7861	ED	164	171	0	0	10	161	101	60
PCT7861	TO	863	603	0	1	46	556	301	255
PCT7862	MV	669	401	0	0	31	370	177	193
PCT7862	ED	195	198	0	0	14	184	101	83
PCT7862	TO	864	599	0	0	45	554	278	276
PCT7863	MV	693	373	0	0	35	338	203	135
PCT7863	ED	208	208	0	0	16	192	113	79
PCT7863	TO	901	581	0	0	51	530	316	214
PCT7864	MV	661	374	0	0	48	326	171	155
PCT7864	ED	153	157	0	0	17	140	87	53
PCT7864	TO	814	531	0	0	65	466	258	208
PCT7865	MV	677	408	0	1	48	359	195	164
PCT7865	ED	163	160	0	0	13	147	95	52
PCT7865	TO	840	568	0	1	61	506	290	216
PCT7866	MV	690	446	0	0	41	405	204	201
PCT7866	ED	158	143	0	0	14	129	63	66
PCT7866	TO	848	589	0	0	55	534	267	267
PCT7867	MV	766	470	0	0	42	428	232	196
PCT7867	ED	212	184	0	0	21	163	92	71
PCT7867	TO	978	654	0	0	63	591	324	267
PCT7868	MV	659	376	0	0	30	346	174	172
PCT7868	ED	217	162	0	0	22	140	84	56
PCT7868	TO	876	538	0	0	52	486	258	228
PCT7869	MV	683	441	0	0	31	410	211	199
PCT7869	ED	178	191	0	0	22	169	103	66
PCT7869	TO	861	632	0	0	53	579	314	265
PCT7871	MV	702	464	0	0	48	416	220	196
PCT7871	ED	200	157	0	0	12	145	70	75
PCT7871	TO	902	621	0	0	60	561	290	271
PCT7872	MV	675	420	0	0	37	383	184	199
PCT7872	ED	199	186	0	0	15	171	77	94
PCT7872	TO	874	606	0	0	52	554	261	293
PCT7873	MV	689	444	0	0	37	407	227	180
PCT7873	ED	202	214	0	0	19	195	117	78
PCT7873	TO	891	658	0	0	56	602	344	258
PCT7874	MV	370	191	0	0	17	174	102	72
PCT7874	ED	119	108	0	0	11	97	53	44
PCT7874	TO	489	299	0	0	28	271	155	116
PCT7875	MV	500	253	0	0	22	231	143	88
PCT7875	ED	147	115	0	0	6	109	69	40
PCT7875	TO	647	368	0	0	28	340	212	128
PCT7876	MV	462	257	0	0	32	225	131	94
PCT7876	ED	106	93	0	0	15	78	44	34
PCT7876	TO	568	350	0	0	47	303	175	128
PCT7901	MV	399	191	0	0	14	177	120	57
PCT7901	ED	150	67	0	0	1	66	47	19
PCT7901	TO	549	258	0	0	15	243	167	76
PCT7902	MV	680	290	0	0	17	273	171	102
PCT7902	ED	232	145	0	1	10	134	96	38
PCT7902	TO	912	435	0	1	27	407	267	140
PCT7903	MV	623	286	0	0	24	262	178	84
PCT7903	ED	229	125	0	0	9	116	86	30
PCT7903	TO	852	411	0	0	33	378	264	114
PCT7904	MV	680	299	0	0	24	275	181	94
PCT7904	ED	157	122	0	1	8	113	79	34
PCT7904	TO	837	421	0	1	32	388	260	128
PCT7905	MV	684	356	0	0	24	332	192	140
PCT7905	ED	191	183	0	0	11	172	111	61
PCT7905	TO	875	539	0	0	35	504	303	201
PCT7906	MV	599	283	0	0	17	266	160	106
PCT7906	ED	187	118	0	0	15	103	82	21
PCT7906	TO	786	401	0	0	32	369	242	127
PCT7907	MV	704	344	0	0	22	322	216	106
PCT7907	ED	238	165	0	0	16	149	105	44
PCT7907	TO	942	509	0	0	38	471	321	150
PCT7908	MV	752	366	0	0	28	338	211	127
PCT7908	ED	240	172	0	0	20	152	107	45
PCT7908	TO	992	538	0	0	48	490	318	172
PCT7909	MV	558	311	0	0	22	289	189	100
PCT7909	ED	185	141	0	0	6	135	95	40
PCT7909	TO	743	452	0	0	28	424	284	140
PCT7911	MV	666	322	0	0	27	295	179	116
PCT7911	ED	205	129	0	0	10	119	76	43
PCT7911	TO	871	451	0	0	37	414	255	159
PCT7912	MV	800	370	0	0	27	343	214	129
PCT7912	ED	259	182	0	0	25	157	108	49
PCT7912	TO	1059	552	0	0	52	500	322	178
PCT7913	MV	660	350	0	0	15	335	211	124
PCT7913	ED	263	216	0	0	12	204	136	68
PCT7913	TO	923	566	0	0	27	539	347	192
PCT7914	MV	715	390	0	0	39	351	226	125
PCT7914	ED	187	142	0	0	16	126	90	36
PCT7914	TO	902	532	0	0	55	477	316	161
PCT7915	MV	605	290	0	0	20	270	167	103
PCT7915	ED	238	183	0	0	7	176	132	44
PCT7915	TO	843	473	0	0	27	446	299	147
PCT7916	MV	639	335	0	0	25	310	190	120
PCT7916	ED	219	162	0	0	11	151	109	42
PCT7916	TO	858	497	0	0	36	461	299	162
PCT7917	MV	716	357	0	0	27	330	214	116
PCT7917	ED	271	187	0	0	6	181	142	39
PCT7917	TO	987	544	0	0	33	511	356	155
PCT7918	MV	597	297	0	0	20	277	175	102
PCT7918	ED	227	145	0	0	10	135	96	39
PCT7918	TO	824	442	0	0	30	412	271	141
PCT7919	MV	608	309	0	0	24	285	188	97
PCT7919	ED	258	177	0	0	11	166	124	42
PCT7919	TO	866	486	0	0	35	451	312	139
PCT7921	MV	682	310	0	0	18	292	192	100
PCT7921	ED	229	103	0	0	8	95	59	36
PCT7921	TO	911	413	0	0	26	387	251	136
PCT7922	MV	648	314	0	0	17	297	197	100
PCT7922	ED	210	157	0	0	14	143	105	38
PCT7922	TO	858	471	0	0	31	440	302	138
PCT7923	MV	666	337	0	1	19	317	198	119
PCT7923	ED	214	172	0	0	10	162	123	39
PCT7923	TO	880	509	0	1	29	479	321	158
PCT7924	MV	649	303	0	0	11	292	189	103
PCT7924	ED	202	126	0	0	8	118	81	37
PCT7924	TO	851	429	0	0	19	410	270	140
PCT7925	MV	434	225	0	0	19	206	121	85
PCT7925	ED	110	89	0	0	5	84	61	23
PCT7925	TO	544	314	0	0	24	290	182	108
PCT7926	MV	610	337	0	1	24	312	192	120
PCT7926	ED	178	150	0	0	16	134	80	54
PCT7926	TO	788	487	0	1	40	446	272	174
PCT7927	MV	580	335	0	0	33	302	179	123
PCT7927	ED	162	154	0	1	8	145	89	56
PCT7927	TO	742	489	0	1	41	447	268	179
PCT7928	MV	700	395	0	0	27	368	233	135
PCT7928	ED	217	208	0	0	13	195	126	69
PCT7928	TO	917	603	0	0	40	563	359	204
PCT7929	MV	678	424	0	0	35	389	221	168
PCT7929	ED	169	172	0	0	18	154	96	58
PCT7929	TO	847	596	0	0	53	543	317	226
PCT7931	MV	610	378	0	0	45	333	188	145
PCT7931	ED	141	150	0	0	15	135	78	57
PCT7931	TO	751	528	0	0	60	468	266	202
PCT7932	MV	443	277	0	0	27	250	136	114
PCT7932	ED	118	96	0	0	12	84	51	33
PCT7932	TO	561	373	0	0	39	334	187	147
PCT7933	MV	9	6	0	0	0	6	4	2
PCT7933	ED	-1	0	0	0	0	0	0	0
PCT7933	TO	8	6	0	0	0	6	4	2
PCT7934	MV	702	409	0	0	37	372	247	125
PCT7934	ED	182	156	0	0	21	135	106	29
PCT7934	TO	884	565	0	0	58	507	353	154
PCT7935	MV	716	436	0	0	37	399	242	157
PCT7935	ED	227	227	0	0	20	207	142	65
PCT7935	TO	943	663	0	0	57	606	384	222
PCT7936	MV	620	370	0	1	34	335	212	123
PCT7936	ED	236	221	0	0	15	206	131	75
PCT7936	TO	856	591	0	1	49	541	343	198
PCT7937	MV	698	406	0	0	41	365	239	126
PCT7937	ED	202	172	0	0	14	158	124	34
PCT7937	TO	900	578	0	0	55	523	363	160
PCT7938	MV	536	301	0	0	18	283	170	113
PCT7938	ED	215	121	0	0	9	112	80	32
PCT7938	TO	751	422	0	0	27	395	250	145
PCT7939	MV	481	289	0	0	23	266	173	93
PCT7939	ED	205	191	0	0	16	175	112	63
PCT7939	TO	686	480	0	0	39	441	285	156
PCT7941	MV	576	304	0	0	28	276	194	82
PCT7941	ED	196	173	0	0	16	157	86	71
PCT7941	TO	772	477	0	0	44	433	280	153
PCT7942	MV	658	333	0	0	26	307	194	113
PCT7942	ED	274	141	0	0	8	133	90	43
PCT7942	TO	932	474	0	0	34	440	284	156
PCT7943	MV	687	368	0	0	27	341	205	136
PCT7943	ED	213	158	0	0	14	144	85	59
PCT7943	TO	900	526	0	0	41	485	290	195
PCT7944	MV	584	342	0	0	40	302	184	118
PCT7944	ED	230	197	0	0	18	179	108	71
PCT7944	TO	814	539	0	0	58	481	292	189
PCT7945	MV	726	338	0	0	32	306	180	126
PCT7945	ED	228	85	0	0	9	76	55	21
PCT7945	TO	954	423	0	0	41	382	235	147
PCT7946	MV	779	366	0	0	25	341	178	163
PCT7946	ED	206	115	0	0	13	102	71	31
PCT7946	TO	985	481	0	0	38	443	249	194
PCT7947	MV	792	332	0	0	30	302	175	127
PCT7947	ED	194	95	0	0	6	89	57	32
PCT7947	TO	986	427	0	0	36	391	232	159
PCT7948	MV	730	373	0	0	34	339	186	153
PCT7948	ED	200	119	0	0	7	112	68	44
PCT7948	TO	930	492	0	0	41	451	254	197
PCT7949	MV	484	233	0	0	18	215	85	130
PCT7949	ED	106	57	0	0	10	47	26	21
PCT7949	TO	590	290	0	0	28	262	111	151
PCT7951	MV	731	366	0	0	31	335	154	181
PCT7951	ED	156	90	0	0	8	82	48	34
PCT7951	TO	887	456	0	0	39	417	202	215
PCT7952	MV	730	292	0	0	23	269	144	125
PCT7952	ED	182	86	0	0	12	74	42	32
PCT7952	TO	912	378	0	0	35	343	186	157
PCT7953	MV	669	331	0	0	33	298	134	164
PCT7953	ED	161	106	0	0	8	98	51	47
PCT7953	TO	830	437	0	0	41	396	185	211
PCT7955	MV	774	350	0	0	35	315	161	154
PCT7955	ED	173	101	0	0	12	89	45	44
PCT7955	TO	947	451	0	0	47	404	206	198
PCT7956	MV	699	267	0	0	21	246	146	100
PCT7956	ED	170	42	0	0	2	40	24	16
PCT7956	TO	869	309	0	0	23	286	170	116
PCT7957	MV	538	261	0	1	22	238	151	87
PCT7957	ED	135	85	0	0	11	74	45	29
PCT7957	TO	673	346	0	1	33	312	196	116
PCT7958	MV	320	104	0	0	6	98	58	40
PCT7958	ED	-23	0	0	0	0	0	0	0
PCT7958	TO	297	104	0	0	6	98	58	40
PCT7959	MV	541	230	0	0	24	206	131	75
PCT7959	ED	145	68	0	0	8	60	42	18
PCT7959	TO	686	298	0	0	32	266	173	93
PCT9001	MV	314	100	0	0	3	97	58	39
PCT9001	ED	-30	0	0	0	0	0	0	0
PCT9001	TO	284	100	0	0	3	97	58	39
PCT9101	MV	712	378	0	0	31	347	199	148
PCT9101	ED	201	195	0	0	21	174	105	69
PCT9101	TO	913	573	0	0	52	521	304	217
PCT9102	MV	788	393	0	0	37	356	200	156
PCT9102	ED	204	175	0	0	20	155	88	67
PCT9102	TO	992	568	0	0	57	511	288	223
PCT9103	MV	719	381	0	0	39	342	182	160
PCT9103	ED	238	194	0	0	25	169	94	75
PCT9103	TO	957	575	0	0	64	511	276	235
PCT9104	MV	810	382	0	0	40	342	199	143
PCT9104	ED	220	181	0	0	22	159	104	55
PCT9104	TO	1030	563	0	0	62	501	303	198
PCT9105	MV	719	413	0	0	33	380	192	188
PCT9105	ED	199	223	0	0	28	195	113	82
PCT9105	TO	918	636	0	0	61	575	305	270
PCT9106	MV	748	397	0	0	47	350	172	178
PCT9106	ED	198	225	0	0	29	196	115	81
PCT9106	TO	946	622	0	0	76	546	287	259
PCT9107	MV	636	305	0	0	34	271	172	99
PCT9107	ED	208	166	0	0	20	146	100	46
PCT9107	TO	844	471	0	0	54	417	272	145
PCT9108	MV	610	337	0	0	44	293	173	120
PCT9108	ED	200	143	0	0	13	130	83	47
PCT9108	TO	810	480	0	0	57	423	256	167
PCT9109	MV	672	300	0	0	33	267	143	124
PCT9109	ED	211	199	0	0	19	180	95	85
PCT9109	TO	883	499	0	0	52	447	238	209
PCT9111	MV	639	317	0	0	30	287	172	115
PCT9111	ED	195	170	0	0	27	143	91	52
PCT9111	TO	834	487	0	0	57	430	263	167
PCT9112	MV	742	351	0	0	44	307	179	128
PCT9112	ED	219	207	0	0	23	184	110	74
PCT9112	TO	961	558	0	0	67	491	289	202
PCT9113	MV	796	371	0	0	39	332	180	152
PCT9113	ED	208	245	0	0	31	214	118	96
PCT9113	TO	1004	616	0	0	70	546	298	248
PCT9114	MV	659	291	0	0	26	265	165	100
PCT9114	ED	231	184	0	0	27	157	109	48
PCT9114	TO	890	475	0	0	53	422	274	148
PCT9115	MV	699	322	0	0	31	291	184	107
PCT9115	ED	182	180	0	0	28	152	110	42
PCT9115	TO	881	502	0	0	59	443	294	149
PCT9116	MV	782	346	0	0	24	322	187	135
PCT9116	ED	179	181	0	0	23	158	104	54
PCT9116	TO	961	527	0	0	47	480	291	189
PCT9117	MV	629	328	0	0	33	295	148	147
PCT9117	ED	171	195	0	0	15	180	96	84
PCT9117	TO	800	523	0	0	48	475	244	231
PCT9118	MV	742	340	0	0	35	305	168	137
PCT9118	ED	242	228	0	0	29	199	135	64
PCT9118	TO	984	568	0	0	64	504	303	201
PCT9119	MV	703	387	0	0	33	354	180	174
PCT9119	ED	197	160	0	0	19	141	84	57
PCT9119	TO	900	547	0	0	52	495	264	231
PCT9121	MV	735	335	0	0	33	302	149	153
PCT9121	ED	218	185	0	0	21	164	98	66
PCT9121	TO	953	520	0	0	54	466	247	219
PCT9122	MV	775	364	0	0	32	332	181	151
PCT9122	ED	192	161	0	0	25	136	79	57
PCT9122	TO	967	525	0	0	57	468	260	208
PCT9123	MV	661	319	0	0	23	296	160	136
PCT9123	ED	191	190	0	0	30	160	95	65
PCT9123	TO	852	509	0	0	53	456	255	201
PCT9124	MV	736	351	0	0	21	330	180	150
PCT9124	ED	167	161	0	0	13	148	103	45
PCT9124	TO	903	512	0	0	34	478	283	195
PCT9125	MV	681	358	0	0	29	329	184	145
PCT9125	ED	188	154	0	0	16	138	77	61
PCT9125	TO	869	512	0	0	45	467	261	206
PCT9126	MV	819	385	0	0	46	339	165	174
PCT9126	ED	194	200	0	0	22	178	98	80
PCT9126	TO	1013	585	0	0	68	517	263	254
PCT9127	MV	748	382	0	0	53	329	172	157
PCT9127	ED	223	221	0	0	22	199	112	87
PCT9127	TO	971	603	0	0	75	528	284	244
PCT9128	MV	628	333	0	0	31	302	132	170
PCT9128	ED	190	196	0	0	22	174	99	75
PCT9128	TO	818	529	0	0	53	476	231	245
PCT9129	MV	587	272	0	0	22	250	151	99
PCT9129	ED	151	154	0	0	10	144	91	53
PCT9129	TO	738	426	0	0	32	394	242	152
PCT9131	MV	596	285	0	0	24	261	129	132
PCT9131	ED	138	154	0	0	19	135	86	49
PCT9131	TO	734	439	0	0	43	396	215	181
PCT9132	MV	627	262	0	0	37	225	144	81
PCT9132	ED	194	172	0	0	21	151	99	52
PCT9132	TO	821	434	0	0	58	376	243	133
PCT9133	MV	808	382	0	0	41	341	190	151
PCT9133	ED	209	214	0	0	16	198	110	88
PCT9133	TO	1017	596	0	0	57	539	300	239
PCT9134	MV	736	327	0	0	27	300	160	140
PCT9134	ED	155	106	0	0	12	94	56	38
PCT9134	TO	891	433	0	0	39	394	216	178
PCT9135	MV	640	305	0	0	27	278	160	118
PCT9135	ED	182	159	0	0	17	142	69	73
PCT9135	TO	822	464	0	0	44	420	229	191
PCT9136	MV	706	368	0	0	47	321	184	137
PCT9136	ED	212	165	0	0	20	145	98	47
PCT9136	TO	918	533	0	0	67	466	282	184
PCT9137	MV	806	389	0	0	41	348	205	143
PCT9137	ED	209	176	0	0	16	160	111	49
PCT9137	TO	1015	565	0	0	57	508	316	192
PCT9138	MV	770	398	0	0	33	365	193	172
PCT9138	ED	175	150	0	0	13	137	94	43
PCT9138	TO	945	548	0	0	46	502	287	215
PCT9139	MV	828	423	0	0	36	387	179	208
PCT9139	ED	190	178	0	0	23	155	84	71
PCT9139	TO	1018	601	0	0	59	542	263	279
PCT9141	MV	789	418	0	0	57	361	202	159
PCT9141	ED	184	173	0	0	17	156	89	67
PCT9141	TO	973	591	0	0	74	517	291	226
PCT9142	MV	747	364	0	0	29	335	207	128
PCT9142	ED	239	210	0	0	22	188	114	74
PCT9142	TO	986	574	0	0	51	523	321	202
PCT9143	MV	705	360	0	0	32	328	162	166
PCT9143	ED	209	172	0	0	12	160	83	77
PCT9143	TO	914	532	0	0	44	488	245	243
PCT9144	MV	767	376	0	0	35	341	193	148
PCT9144	ED	203	215	0	0	21	194	126	68
PCT9144	TO	970	591	0	0	56	535	319	216
PCT9145	MV	681	334	0	0	27	307	158	149
PCT9145	ED	194	178	0	0	14	164	90	74
PCT9145	TO	875	512	0	0	41	471	248	223
PCT9146	MV	725	353	0	0	39	314	195	119
PCT9146	ED	160	194	0	0	27	167	104	63
PCT9146	TO	885	547	0	0	66	481	299	182
PCT9147	MV	765	373	0	0	30	343	188	155
PCT9147	ED	225	211	0	0	22	189	118	71
PCT9147	TO	990	584	0	0	52	532	306	226
PCT9148	MV	779	397	0	0	35	362	191	171
PCT9148	ED	235	230	0	0	27	203	112	91
PCT9148	TO	1014	627	0	0	62	565	303	262
PCT9149	MV	813	385	0	0	31	354	194	160
PCT9149	ED	178	252	0	0	25	227	149	78
PCT9149	TO	991	637	0	0	56	581	343	238
PCT9151	MV	693	351	0	0	43	308	183	125
PCT9151	ED	168	116	0	0	7	109	58	51
PCT9151	TO	861	467	0	0	50	417	241	176
PCT9152	MV	550	196	0	0	18	178	113	65
PCT9152	ED	187	143	0	1	15	127	96	31
PCT9152	TO	737	339	0	1	33	305	209	96
PCT9201	MV	785	358	0	0	43	315	211	104
PCT9201	ED	186	228	0	0	23	205	141	64
PCT9201	TO	971	586	0	0	66	520	352	168
PCT9202	MV	819	368	0	1	54	313	160	153
PCT9202	ED	177	228	0	0	26	202	102	100
PCT9202	TO	996	596	0	1	80	515	262	253
PCT9203	MV	847	373	0	0	63	310	107	203
PCT9203	ED	155	191	0	0	30	161	75	86
PCT9203	TO	1002	564	0	0	93	471	182	289
PCT9204	MV	686	309	0	0	44	265	82	183
PCT9204	ED	176	198	0	1	33	164	61	103
PCT9204	TO	862	507	0	1	77	429	143	286
PCT9205	MV	621	288	0	0	41	247	105	142
PCT9205	ED	115	154	0	0	27	127	59	68
PCT9205	TO	736	442	0	0	68	374	164	210
PCT9206	MV	741	351	0	0	42	309	106	203
PCT9206	ED	188	194	0	0	41	153	59	94
PCT9206	TO	929	545	0	0	83	462	165	297
PCT9207	MV	824	370	0	0	38	332	148	184
PCT9207	ED	165	194	0	0	30	164	66	98
PCT9207	TO	989	564	0	0	68	496	214	282
PCT9208	MV	808	357	0	1	47	309	125	184
PCT9208	ED	179	179	0	0	25	154	66	88
PCT9208	TO	987	536	0	1	72	463	191	272
PCT9209	MV	615	276	0	0	31	245	90	155
PCT9209	ED	156	172	0	1	37	134	58	76
PCT9209	TO	771	448	0	1	68	379	148	231
PCT9211	MV	730	314	0	0	42	272	123	149
PCT9211	ED	161	155	0	0	24	131	48	83
PCT9211	TO	891	469	0	0	66	403	171	232
PCT9212	MV	671	284	0	1	35	248	99	149
PCT9212	ED	137	175	0	0	40	135	60	75
PCT9212	TO	808	459	0	1	75	383	159	224
PCT9213	MV	776	350	0	0	42	308	146	162
PCT9213	ED	161	200	0	0	36	164	83	81
PCT9213	TO	937	550	0	0	78	472	229	243
PCT9214	MV	517	236	0	0	22	214	97	117
PCT9214	ED	110	136	0	0	28	108	33	75
PCT9214	TO	627	372	0	0	50	322	130	192
PCT9215	MV	524	246	0	0	23	223	93	130
PCT9215	ED	120	131	0	0	21	110	35	75
PCT9215	TO	644	377	0	0	44	333	128	205
PCT9216	MV	669	264	0	0	42	222	85	137
PCT9216	ED	155	173	0	0	23	150	78	72
PCT9216	TO	824	437	0	0	65	372	163	209
PCT9217	MV	588	268	0	0	22	246	110	136
PCT9217	ED	117	134	0	0	12	122	57	65
PCT9217	TO	705	402	0	0	34	368	167	201
PCT9218	MV	652	278	0	0	34	244	111	133
PCT9218	ED	164	160	0	0	18	142	61	81
PCT9218	TO	816	438	0	0	52	386	172	214
PCT9219	MV	646	288	0	0	41	247	128	119
PCT9219	ED	144	172	0	0	26	146	82	64
PCT9219	TO	790	460	0	0	67	393	210	183
PCT9221	MV	562	322	0	0	27	295	85	210
PCT9221	ED	89	140	0	0	23	117	30	87
PCT9221	TO	651	462	0	0	50	412	115	297
PCT9222	MV	773	373	0	0	41	332	109	223
PCT9222	ED	137	176	0	0	27	149	56	93
PCT9222	TO	910	549	0	0	68	481	165	316
PCT9223	MV	558	266	0	0	28	238	78	160
PCT9223	ED	109	115	0	0	17	98	34	64
PCT9223	TO	667	381	0	0	45	336	112	224
PCT9224	MV	768	380	0	0	35	345	135	210
PCT9224	ED	181	168	0	0	29	139	56	83
PCT9224	TO	949	548	0	0	64	484	191	293
PCT9225	MV	757	303	0	0	38	265	121	144
PCT9225	ED	169	219	0	0	33	186	87	99
PCT9225	TO	926	522	0	0	71	451	208	243
PCT9226	MV	741	355	0	0	48	307	113	194
PCT9226	ED	155	179	0	0	23	156	77	79
PCT9226	TO	896	534	0	0	71	463	190	273
PCT9227	MV	605	372	0	0	43	329	111	218
PCT9227	ED	124	149	0	0	10	139	53	86
PCT9227	TO	729	521	0	0	53	468	164	304
PCT9228	MV	578	314	0	0	27	287	93	194
PCT9228	ED	160	180	0	0	29	151	56	95
PCT9228	TO	738	494	0	0	56	438	149	289
PCT9229	MV	460	257	0	0	33	224	90	134
PCT9229	ED	119	122	0	0	15	107	40	67
PCT9229	TO	579	379	0	0	48	331	130	201
PCT9231	MV	726	352	0	0	35	317	139	178
PCT9231	ED	236	264	0	0	35	229	122	107
PCT9231	TO	962	616	0	0	70	546	261	285
PCT9232	MV	608	293	0	0	34	259	93	166
PCT9232	ED	126	157	0	0	17	140	63	77
PCT9232	TO	734	450	0	0	51	399	156	243
PCT9233	MV	668	332	0	0	45	287	83	204
PCT9233	ED	150	188	0	0	32	156	52	104
PCT9233	TO	818	520	0	0	77	443	135	308
PCT9234	MV	643	319	0	0	27	292	124	168
PCT9234	ED	91	145	0	0	26	119	48	71
PCT9234	TO	734	464	0	0	53	411	172	239
PCT9235	MV	703	365	0	1	38	326	93	233
PCT9235	ED	160	195	0	0	23	172	66	106
PCT9235	TO	863	560	0	1	61	498	159	339
PCT9236	MV	537	283	0	0	27	256	109	147
PCT9236	ED	136	137	0	0	23	114	41	73
PCT9236	TO	673	420	0	0	50	370	150	220
PCT9237	MV	779	395	0	2	42	351	127	224
PCT9237	ED	118	183	0	0	28	155	71	84
PCT9237	TO	897	578	0	2	70	506	198	308
PCT9238	MV	687	330	0	0	41	289	101	188
PCT9238	ED	118	174	0	0	30	144	65	79
PCT9238	TO	805	504	0	0	71	433	166	267
PCT9239	MV	740	391	0	0	58	333	126	207
PCT9239	ED	124	161	0	0	29	132	55	77
PCT9239	TO	864	552	0	0	87	465	181	284
PCT9241	MV	819	403	0	0	42	361	146	215
PCT9241	ED	141	196	0	0	26	170	72	98
PCT9241	TO	960	599	0	0	68	531	218	313
PCT9242	MV	771	349	0	0	46	303	131	172
PCT9242	ED	172	215	0	0	36	179	97	82
PCT9242	TO	943	564	0	0	82	482	228	254
PCT9243	MV	480	242	0	0	31	211	89	122
PCT9243	ED	123	141	0	0	21	120	65	55
PCT9243	TO	603	383	0	0	52	331	154	177
PCT9244	MV	756	396	0	0	59	337	143	194
PCT9244	ED	154	186	0	0	23	163	89	74
PCT9244	TO	910	582	0	0	82	500	232	268
PCT9245	MV	616	300	0	0	43	257	114	143
PCT9245	ED	98	129	0	0	16	113	55	58
PCT9245	TO	714	429	0	0	59	370	169	201
PCT9246	MV	815	430	0	0	41	389	170	219
PCT9246	ED	155	196	0	0	33	163	73	90
PCT9246	TO	970	626	0	0	74	552	243	309
PCT9247	MV	764	381	0	0	37	344	159	185
PCT9247	ED	148	205	0	0	35	170	89	81
PCT9247	TO	912	586	0	0	72	514	248	266
PCT9248	MV	757	358	0	0	41	317	165	152
PCT9248	ED	150	192	0	0	28	164	98	66
PCT9248	TO	907	550	0	0	69	481	263	218
PCT9249	MV	724	379	0	0	46	333	160	173
PCT9249	ED	191	214	0	0	23	191	92	99
PCT9249	TO	915	593	0	0	69	524	252	272
PCT9251	MV	792	392	0	0	48	344	162	182
PCT9251	ED	174	236	0	0	33	203	100	103
PCT9251	TO	966	628	0	0	81	547	262	285
PCT9252	MV	811	382	0	0	44	338	164	174
PCT9252	ED	142	179	0	0	13	166	86	80
PCT9252	TO	953	561	0	0	57	504	250	254
PCT9253	MV	599	300	0	0	28	272	113	159
PCT9253	ED	162	150	0	0	19	131	81	50
PCT9253	TO	761	450	0	0	47	403	194	209
PCT9254	MV	758	415	0	0	38	377	170	207
PCT9254	ED	163	197	0	0	34	163	91	72
PCT9254	TO	921	612	0	0	72	540	261	279
PCT9255	MV	436	196	0	0	32	164	87	77
PCT9255	ED	114	135	0	0	22	113	63	50
PCT9255	TO	550	331	0	0	54	277	150	127
PCT9256	MV	367	169	0	0	17	152	75	77
PCT9256	ED	95	119	0	0	13	106	58	48
PCT9256	TO	462	288	0	0	30	258	133	125
PCT9257	MV	359	162	0	0	21	141	97	44
PCT9257	ED	-39	13	0	0	2	11	8	3
PCT9257	TO	320	175	0	0	23	152	105	47
PCT9258	MV	583	307	0	0	33	274	137	137
PCT9258	ED	120	148	0	0	20	128	73	55
PCT9258	TO	703	455	0	0	53	402	210	192
PCT9401	MV	796	358	0	0	27	331	221	110
PCT9401	ED	242	226	0	0	24	202	152	50
PCT9401	TO	1038	584	0	0	51	533	373	160
PCT9402	MV	775	377	0	0	37	340	212	128
PCT9402	ED	242	207	0	0	22	185	124	61
PCT9402	TO	1017	584	0	0	59	525	336	189
PCT9403	MV	731	348	0	0	21	327	193	134
PCT9403	ED	190	168	0	0	18	150	106	44
PCT9403	TO	921	516	0	0	39	477	299	178
PCT9404	MV	753	345	0	0	28	317	172	145
PCT9404	ED	191	197	0	0	29	168	108	60
PCT9404	TO	944	542	0	0	57	485	280	205
PCT9405	MV	629	276	0	1	34	241	128	113
PCT9405	ED	151	131	0	0	6	125	78	47
PCT9405	TO	780	407	0	1	40	366	206	160
PCT9406	MV	695	330	0	0	31	299	168	131
PCT9406	ED	188	169	0	0	17	152	81	71
PCT9406	TO	883	499	0	0	48	451	249	202
PCT9407	MV	712	368	0	0	32	336	183	153
PCT9407	ED	201	174	0	0	30	144	87	57
PCT9407	TO	913	542	0	0	62	480	270	210
PCT9408	MV	711	321	0	0	36	285	185	100
PCT9408	ED	152	171	0	0	14	157	107	50
PCT9408	TO	863	492	0	0	50	442	292	150
PCT9409	MV	443	226	0	0	25	201	119	82
PCT9409	ED	158	146	0	0	11	135	95	40
PCT9409	TO	601	372	0	0	36	336	214	122
PCT9411	MV	816	378	0	0	37	341	227	114
PCT9411	ED	191	212	0	0	24	188	133	55
PCT9411	TO	1007	590	0	0	61	529	360	169
PCT9412	MV	668	339	0	0	31	308	162	146
PCT9412	ED	202	186	0	0	20	166	98	68
PCT9412	TO	870	525	0	0	51	474	260	214
PCT9413	MV	757	375	0	0	51	324	180	144
PCT9413	ED	179	170	0	0	22	148	97	51
PCT9413	TO	936	545	0	0	73	472	277	195
PCT9414	MV	734	361	0	0	44	317	164	153
PCT9414	ED	186	142	0	0	16	126	68	58
PCT9414	TO	920	503	0	0	60	443	232	211
PCT9415	MV	634	315	0	0	24	291	144	147
PCT9415	ED	154	135	0	0	9	126	84	42
PCT9415	TO	788	450	0	0	33	417	228	189
PCT9416	MV	769	391	0	0	55	336	166	170
PCT9416	ED	230	151	0	0	14	137	73	64
PCT9416	TO	999	542	0	0	69	473	239	234
PCT9417	MV	629	321	0	0	34	287	147	140
PCT9417	ED	145	125	0	0	9	116	67	49
PCT9417	TO	774	446	0	0	43	403	214	189
PCT9418	MV	631	310	0	0	34	276	122	154
PCT9418	ED	188	141	0	0	13	128	80	48
PCT9418	TO	819	451	0	0	47	404	202	202
PCT9419	MV	736	369	0	0	38	331	137	194
PCT9419	ED	173	140	0	0	14	126	56	70
PCT9419	TO	909	509	0	0	52	457	193	264
PCT9421	MV	752	338	0	0	34	304	138	166
PCT9421	ED	173	154	0	0	14	140	76	64
PCT9421	TO	925	492	0	0	48	444	214	230
PCT9422	MV	831	413	0	0	43	370	194	176
PCT9422	ED	270	209	0	0	27	182	109	73
PCT9422	TO	1101	622	0	0	70	552	303	249
PCT9423	MV	714	316	0	0	33	283	143	140
PCT9423	ED	190	158	0	0	18	140	82	58
PCT9423	TO	904	474	0	0	51	423	225	198
PCT9424	MV	799	385	0	0	39	346	172	174
PCT9424	ED	210	154	0	0	19	135	80	55
PCT9424	TO	1009	539	0	0	58	481	252	229
PCT9425	MV	789	346	0	0	48	298	158	140
PCT9425	ED	187	171	0	0	24	147	94	53
PCT9425	TO	976	517	0	0	72	445	252	193
PCT9426	MV	697	324	0	0	31	293	139	154
PCT9426	ED	156	139	0	0	22	117	58	59
PCT9426	TO	853	463	0	0	53	410	197	213
PCT9427	MV	799	383	0	0	33	350	151	199
PCT9427	ED	188	149	0	0	25	124	68	56
PCT9427	TO	987	532	0	0	58	474	219	255
PCT9428	MV	811	351	0	0	36	315	159	156
PCT9428	ED	179	144	0	0	18	126	77	49
PCT9428	TO	990	495	0	0	54	441	236	205
PCT9429	MV	709	343	0	0	34	309	141	168
PCT9429	ED	197	146	0	0	23	123	64	59
PCT9429	TO	906	489	0	0	57	432	205	227
PCT9431	MV	832	412	0	0	45	367	151	216
PCT9431	ED	204	171	0	0	13	158	89	69
PCT9431	TO	1036	583	0	0	58	525	240	285
PCT9432	MV	743	358	0	0	45	313	159	154
PCT9432	ED	215	136	0	0	19	117	60	57
PCT9432	TO	958	494	0	0	64	430	219	211
PCT9433	MV	794	373	0	0	45	328	156	172
PCT9433	ED	164	124	0	0	11	113	51	62
PCT9433	TO	958	497	0	0	56	441	207	234
PCT9434	MV	785	387	0	0	40	347	172	175
PCT9434	ED	227	210	0	0	28	182	111	71
PCT9434	TO	1012	597	0	0	68	529	283	246
PCT9435	MV	779	366	0	0	39	327	155	172
PCT9435	ED	225	186	0	0	15	171	114	57
PCT9435	TO	1004	552	0	0	54	498	269	229
PCT9436	MV	842	386	0	0	29	357	152	205
PCT9436	ED	226	149	0	0	17	132	65	67
PCT9436	TO	1068	535	0	0	46	489	217	272
PCT9437	MV	736	376	0	0	33	343	159	184
PCT9437	ED	191	149	0	0	14	135	86	49
PCT9437	TO	927	525	0	0	47	478	245	233
PCT9438	MV	837	419	0	0	37	382	170	212
PCT9438	ED	152	108	0	0	9	99	56	43
PCT9438	TO	989	527	0	0	46	481	226	255
PCT9439	MV	718	343	0	0	26	317	134	183
PCT9439	ED	199	141	0	0	22	119	67	52
PCT9439	TO	917	484	0	0	48	436	201	235
PCT9441	MV	778	396	0	0	43	353	207	146
PCT9441	ED	193	166	0	0	23	143	91	52
PCT9441	TO	971	562	0	0	66	496	298	198
PCT9442	MV	830	379	0	0	45	334	188	146
PCT9442	ED	210	212	0	0	24	188	107	81
PCT9442	TO	1040	591	0	0	69	522	295	227
PCT9443	MV	759	362	0	0	35	327	178	149
PCT9443	ED	196	152	0	1	23	128	79	49
PCT9443	TO	955	514	0	1	58	455	257	198
PCT9444	MV	768	340	0	0	23	317	149	168
PCT9444	ED	197	134	0	0	18	116	72	44
PCT9444	TO	965	474	0	0	41	433	221	212
PCT9445	MV	829	406	0	0	41	365	176	189
PCT9445	ED	167	147	0	0	16	131	77	54
PCT9445	TO	996	553	0	0	57	496	253	243
PCT9446	MV	900	465	0	0	50	415	199	216
PCT9446	ED	216	178	0	0	20	158	84	74
PCT9446	TO	1116	643	0	0	70	573	283	290
PCT9447	MV	729	392	0	0	28	364	163	201
PCT9447	ED	192	181	0	0	18	163	90	73
PCT9447	TO	921	573	0	0	46	527	253	274
PCT9448	MV	742	347	0	0	32	315	156	159
PCT9448	ED	198	157	0	0	17	140	90	50
PCT9448	TO	940	504	0	0	49	455	246	209
PCT9449	MV	719	340	0	1	37	302	146	156
PCT9449	ED	162	119	0	1	11	107	54	53
PCT9449	TO	881	459	0	2	48	409	200	209
PCT9451	MV	353	178	0	0	17	161	74	87
PCT9451	ED	88	69	0	0	8	61	37	24
PCT9451	TO	441	247	0	0	25	222	111	111
PCT9452	MV	647	334	0	0	32	302	149	153
PCT9452	ED	195	186	0	0	20	166	78	88
PCT9452	TO	842	520	0	0	52	468	227	241
PCT9453	MV	409	217	0	0	19	198	83	115
PCT9453	ED	115	84	0	0	8	76	32	44
PCT9453	TO	524	301	0	0	27	274	115	159
PCT9501	MV	158	92	0	1	12	79	49	30
PCT9501	ED	-8	3	0	0	1	2	1	1
PCT9501	TO	150	95	0	1	13	81	50	31
PCT9502	MV	294	136	0	0	19	117	70	47
PCT9502	ED	-43	6	0	0	1	5	4	1
PCT9502	TO	251	142	0	0	20	122	74	48
PCT9503	MV	550	263	0	0	38	225	126	99
PCT9503	ED	150	122	0	0	16	106	65	41
PCT9503	TO	700	385	0	0	54	331	191	140
PCT9505	MV	589	296	0	0	34	262	177	85
PCT9505	ED	176	136	0	0	14	122	67	55
PCT9505	TO	765	432	0	0	48	384	244	140
PCT9506	MV	547	232	0	0	18	214	118	96
PCT9506	ED	207	138	0	0	16	122	88	34
PCT9506	TO	754	370	0	0	34	336	206	130
PCT9507	MV	556	306	0	1	29	276	163	113
PCT9507	ED	160	182	0	0	24	158	99	59
PCT9507	TO	716	488	0	1	53	434	262	172
PCT9508	MV	632	317	0	0	23	294	196	98
PCT9508	ED	148	185	0	0	27	158	99	59
PCT9508	TO	780	502	0	0	50	452	295	157
PCT9509	MV	585	296	0	0	22	274	147	127
PCT9509	ED	142	167	0	0	20	147	106	41
PCT9509	TO	727	463	0	0	42	421	253	168
PCT9511	MV	458	240	0	0	18	222	129	93
PCT9511	ED	176	163	0	0	20	143	89	54
PCT9511	TO	634	403	0	0	38	365	218	147
PCT9512	MV	617	327	0	0	33	294	181	113
PCT9512	ED	160	179	0	0	18	161	104	57
PCT9512	TO	777	506	0	0	51	455	285	170
PCT9513	MV	686	334	0	0	37	297	190	107
PCT9513	ED	191	188	0	0	21	167	115	52
PCT9513	TO	877	522	0	0	58	464	305	159
PCT9514	MV	713	352	0	0	41	311	175	136
PCT9514	ED	183	213	0	0	23	190	130	60
PCT9514	TO	896	565	0	0	64	501	305	196
PCT9515	MV	543	305	0	0	30	275	146	129
PCT9515	ED	169	164	0	0	22	142	82	60
PCT9515	TO	712	469	0	0	52	417	228	189
PCT9516	MV	705	366	0	0	30	336	205	131
PCT9516	ED	184	190	0	0	22	168	97	71
PCT9516	TO	889	556	0	0	52	504	302	202
PCT9517	MV	626	335	0	0	23	312	180	132
PCT9517	ED	162	173	0	0	27	146	107	39
PCT9517	TO	788	508	0	0	50	458	287	171
PCT9518	MV	642	316	0	0	28	288	182	106
PCT9518	ED	146	195	0	0	18	177	121	56
PCT9518	TO	788	511	0	0	46	465	303	162
PCT9519	MV	693	368	0	0	30	338	204	134
PCT9519	ED	198	239	0	0	27	212	130	82
PCT9519	TO	891	607	0	0	57	550	334	216
PCT9521	MV	687	352	0	0	28	324	187	137
PCT9521	ED	214	242	0	0	28	214	139	75
PCT9521	TO	901	594	0	0	56	538	326	212
PCT9701	MV	498	269	0	0	26	243	143	100
PCT9701	ED	156	139	0	0	11	128	80	48
PCT9701	TO	654	408	0	0	37	371	223	148
PCT9702	MV	554	305	0	0	25	280	146	134
PCT9702	ED	166	148	0	0	11	137	85	52
PCT9702	TO	720	453	0	0	36	417	231	186
PCT9703	MV	809	403	0	0	47	356	185	171
PCT9703	ED	182	147	0	0	14	133	75	58
PCT9703	TO	991	550	0	0	61	489	260	229
PCT9704	MV	760	422	0	0	45	377	171	206
PCT9704	ED	199	199	0	0	22	177	109	68
PCT9704	TO	959	621	0	0	67	554	280	274
PCT9705	MV	754	421	0	0	42	379	190	189
PCT9705	ED	175	146	0	0	15	131	79	52
PCT9705	TO	929	567	0	0	57	510	269	241
PCT9706	MV	57	34	0	0	2	32	16	16
PCT9706	ED	-8	0	0	0	0	0	0	0
PCT9706	TO	49	34	0	0	2	32	16	16
PCT9707	MV	687	358	0	0	25	333	139	194
PCT9707	ED	139	103	0	0	12	91	43	48
PCT9707	TO	826	461	0	0	37	424	182	242
PCT9708	MV	786	429	0	0	55	374	205	169
PCT9708	ED	175	159	0	0	15	144	87	57
PCT9708	TO	961	588	0	0	70	518	292	226
PCT9709	MV	831	427	0	0	47	380	165	215
PCT9709	ED	209	183	0	0	15	168	92	76
PCT9709	TO	1040	610	0	0	62	548	257	291
PCT9711	MV	502	307	0	0	34	273	133	140
PCT9711	ED	144	162	0	0	19	143	64	79
PCT9711	TO	646	469	0	0	53	416	197	219
PCT9712	MV	534	335	0	0	33	302	117	185
PCT9712	ED	127	118	0	0	7	111	52	59
PCT9712	TO	661	453	0	0	40	413	169	244
PCT9713	MV	747	389	0	0	31	358	160	198
PCT9713	ED	203	171	0	0	22	149	83	66
PCT9713	TO	950	560	0	0	53	507	243	264
PCT9714	MV	795	447	0	0	41	406	153	253
PCT9714	ED	156	137	0	0	8	129	60	69
PCT9714	TO	951	584	0	0	49	535	213	322
PCT9715	MV	449	241	0	0	28	213	65	148
PCT9715	ED	130	135	0	0	9	126	42	84
PCT9715	TO	579	376	0	0	37	339	107	232
PCT9716	MV	745	398	0	0	40	358	158	200
PCT9716	ED	221	167	0	0	18	149	74	75
PCT9716	TO	966	565	0	0	58	507	232	275
PCT9717	MV	753	437	0	0	38	399	152	247
PCT9717	ED	224	173	0	0	20	153	68	85
PCT9717	TO	977	610	0	0	58	552	220	332
PCT9718	MV	749	449	0	0	36	413	180	233
PCT9718	ED	152	145	0	0	12	133	56	77
PCT9718	TO	901	594	0	0	48	546	236	310
PCT9719	MV	747	463	0	0	41	422	159	263
PCT9719	ED	173	151	0	0	8	143	59	84
PCT9719	TO	920	614	0	0	49	565	218	347
PCT9721	MV	498	288	0	0	29	259	95	164
PCT9721	ED	164	135	0	0	8	127	47	80
PCT9721	TO	662	423	0	0	37	386	142	244
PCT9722	MV	513	315	0	0	25	290	126	164
PCT9722	ED	84	76	0	0	9	67	29	38
PCT9722	TO	597	391	0	0	34	357	155	202
PCT9723	MV	436	224	0	0	16	208	56	152
PCT9723	ED	72	46	0	0	4	42	11	31
PCT9723	TO	508	270	0	0	20	250	67	183
PCT9724	MV	851	451	0	0	38	413	126	287
PCT9724	ED	169	100	0	0	8	92	39	53
PCT9724	TO	1020	551	0	0	46	505	165	340
PCT9725	MV	814	437	0	0	35	402	163	239
PCT9725	ED	157	97	0	0	11	86	26	60
PCT9725	TO	971	534	0	0	46	488	189	299
PCT9726	MV	630	217	0	0	27	190	126	64
PCT9726	ED	-14	103	0	0	10	93	59	34
PCT9726	TO	616	320	0	0	37	283	185	98
PCT9727	MV	404	227	0	2	19	206	75	131
PCT9727	ED	56	35	0	0	5	30	9	21
PCT9727	TO	460	262	0	2	24	236	84	152
PCT9728	MV	751	446	0	0	35	411	116	295
PCT9728	ED	212	137	0	0	16	121	45	76
PCT9728	TO	963	583	0	0	51	532	161	371
PCT9729	MV	654	335	0	0	27	308	82	226
PCT9729	ED	164	131	0	0	6	125	39	86
PCT9729	TO	818	466	0	0	33	433	121	312
PCT9731	MV	436	245	0	0	24	221	75	146
PCT9731	ED	143	111	0	0	7	104	32	72
PCT9731	TO	579	356	0	0	31	325	107	218
PCT9732	MV	78	47	0	0	4	43	17	26
PCT9732	ED	-5	0	0	0	0	0	0	0
PCT9732	TO	73	47	0	0	4	43	17	26
PCT9733	MV	261	162	0	0	7	155	82	73
PCT9733	ED	-21	1	0	0	0	1	0	1
PCT9733	TO	240	163	0	0	7	156	82	74
PCT9734	MV	473	286	0	0	23	263	97	166
PCT9734	ED	131	110	0	0	10	100	34	66
PCT9734	TO	604	396	0	0	33	363	131	232
PCT9735	MV	650	386	0	0	32	354	140	214
PCT9735	ED	170	133	0	0	16	117	47	70
PCT9735	TO	820	519	0	0	48	471	187	284
PCT9736	MV	586	325	0	0	26	299	117	182
PCT9736	ED	150	155	0	0	14	141	64	77
PCT9736	TO	736	480	0	0	40	440	181	259
PCT9737	MV	637	388	0	0	37	351	164	187
PCT9737	ED	154	137	0	1	8	128	65	63
PCT9737	TO	791	525	0	1	45	479	229	250
PCT9738	MV	688	320	0	0	33	287	181	106
PCT9738	ED	150	66	0	0	5	61	31	30
PCT9738	TO	838	386	0	0	38	348	212	136
PCT9739	MV	674	270	0	0	15	255	181	74
PCT9739	ED	115	88	0	0	6	82	70	12
PCT9739	TO	789	358	0	0	21	337	251	86
PCT9741	MV	837	173	0	0	22	151	128	23
PCT9741	ED	-396	10	0	0	2	8	6	2
PCT9741	TO	441	183	0	0	24	159	134	25
PCT9742	MV	530	229	0	0	15	214	80	134
PCT9742	ED	165	101	0	0	9	92	41	51
PCT9742	TO	695	330	0	0	24	306	121	185
PCT9743	MV	913	400	0	0	32	368	220	148
PCT9743	ED	227	174	0	0	19	155	116	39
PCT9743	TO	1140	574	0	0	51	523	336	187
PCT9744	MV	783	333	0	0	40	293	190	103
PCT9744	ED	160	126	0	0	19	107	75	32
PCT9744	TO	943	459	0	0	59	400	265	135
PCT9745	MV	790	317	0	0	34	283	197	86
PCT9745	ED	202	129	0	0	12	117	81	36
PCT9745	TO	992	446	0	0	46	400	278	122
PCT9746	MV	714	373	0	0	18	355	147	208
PCT9746	ED	189	120	0	0	11	109	45	64
PCT9746	TO	903	493	0	0	29	464	192	272
PCT9747	MV	772	401	0	0	37	364	191	173
PCT9747	ED	204	146	0	0	13	133	68	65
PCT9747	TO	976	547	0	0	50	497	259	238
PCT9748	MV	746	425	0	0	39	386	179	207
PCT9748	ED	167	119	0	0	11	108	56	52
PCT9748	TO	913	544	0	0	50	494	235	259
PCT9749	MV	750	289	0	0	18	271	171	100
PCT9749	ED	188	109	0	0	9	100	64	36
PCT9749	TO	938	398	0	0	27	371	235	136
PCT9751	MV	857	472	0	0	47	425	193	232
PCT9751	ED	214	153	0	0	18	135	66	69
PCT9751	TO	1071	625	0	0	65	560	259	301
PCT9752	MV	563	328	0	0	25	303	141	162
PCT9752	ED	134	109	0	0	9	100	51	49
PCT9752	TO	697	437	0	0	34	403	192	211
PCT9753	MV	617	300	0	0	22	278	156	122
PCT9753	ED	145	123	0	0	3	120	67	53
PCT9753	TO	762	423	0	0	25	398	223	175
PCT9754	MV	545	317	0	0	25	292	181	111
PCT9754	ED	162	115	0	0	10	105	63	42
PCT9754	TO	707	432	0	0	35	397	244	153
PCT9755	MV	441	239	0	0	25	214	118	96
PCT9755	ED	139	99	0	0	7	92	42	50
PCT9755	TO	580	338	0	0	32	306	160	146
PCT9756	MV	805	364	0	0	33	331	167	164
PCT9756	ED	162	107	0	0	11	96	57	39
PCT9756	TO	967	471	0	0	44	427	224	203
PCT9801	MV	320	163	0	0	17	146	84	62
PCT9801	ED	88	53	0	0	6	47	24	23
PCT9801	TO	408	216	0	0	23	193	108	85
CONG12	MV	355594	174824	0	37	17233	157554	84268	73286
CONG12	ED	90254	77529	0	14	8862	68653	40789	27864
CONG12	TO	445848	252353	0	51	26095	226207	125057	101150
CONG14	MV	47252	22365	0	5	1892	20468	10314	10154
CONG14	ED	10799	7055	0	1	633	6421	3502	2919
CONG14	TO	58051	29420	0	6	2525	26889	13816	13073
ASSM17	MV	232787	114654	0	27	10975	103652	57308	46344
ASSM17	ED	59635	47539	0	9	5163	42367	26009	16358
ASSM17	TO	292422	162193	0	36	16138	146019	83317	62702
ASSM19	MV	170059	82535	0	15	8150	74370	37274	37096
ASSM19	ED	41418	37045	0	6	4332	32707	18282	14425
ASSM19	TO	211477	119580	0	21	12482	107077	55556	51521
SUPV1	MV	33868	16583	0	0	1620	14963	8248	6715
SUPV1	ED	9248	8645	0	1	968	7676	4654	3022
SUPV1	TO	43116	25228	0	1	2588	22639	12902	9737
SUPV2	MV	41435	19991	0	6	2348	17637	7461	10176
SUPV2	ED	8611	10358	0	2	1537	8819	4154	4665
SUPV2	TO	50046	30349	0	8	3885	26456	11615	14841
SUPV3	MV	31943	14432	0	3	1531	12898	6887	6011
SUPV3	ED	7434	6535	0	2	875	5658	3369	2289
SUPV3	TO	39377	20967	0	5	2406	18556	10256	8300
SUPV4	MV	35049	16883	0	2	1691	15190	7701	7489
SUPV4	ED	9045	7574	0	2	856	6716	3992	2724
SUPV4	TO	44094	24457	0	4	2547	21906	11693	10213
SUPV5	MV	41966	21520	0	5	2124	19391	11381	8010
SUPV5	ED	10934	11548	0	1	1364	10183	6513	3670
SUPV5	TO	52900	33068	0	6	3488	29574	17894	11680
SUPV6	MV	35755	15237	0	6	1535	13696	7410	6286
SUPV6	ED	7940	5858	0	2	781	5075	3114	1961
SUPV6	TO	43695	21095	0	8	2316	18771	10524	8247
SUPV7	MV	38887	20739	0	2	1878	18859	8828	10031
SUPV7	ED	8556	7372	0	1	665	6706	3385	3321
SUPV7	TO	47443	28111	0	3	2543	25565	12213	13352
SUPV8	MV	46370	27513	0	7	2563	24943	13420	11523
SUPV8	ED	11807	11215	0	0	1073	10142	6023	4119
SUPV8	TO	58177	38728	0	7	3636	35085	19443	15642
SUPV9	MV	33165	16788	0	4	1336	15448	9375	6073
SUPV9	ED	10098	7144	0	3	588	6553	4408	2145
SUPV9	TO	43263	23932	0	7	1924	22001	13783	8218
SUPV10	MV	33765	14063	0	4	1357	12702	6923	5779
SUPV10	ED	9348	4282	0	0	412	3870	2335	1535
SUPV10	TO	43113	18345	0	4	1769	16572	9258	7314
SUPV11	MV	30643	13440	0	3	1142	12295	6948	5347
SUPV11	ED	8032	4053	0	1	376	3676	2344	1332
SUPV11	TO	38675	17493	0	4	1518	15971	9292	6679
NEIG1	MV	15464	5944	0	1	589	5354	2974	2380
NEIG1	ED	5021	1583	0	0	145	1438	876	562
NEIG1	TO	20485	7527	0	1	734	6792	3850	2942
NEIG2	MV	14029	6280	0	1	736	5543	2855	2688
NEIG2	ED	3238	2815	0	0	410	2405	1376	1029
NEIG2	TO	17267	9095	0	1	1146	7948	4231	3717
NEIG3	MV	22050	9508	0	4	965	8539	5212	3327
NEIG3	ED	5969	4204	0	1	515	3688	2489	1199
NEIG3	TO	28019	13712	0	5	1480	12227	7701	4526
NEIG4	MV	5630	3494	0	0	334	3160	1583	1577
NEIG4	ED	1430	1249	0	0	135	1114	570	544
NEIG4	TO	7060	4743	0	0	469	4274	2153	2121
NEIG5	MV	22700	10125	0	3	896	9226	5163	4063
NEIG5	ED	5893	3002	0	1	282	2719	1695	1024
NEIG5	TO	28593	13127	0	4	1178	11945	6858	5087
NEIG6	MV	11526	5973	0	1	572	5400	3200	2200
NEIG6	ED	2336	3502	0	1	403	3098	1964	1134
NEIG6	TO	13862	9475	0	2	975	8498	5164	3334
NEIG7	MV	9818	4131	0	0	314	3817	2207	1610
NEIG7	ED	2577	1320	0	0	120	1200	794	406
NEIG7	TO	12395	5451	0	0	434	5017	3001	2016
NEIG8	MV	7628	4028	0	0	372	3656	2091	1565
NEIG8	ED	2030	2242	0	0	246	1996	1250	746
NEIG8	TO	9658	6270	0	0	618	5652	3341	2311
NEIG9	MV	7416	3142	0	0	292	2850	1568	1282
NEIG9	ED	842	939	0	0	96	843	514	329
NEIG9	TO	8258	4081	0	0	388	3693	2082	1611
NEIG10	MV	8172	3953	0	1	420	3532	1853	1679
NEIG10	ED	1850	2034	0	1	234	1799	1063	736
NEIG10	TO	10022	5987	0	2	654	5331	2916	2415
NEIG11	MV	33509	15534	0	5	1862	13667	5853	7814
NEIG11	ED	5931	7964	0	2	1237	6725	3189	3536
NEIG11	TO	39440	23498	0	7	3099	20392	9042	11350
NEIG12	MV	23572	11865	0	1	900	10964	6782	4182
NEIG12	ED	7433	5385	0	2	447	4936	3418	1518
NEIG12	TO	31005	17250	0	3	1347	15900	10200	5700
NEIG14	MV	6791	3992	0	2	359	3631	2210	1421
NEIG14	ED	1942	1795	0	1	157	1637	1084	553
NEIG14	TO	8733	5787	0	3	516	5268	3294	1974
NEIG15	MV	5779	2678	0	0	248	2430	1202	1228
NEIG15	ED	1309	1197	0	1	153	1043	578	465
NEIG15	TO	7088	3875	0	1	401	3473	1780	1693
NEIG13	MV	13553	8168	0	5	793	7370	3807	3563
NEIG13	ED	3435	3395	0	0	312	3083	1767	1316
NEIG13	TO	16988	11563	0	5	1105	10453	5574	4879
NEIG26	MV	7830	3526	0	1	303	3222	1702	1520
NEIG26	ED	1802	958	0	0	90	868	519	349
NEIG26	TO	9632	4484	0	1	393	4090	2221	1869
NEIG16	MV	14623	6960	0	4	702	6254	3223	3031
NEIG16	ED	2733	2592	0	1	305	2286	1358	928
NEIG16	TO	17356	9552	0	5	1007	8540	4581	3959
NEIG17	MV	29447	14415	0	0	1413	13002	7185	5817
NEIG17	ED	8178	7576	0	0	850	6726	4065	2661
NEIG17	TO	37625	21991	0	0	2263	19728	11250	8478
NEIG19	MV	7165	4024	0	0	338	3686	2167	1519
NEIG19	ED	2406	1880	0	0	163	1717	1035	682
NEIG19	TO	9571	5904	0	0	501	5403	3202	2201
NEIG18	MV	6458	3414	0	1	362	3051	1190	1861
NEIG18	ED	1563	1848	0	0	244	1604	728	876
NEIG18	TO	8021	5262	0	1	606	4655	1918	2737
NEIG20	MV	20910	8912	0	3	880	8029	4046	3983
NEIG20	ED	4167	3399	0	1	460	2938	1659	1279
NEIG20	TO	25077	12311	0	4	1340	10967	5705	5262
NEIG21	MV	34606	16657	0	2	1666	14989	7582	7407
NEIG21	ED	8887	7428	0	2	845	6581	3897	2684
NEIG21	TO	43493	24085	0	4	2511	21570	11479	10091
NEIG22	MV	15381	9297	0	1	850	8446	4564	3882
NEIG22	ED	3512	3650	0	0	344	3306	2010	1296
NEIG22	TO	18893	12947	0	1	1194	11752	6574	5178
NEIG23	MV	6638	2511	0	0	231	2280	1233	1047
NEIG23	ED	1850	604	0	0	57	547	327	220
NEIG23	TO	8488	3115	0	0	288	2827	1560	1267
NEIG24	MV	28439	16112	0	2	1467	14643	6496	8147
NEIG24	ED	6935	5821	0	1	518	5302	2527	2775
NEIG24	TO	35374	21933	0	3	1985	19945	9023	10922
NEIG25	MV	23712	12546	0	4	1261	11281	6634	4647
NEIG25	ED	7784	6202	0	0	727	5475	3539	1936
NEIG25	TO	31496	18748	0	4	1988	16756	10173	6583
