area_id	subtotal_type	RSReg	RSCst	RSRej	RSOvr	RSUnd	RSTot	11:YES	12:NO
ALLPCTS	TO	503899	275013	0	57	27416	247540	135324	112216
ALLPCTS	ED	101053	78221	0	15	8335	69871	40961	28910
ALLPCTS	MV	402846	196792	0	42	19081	177669	94363	83306
PCT1101	MV	448	214	0	0	24	190	116	74
PCT1101	ED	114	60	0	0	8	52	35	17
PCT1101	TO	562	274	0	0	32	242	151	91
PCT1102	MV	774	368	0	0	26	342	164	178
PCT1102	ED	230	159	0	0	13	146	86	60
PCT1102	TO	1004	527	0	0	39	488	250	238
PCT1103	MV	749	371	0	0	21	350	197	153
PCT1103	ED	222	142	0	0	11	131	75	56
PCT1103	TO	971	513	0	0	32	481	272	209
PCT1104	MV	751	343	0	0	32	311	191	120
PCT1104	ED	267	120	0	0	6	114	75	39
PCT1104	TO	1018	463	0	0	38	425	266	159
PCT1106	MV	598	255	0	0	25	230	125	105
PCT1106	ED	173	96	0	0	7	89	46	43
PCT1106	TO	771	351	0	0	32	319	171	148
PCT1107	MV	612	287	0	0	21	266	135	131
PCT1107	ED	139	76	0	0	9	67	35	32
PCT1107	TO	751	363	0	0	30	333	170	163
PCT1108	MV	725	360	0	0	29	331	187	144
PCT1108	ED	198	115	0	0	15	100	64	36
PCT1108	TO	923	475	0	0	44	431	251	180
PCT1109	MV	653	284	0	0	21	263	140	123
PCT1109	ED	169	97	0	0	8	89	54	35
PCT1109	TO	822	381	0	0	29	352	194	158
PCT1111	MV	849	354	0	0	34	320	180	140
PCT1111	ED	197	118	0	0	10	108	72	36
PCT1111	TO	1046	472	0	0	44	428	252	176
PCT1112	MV	643	276	0	0	19	257	150	107
PCT1112	ED	159	77	0	0	5	72	51	21
PCT1112	TO	802	353	0	0	24	329	201	128
PCT1113	MV	675	286	0	0	26	260	143	117
PCT1113	ED	120	65	0	0	8	57	38	19
PCT1113	TO	795	351	0	0	34	317	181	136
PCT1114	MV	769	328	0	0	28	300	181	119
PCT1114	ED	222	97	0	0	14	83	56	27
PCT1114	TO	991	425	0	0	42	383	237	146
PCT1115	MV	743	295	0	0	24	271	155	116
PCT1115	ED	193	86	0	0	7	79	52	27
PCT1115	TO	936	381	0	0	31	350	207	143
PCT1116	MV	715	308	0	0	30	278	177	101
PCT1116	ED	216	118	0	0	10	108	76	32
PCT1116	TO	931	426	0	0	40	386	253	133
PCT1117	MV	665	257	0	0	23	234	142	92
PCT1117	ED	181	71	0	0	4	67	52	15
PCT1117	TO	846	328	0	0	27	301	194	107
PCT1118	MV	846	356	0	0	18	338	194	144
PCT1118	ED	219	104	0	0	16	88	53	35
PCT1118	TO	1065	460	0	0	34	426	247	179
PCT1119	MV	659	303	0	0	19	284	166	118
PCT1119	ED	138	74	0	0	6	68	50	18
PCT1119	TO	797	377	0	0	25	352	216	136
PCT1121	MV	556	268	0	0	32	236	134	102
PCT1121	ED	149	82	0	0	8	74	44	30
PCT1121	TO	705	350	0	0	40	310	178	132
PCT1122	MV	519	245	0	0	24	221	113	108
PCT1122	ED	118	71	0	0	8	63	35	28
PCT1122	TO	637	316	0	0	32	284	148	136
PCT1123	MV	730	257	0	0	22	235	137	98
PCT1123	ED	208	89	0	0	5	84	67	17
PCT1123	TO	938	346	0	0	27	319	204	115
PCT1124	MV	630	246	0	0	10	236	145	91
PCT1124	ED	199	73	0	0	4	69	50	19
PCT1124	TO	829	319	0	0	14	305	195	110
PCT1125	MV	919	364	0	1	44	319	193	126
PCT1125	ED	178	67	0	0	11	56	41	15
PCT1125	TO	1097	431	0	1	55	375	234	141
PCT1126	MV	812	308	0	0	26	282	165	117
PCT1126	ED	200	68	0	0	5	63	40	23
PCT1126	TO	1012	376	0	0	31	345	205	140
PCT1127	MV	743	293	0	0	19	274	136	138
PCT1127	ED	222	100	0	0	8	92	54	38
PCT1127	TO	965	393	0	0	27	366	190	176
PCT1128	MV	734	286	0	0	27	259	143	116
PCT1128	ED	145	59	0	0	7	52	37	15
PCT1128	TO	879	345	0	0	34	311	180	131
PCT1129	MV	790	314	0	1	27	286	175	111
PCT1129	ED	246	108	0	0	15	93	63	30
PCT1129	TO	1036	422	0	1	42	379	238	141
PCT1131	MV	694	279	0	1	35	243	111	132
PCT1131	ED	166	60	0	0	8	52	29	23
PCT1131	TO	860	339	0	1	43	295	140	155
PCT1132	MV	839	370	0	0	32	338	180	158
PCT1132	ED	193	59	0	0	3	56	26	30
PCT1132	TO	1032	429	0	0	35	394	206	188
PCT1133	MV	716	334	0	0	20	314	154	160
PCT1133	ED	159	74	0	0	5	69	36	33
PCT1133	TO	875	408	0	0	25	383	190	193
PCT1134	MV	585	292	0	0	21	271	129	142
PCT1134	ED	182	80	0	0	8	72	51	21
PCT1134	TO	767	372	0	0	29	343	180	163
PCT1135	MV	465	218	0	0	15	203	105	98
PCT1135	ED	91	51	0	0	4	47	25	22
PCT1135	TO	556	269	0	0	19	250	130	120
PCT1136	MV	710	340	0	0	19	321	185	136
PCT1136	ED	157	77	0	0	5	72	44	28
PCT1136	TO	867	417	0	0	24	393	229	164
PCT1141	MV	836	392	0	0	30	362	198	164
PCT1141	ED	220	123	0	0	7	116	72	44
PCT1141	TO	1056	515	0	0	37	478	270	208
PCT1142	MV	721	324	0	0	39	285	177	108
PCT1142	ED	175	87	0	0	5	82	59	23
PCT1142	TO	896	411	0	0	44	367	236	131
PCT1143	MV	824	360	0	0	39	321	202	119
PCT1143	ED	225	114	0	0	11	103	72	31
PCT1143	TO	1049	474	0	0	50	424	274	150
PCT1144	MV	727	326	0	0	24	302	172	130
PCT1144	ED	220	121	0	0	12	109	60	49
PCT1144	TO	947	447	0	0	36	411	232	179
PCT1145	MV	753	411	0	0	34	377	207	170
PCT1145	ED	152	114	0	1	10	103	73	30
PCT1145	TO	905	525	0	1	44	480	280	200
PCT1146	MV	839	364	0	0	26	338	206	132
PCT1146	ED	215	110	0	0	9	101	69	32
PCT1146	TO	1054	474	0	0	35	439	275	164
PCT1147	MV	673	309	0	0	19	290	174	116
PCT1147	ED	212	107	0	0	13	94	61	33
PCT1147	TO	885	416	0	0	32	384	235	149
PCT1148	MV	804	367	0	0	32	335	189	146
PCT1148	ED	224	116	0	0	11	105	66	39
PCT1148	TO	1028	483	0	0	43	440	255	185
PCT1149	MV	710	319	0	0	37	282	144	138
PCT1149	ED	229	118	0	0	10	108	74	34
PCT1149	TO	939	437	0	0	47	390	218	172
PCT1151	MV	0	0	0	0	0	0	0	0
PCT1151	ED	0	0	0	0	0	0	0	0
PCT1151	TO	0	0	0	0	0	0	0	0
PCT1152	MV	710	312	0	0	32	280	171	109
PCT1152	ED	180	85	0	0	8	77	46	31
PCT1152	TO	890	397	0	0	40	357	217	140
PCT1153	MV	730	285	0	0	36	249	151	98
PCT1153	ED	210	117	0	0	11	106	53	53
PCT1153	TO	940	402	0	0	47	355	204	151
PCT1154	MV	0	0	0	0	0	0	0	0
PCT1154	ED	0	0	0	0	0	0	0	0
PCT1154	TO	0	0	0	0	0	0	0	0
PCT7001	MV	632	328	0	0	25	303	152	151
PCT7001	ED	141	103	0	0	7	96	57	39
PCT7001	TO	773	431	0	0	32	399	209	190
PCT7002	MV	598	267	0	0	32	235	129	106
PCT7002	ED	116	88	0	0	6	82	50	32
PCT7002	TO	714	355	0	0	38	317	179	138
PCT7003	MV	759	430	0	0	44	386	207	179
PCT7003	ED	147	144	0	0	15	129	75	54
PCT7003	TO	906	574	0	0	59	515	282	233
PCT7004	MV	764	416	0	1	35	380	189	191
PCT7004	ED	149	143	0	0	16	127	69	58
PCT7004	TO	913	559	0	1	51	507	258	249
PCT7005	MV	698	350	0	0	32	318	168	150
PCT7005	ED	161	162	0	0	23	139	87	52
PCT7005	TO	859	512	0	0	55	457	255	202
PCT7006	MV	729	359	0	0	40	319	196	123
PCT7006	ED	203	149	0	0	10	139	101	38
PCT7006	TO	932	508	0	0	50	458	297	161
PCT7007	MV	777	437	0	0	41	396	205	191
PCT7007	ED	180	169	0	0	18	151	92	59
PCT7007	TO	957	606	0	0	59	547	297	250
PCT7008	MV	732	367	0	0	42	325	168	157
PCT7008	ED	177	192	0	0	18	174	105	69
PCT7008	TO	909	559	0	0	60	499	273	226
PCT7009	MV	752	389	0	0	30	359	201	158
PCT7009	ED	119	91	0	0	6	85	47	38
PCT7009	TO	871	480	0	0	36	444	248	196
PCT7011	MV	704	231	0	0	21	210	103	107
PCT7011	ED	269	87	0	0	4	83	49	34
PCT7011	TO	973	318	0	0	25	293	152	141
PCT7012	MV	999	487	0	0	48	439	250	189
PCT7012	ED	227	206	0	0	19	187	104	83
PCT7012	TO	1226	693	0	0	67	626	354	272
PCT7013	MV	984	280	0	0	26	254	144	110
PCT7013	ED	155	151	0	0	19	132	74	58
PCT7013	TO	1139	431	0	0	45	386	218	168
PCT7014	MV	610	298	0	1	31	266	125	141
PCT7014	ED	109	112	0	0	18	94	55	39
PCT7014	TO	719	410	0	1	49	360	180	180
PCT7015	MV	128	40	0	0	6	34	23	11
PCT7015	ED	-18	0	0	0	0	0	0	0
PCT7015	TO	110	40	0	0	6	34	23	11
PCT7016	MV	655	238	0	0	23	215	112	103
PCT7016	ED	277	75	0	0	7	68	42	26
PCT7016	TO	932	313	0	0	30	283	154	129
PCT7017	MV	543	180	0	0	26	154	92	62
PCT7017	ED	238	53	0	0	12	41	21	20
PCT7017	TO	781	233	0	0	38	195	113	82
PCT7018	MV	847	357	0	0	36	321	166	155
PCT7018	ED	200	56	0	0	5	51	37	14
PCT7018	TO	1047	413	0	0	41	372	203	169
PCT7019	MV	734	355	0	0	29	326	168	158
PCT7019	ED	166	74	0	0	8	66	41	25
PCT7019	TO	900	429	0	0	37	392	209	183
PCT7021	MV	679	271	0	0	32	239	150	89
PCT7021	ED	288	106	0	0	12	94	60	34
PCT7021	TO	967	377	0	0	44	333	210	123
PCT7022	MV	770	311	0	0	36	275	160	115
PCT7022	ED	193	55	0	0	3	52	39	13
PCT7022	TO	963	366	0	0	39	327	199	128
PCT7023	MV	687	331	0	0	30	301	172	129
PCT7023	ED	233	71	0	0	6	65	38	27
PCT7023	TO	920	402	0	0	36	366	210	156
PCT7024	MV	251	50	0	0	4	46	26	20
PCT7024	ED	190	20	0	0	4	16	12	4
PCT7024	TO	441	70	0	0	8	62	38	24
PCT7025	MV	316	95	0	0	7	88	49	39
PCT7025	ED	167	39	0	0	2	37	21	16
PCT7025	TO	483	134	0	0	9	125	70	55
PCT7026	MV	819	336	0	0	29	307	163	144
PCT7026	ED	191	72	0	0	7	65	39	26
PCT7026	TO	1010	408	0	0	36	372	202	170
PCT7027	MV	677	270	0	0	31	239	140	99
PCT7027	ED	219	96	0	0	10	86	47	39
PCT7027	TO	896	366	0	0	41	325	187	138
PCT7028	MV	585	220	0	0	19	201	124	77
PCT7028	ED	271	97	0	0	11	86	59	27
PCT7028	TO	856	317	0	0	30	287	183	104
PCT7029	MV	642	208	0	0	30	178	101	77
PCT7029	ED	267	39	0	0	1	38	16	22
PCT7029	TO	909	247	0	0	31	216	117	99
PCT7030	MV	654	274	0	0	19	255	127	128
PCT7030	ED	141	58	0	0	1	57	34	23
PCT7030	TO	795	332	0	0	20	312	161	151
PCT7031	MV	622	263	0	0	24	239	143	96
PCT7031	ED	72	48	0	0	8	40	20	20
PCT7031	TO	694	311	0	0	32	279	163	116
PCT7032	MV	643	266	0	0	26	240	130	110
PCT7032	ED	238	53	0	0	4	49	29	20
PCT7032	TO	881	319	0	0	30	289	159	130
PCT7033	MV	549	214	0	0	21	193	111	82
PCT7033	ED	229	86	0	0	9	77	49	28
PCT7033	TO	778	300	0	0	30	270	160	110
PCT7034	MV	620	140	0	0	22	118	73	45
PCT7034	ED	318	58	0	0	4	54	33	21
PCT7034	TO	938	198	0	0	26	172	106	66
PCT7035	MV	567	237	0	0	24	213	103	110
PCT7035	ED	152	52	0	0	7	45	27	18
PCT7035	TO	719	289	0	0	31	258	130	128
PCT7036	MV	781	262	0	0	31	231	126	105
PCT7036	ED	193	39	0	0	1	38	23	15
PCT7036	TO	974	301	0	0	32	269	149	120
PCT7037	MV	434	63	0	0	4	59	39	20
PCT7037	ED	312	38	0	0	6	32	22	10
PCT7037	TO	746	101	0	0	10	91	61	30
PCT7038	MV	758	308	0	0	29	279	143	136
PCT7038	ED	203	58	0	0	10	48	24	24
PCT7038	TO	961	366	0	0	39	327	167	160
PCT7039	MV	636	243	0	0	27	216	100	116
PCT7039	ED	201	104	0	0	4	100	65	35
PCT7039	TO	837	347	0	0	31	316	165	151
PCT7041	MV	70	29	0	0	7	22	13	9
PCT7041	ED	-4	0	0	0	0	0	0	0
PCT7041	TO	66	29	0	0	7	22	13	9
PCT7042	MV	514	221	0	0	18	203	116	87
PCT7042	ED	146	59	0	0	1	58	41	17
PCT7042	TO	660	280	0	0	19	261	157	104
PCT7043	MV	754	295	0	0	27	268	172	96
PCT7043	ED	224	78	0	0	4	74	47	27
PCT7043	TO	978	373	0	0	31	342	219	123
PCT7044	MV	586	148	0	0	5	143	76	67
PCT7044	ED	266	33	0	0	3	30	24	6
PCT7044	TO	852	181	0	0	8	173	100	73
PCT7045	MV	632	266	0	0	28	238	140	98
PCT7045	ED	154	53	0	0	5	48	26	22
PCT7045	TO	786	319	0	0	33	286	166	120
PCT7046	MV	334	132	0	0	14	118	63	55
PCT7046	ED	96	48	0	0	3	45	24	21
PCT7046	TO	430	180	0	0	17	163	87	76
PCT7047	MV	733	314	0	0	27	287	151	136
PCT7047	ED	150	62	0	0	6	56	36	20
PCT7047	TO	883	376	0	0	33	343	187	156
PCT7048	MV	685	267	0	0	21	246	148	98
PCT7048	ED	196	56	0	0	5	51	30	21
PCT7048	TO	881	323	0	0	26	297	178	119
PCT7049	MV	616	247	0	0	23	224	121	103
PCT7049	ED	210	70	0	0	9	61	30	31
PCT7049	TO	826	317	0	0	32	285	151	134
PCT7051	MV	715	306	0	0	24	282	143	139
PCT7051	ED	165	70	0	0	8	62	43	19
PCT7051	TO	880	376	0	0	32	344	186	158
PCT7052	MV	722	296	0	0	14	282	142	140
PCT7052	ED	184	84	0	0	6	78	41	37
PCT7052	TO	906	380	0	0	20	360	183	177
PCT7053	MV	542	227	0	0	38	189	88	101
PCT7053	ED	43	42	0	0	4	38	21	17
PCT7053	TO	585	269	0	0	42	227	109	118
PCT7054	MV	863	308	0	1	30	277	157	120
PCT7054	ED	273	106	0	0	5	101	59	42
PCT7054	TO	1136	414	0	1	35	378	216	162
PCT7055	MV	732	291	0	0	23	268	151	117
PCT7055	ED	94	77	0	0	9	68	40	28
PCT7055	TO	826	368	0	0	32	336	191	145
PCT7056	MV	618	273	0	1	29	243	117	126
PCT7056	ED	87	119	0	0	12	107	63	44
PCT7056	TO	705	392	0	1	41	350	180	170
PCT7101	MV	162	99	0	0	8	91	49	42
PCT7101	ED	-15	4	0	0	2	2	2	0
PCT7101	TO	147	103	0	0	10	93	51	42
PCT7201	MV	788	383	0	0	40	343	151	192
PCT7201	ED	147	168	0	0	29	139	69	70
PCT7201	TO	935	551	0	0	69	482	220	262
PCT7202	MV	708	308	0	0	30	278	121	157
PCT7202	ED	143	156	0	0	19	137	73	64
PCT7202	TO	851	464	0	0	49	415	194	221
PCT7203	MV	693	321	0	0	46	275	125	150
PCT7203	ED	186	186	0	0	29	157	78	79
PCT7203	TO	879	507	0	0	75	432	203	229
PCT7204	MV	773	421	0	0	55	366	154	212
PCT7204	ED	126	122	0	0	23	99	47	52
PCT7204	TO	899	543	0	0	78	465	201	264
PCT7205	MV	724	360	0	0	33	327	152	175
PCT7205	ED	147	175	0	0	23	152	70	82
PCT7205	TO	871	535	0	0	56	479	222	257
PCT7206	MV	299	129	0	0	12	117	56	61
PCT7206	ED	78	102	0	0	13	89	49	40
PCT7206	TO	377	231	0	0	25	206	105	101
PCT7207	MV	744	333	0	0	32	301	157	144
PCT7207	ED	123	151	0	0	20	131	81	50
PCT7207	TO	867	484	0	0	52	432	238	194
PCT7208	MV	492	253	0	0	35	218	101	117
PCT7208	ED	78	94	0	0	13	81	49	32
PCT7208	TO	570	347	0	0	48	299	150	149
PCT7209	MV	595	341	0	0	45	296	105	191
PCT7209	ED	52	75	0	0	9	66	31	35
PCT7209	TO	647	416	0	0	54	362	136	226
PCT7301	MV	813	317	0	0	31	286	167	119
PCT7301	ED	201	141	0	0	15	126	75	51
PCT7301	TO	1014	458	0	0	46	412	242	170
PCT7302	MV	713	351	0	0	37	314	157	157
PCT7302	ED	136	137	0	0	17	120	63	57
PCT7302	TO	849	488	0	0	54	434	220	214
PCT7303	MV	869	376	0	0	35	341	190	151
PCT7303	ED	199	155	0	1	22	132	76	56
PCT7303	TO	1068	531	0	1	57	473	266	207
PCT7304	MV	802	366	0	0	40	326	143	183
PCT7304	ED	199	184	0	0	15	169	95	74
PCT7304	TO	1001	550	0	0	55	495	238	257
PCT7305	MV	713	386	0	0	38	348	147	201
PCT7305	ED	154	154	0	0	19	135	70	65
PCT7305	TO	867	540	0	0	57	483	217	266
PCT7306	MV	801	373	0	0	54	319	144	175
PCT7306	ED	243	193	0	0	32	161	96	65
PCT7306	TO	1044	566	0	0	86	480	240	240
PCT7307	MV	605	272	0	0	19	253	129	124
PCT7307	ED	169	126	0	0	19	107	59	48
PCT7307	TO	774	398	0	0	38	360	188	172
PCT7308	MV	520	256	0	0	17	239	112	127
PCT7308	ED	105	157	0	0	22	135	67	68
PCT7308	TO	625	413	0	0	39	374	179	195
PCT7309	MV	691	324	0	0	40	284	133	151
PCT7309	ED	167	190	0	0	29	161	95	66
PCT7309	TO	858	514	0	0	69	445	228	217
PCT7311	MV	698	333	0	0	25	308	133	175
PCT7311	ED	208	215	0	0	32	183	102	81
PCT7311	TO	906	548	0	0	57	491	235	256
PCT7312	MV	700	394	0	0	45	349	147	202
PCT7312	ED	110	160	0	0	21	139	60	79
PCT7312	TO	810	554	0	0	66	488	207	281
PCT7313	MV	819	373	0	0	33	340	186	154
PCT7313	ED	184	160	0	0	28	132	86	46
PCT7313	TO	1003	533	0	0	61	472	272	200
PCT7314	MV	612	226	0	0	28	198	131	67
PCT7314	ED	147	83	0	0	11	72	47	25
PCT7314	TO	759	309	0	0	39	270	178	92
PCT7315	MV	570	206	0	0	20	186	98	88
PCT7315	ED	195	134	0	0	15	119	70	49
PCT7315	TO	765	340	0	0	35	305	168	137
PCT7316	MV	654	261	0	0	31	230	134	96
PCT7316	ED	178	130	0	0	19	111	74	37
PCT7316	TO	832	391	0	0	50	341	208	133
PCT7317	MV	744	348	0	0	31	317	151	166
PCT7317	ED	146	111	0	0	15	96	59	37
PCT7317	TO	890	459	0	0	46	413	210	203
PCT7318	MV	605	293	0	0	36	257	135	122
PCT7318	ED	118	106	0	0	21	85	43	42
PCT7318	TO	723	399	0	0	57	342	178	164
PCT7319	MV	861	344	0	0	38	306	153	153
PCT7319	ED	188	180	0	0	29	151	77	74
PCT7319	TO	1049	524	0	0	67	457	230	227
PCT7321	MV	557	202	0	0	25	177	87	90
PCT7321	ED	102	84	0	0	11	73	41	32
PCT7321	TO	659	286	0	0	36	250	128	122
PCT7322	MV	742	294	0	1	44	249	160	89
PCT7322	ED	146	49	0	0	7	42	36	6
PCT7322	TO	888	343	0	1	51	291	196	95
PCT7323	MV	790	368	0	0	51	317	144	173
PCT7323	ED	166	157	0	0	23	134	73	61
PCT7323	TO	956	525	0	0	74	451	217	234
PCT7324	MV	587	259	0	0	34	225	124	101
PCT7324	ED	150	89	0	0	13	76	38	38
PCT7324	TO	737	348	0	0	47	301	162	139
PCT7325	MV	714	326	0	0	39	287	155	132
PCT7325	ED	172	123	0	0	18	105	60	45
PCT7325	TO	886	449	0	0	57	392	215	177
PCT7326	MV	685	303	0	0	35	268	151	117
PCT7326	ED	174	155	0	0	25	130	68	62
PCT7326	TO	859	458	0	0	60	398	219	179
PCT7327	MV	561	230	0	0	33	197	119	78
PCT7327	ED	126	49	0	0	5	44	22	22
PCT7327	TO	687	279	0	0	38	241	141	100
PCT7328	MV	829	333	0	0	64	269	170	99
PCT7328	ED	173	67	0	0	14	53	39	14
PCT7328	TO	1002	400	0	0	78	322	209	113
PCT7329	MV	556	227	0	0	24	203	80	123
PCT7329	ED	95	76	0	0	8	68	29	39
PCT7329	TO	651	303	0	0	32	271	109	162
PCT7331	MV	710	360	0	0	40	320	131	189
PCT7331	ED	160	158	0	0	27	131	58	73
PCT7331	TO	870	518	0	0	67	451	189	262
PCT7332	MV	654	262	0	0	31	231	140	91
PCT7332	ED	136	147	0	0	12	135	94	41
PCT7332	TO	790	409	0	0	43	366	234	132
PCT7333	MV	822	389	0	0	35	354	201	153
PCT7333	ED	193	219	0	0	26	193	120	73
PCT7333	TO	1015	608	0	0	61	547	321	226
PCT7334	MV	688	306	0	0	22	284	170	114
PCT7334	ED	131	131	0	0	13	118	86	32
PCT7334	TO	819	437	0	0	35	402	256	146
PCT7335	MV	788	389	0	0	42	347	170	177
PCT7335	ED	146	189	0	0	24	165	96	69
PCT7335	TO	934	578	0	0	66	512	266	246
PCT7336	MV	779	404	0	0	39	365	176	189
PCT7336	ED	175	174	0	0	28	146	85	61
PCT7336	TO	954	578	0	0	67	511	261	250
PCT7337	MV	772	386	0	0	47	339	146	193
PCT7337	ED	125	111	0	0	10	101	55	46
PCT7337	TO	897	497	0	0	57	440	201	239
PCT7338	MV	770	360	0	0	38	322	184	138
PCT7338	ED	125	90	0	0	12	78	55	23
PCT7338	TO	895	450	0	0	50	400	239	161
PCT7339	MV	605	270	0	0	24	246	141	105
PCT7339	ED	150	122	0	0	8	114	69	45
PCT7339	TO	755	392	0	0	32	360	210	150
PCT7341	MV	675	291	0	1	33	257	164	93
PCT7341	ED	178	159	0	1	14	144	99	45
PCT7341	TO	853	450	0	2	47	401	263	138
PCT7342	MV	674	323	0	0	26	297	176	121
PCT7342	ED	230	238	0	0	25	213	137	76
PCT7342	TO	904	561	0	0	51	510	313	197
PCT7343	MV	554	251	0	0	22	229	140	89
PCT7343	ED	150	146	0	0	21	125	88	37
PCT7343	TO	704	397	0	0	43	354	228	126
PCT7344	MV	863	392	0	0	29	363	183	180
PCT7344	ED	201	161	0	0	15	146	86	60
PCT7344	TO	1064	553	0	0	44	509	269	240
PCT7345	MV	904	432	0	0	36	396	235	161
PCT7345	ED	210	214	0	0	28	186	114	72
PCT7345	TO	1114	646	0	0	64	582	349	233
PCT7346	MV	681	288	0	0	29	259	182	77
PCT7346	ED	208	169	0	0	23	146	110	36
PCT7346	TO	889	457	0	0	52	405	292	113
PCT7347	MV	833	370	0	0	37	333	235	98
PCT7347	ED	170	109	0	0	10	99	66	33
PCT7347	TO	1003	479	0	0	47	432	301	131
PCT7348	MV	650	279	0	0	26	253	162	91
PCT7348	ED	193	115	0	0	9	106	68	38
PCT7348	TO	843	394	0	0	35	359	230	129
PCT7349	MV	710	315	0	1	26	288	157	131
PCT7349	ED	202	143	0	0	22	121	77	44
PCT7349	TO	912	458	0	1	48	409	234	175
PCT7501	MV	456	248	0	0	36	212	83	129
PCT7501	ED	95	116	0	0	17	99	48	51
PCT7501	TO	551	364	0	0	53	311	131	180
PCT7502	MV	668	314	0	0	34	280	145	135
PCT7502	ED	121	135	0	0	23	112	73	39
PCT7502	TO	789	449	0	0	57	392	218	174
PCT7503	MV	614	286	0	0	32	254	155	99
PCT7503	ED	148	134	0	0	24	110	62	48
PCT7503	TO	762	420	0	0	56	364	217	147
PCT7504	MV	404	175	0	0	17	158	90	68
PCT7504	ED	84	57	0	0	10	47	27	20
PCT7504	TO	488	232	0	0	27	205	117	88
PCT7505	MV	729	405	0	0	46	359	157	202
PCT7505	ED	133	96	0	0	8	88	40	48
PCT7505	TO	862	501	0	0	54	447	197	250
PCT7506	MV	842	363	0	0	40	323	196	127
PCT7506	ED	158	117	0	0	13	104	78	26
PCT7506	TO	1000	480	0	0	53	427	274	153
PCT7507	MV	694	289	0	0	23	266	176	90
PCT7507	ED	262	102	0	0	7	95	64	31
PCT7507	TO	956	391	0	0	30	361	240	121
PCT7508	MV	618	373	0	0	39	334	193	141
PCT7508	ED	126	106	0	0	10	96	59	37
PCT7508	TO	744	479	0	0	49	430	252	178
PCT7509	MV	756	399	0	0	33	366	216	150
PCT7509	ED	173	148	0	0	17	131	78	53
PCT7509	TO	929	547	0	0	50	497	294	203
PCT7512	MV	475	248	0	0	28	220	111	109
PCT7512	ED	125	86	0	0	8	78	48	30
PCT7512	TO	600	334	0	0	36	298	159	139
PCT7513	MV	575	248	0	0	34	214	143	71
PCT7513	ED	231	112	0	0	17	95	76	19
PCT7513	TO	806	360	0	0	51	309	219	90
PCT7514	MV	709	242	0	0	40	202	138	64
PCT7514	ED	207	61	0	0	15	46	29	17
PCT7514	TO	916	303	0	0	55	248	167	81
PCT7515	MV	663	321	0	1	25	295	182	113
PCT7515	ED	201	90	0	0	15	75	49	26
PCT7515	TO	864	411	0	1	40	370	231	139
PCT7516	MV	773	423	0	0	34	389	214	175
PCT7516	ED	147	118	0	0	6	112	54	58
PCT7516	TO	920	541	0	0	40	501	268	233
PCT7517	MV	645	362	0	0	45	317	203	114
PCT7517	ED	223	179	0	0	17	162	104	58
PCT7517	TO	868	541	0	0	62	479	307	172
PCT7518	MV	708	392	0	0	39	353	200	153
PCT7518	ED	218	186	0	0	17	169	107	62
PCT7518	TO	926	578	0	0	56	522	307	215
PCT7519	MV	543	259	0	0	27	232	141	91
PCT7519	ED	172	136	0	0	12	124	87	37
PCT7519	TO	715	395	0	0	39	356	228	128
PCT7521	MV	597	318	0	0	26	292	182	110
PCT7521	ED	182	149	0	0	10	139	88	51
PCT7521	TO	779	467	0	0	36	431	270	161
PCT7522	MV	588	301	0	1	27	273	155	118
PCT7522	ED	171	159	0	0	22	137	92	45
PCT7522	TO	759	460	0	1	49	410	247	163
PCT7523	MV	564	285	0	0	34	251	152	99
PCT7523	ED	180	169	0	0	12	157	106	51
PCT7523	TO	744	454	0	0	46	408	258	150
PCT7524	MV	480	228	0	0	23	205	144	61
PCT7524	ED	144	102	0	0	9	93	57	36
PCT7524	TO	624	330	0	0	32	298	201	97
PCT7525	MV	594	246	0	0	34	212	134	78
PCT7525	ED	170	96	0	0	12	84	53	31
PCT7525	TO	764	342	0	0	46	296	187	109
PCT7526	MV	826	395	0	0	45	350	190	160
PCT7526	ED	162	149	0	0	16	133	84	49
PCT7526	TO	988	544	0	0	61	483	274	209
PCT7527	MV	538	296	0	0	26	270	172	98
PCT7527	ED	172	113	0	0	7	106	65	41
PCT7527	TO	710	409	0	0	33	376	237	139
PCT7529	MV	749	366	0	0	33	333	200	133
PCT7529	ED	154	187	0	0	17	170	113	57
PCT7529	TO	903	553	0	0	50	503	313	190
PCT7531	MV	714	336	0	0	24	312	205	107
PCT7531	ED	159	135	0	0	5	130	88	42
PCT7531	TO	873	471	0	0	29	442	293	149
PCT7532	MV	668	328	0	0	29	299	165	134
PCT7532	ED	167	139	0	0	15	124	83	41
PCT7532	TO	835	467	0	0	44	423	248	175
PCT7533	MV	776	405	0	0	42	363	240	123
PCT7533	ED	194	189	0	0	21	168	116	52
PCT7533	TO	970	594	0	0	63	531	356	175
PCT7534	MV	670	375	0	1	36	338	202	136
PCT7534	ED	233	187	0	0	21	166	121	45
PCT7534	TO	903	562	0	1	57	504	323	181
PCT7535	MV	606	300	0	0	33	267	176	91
PCT7535	ED	139	162	0	0	20	142	100	42
PCT7535	TO	745	462	0	0	53	409	276	133
PCT7536	MV	670	346	0	0	25	321	206	115
PCT7536	ED	163	172	0	0	15	157	88	69
PCT7536	TO	833	518	0	0	40	478	294	184
PCT7537	MV	619	301	0	0	28	273	148	125
PCT7537	ED	126	150	0	0	13	137	84	53
PCT7537	TO	745	451	0	0	41	410	232	178
PCT7538	MV	562	321	0	0	35	286	159	127
PCT7538	ED	189	175	0	0	22	153	102	51
PCT7538	TO	751	496	0	0	57	439	261	178
PCT7539	MV	696	374	0	0	33	341	178	163
PCT7539	ED	225	195	0	0	14	181	136	45
PCT7539	TO	921	569	0	0	47	522	314	208
PCT7541	MV	600	295	0	0	36	259	147	112
PCT7541	ED	170	164	0	0	19	145	100	45
PCT7541	TO	770	459	0	0	55	404	247	157
PCT7542	MV	632	323	0	0	25	298	196	102
PCT7542	ED	192	171	0	0	9	162	112	50
PCT7542	TO	824	494	0	0	34	460	308	152
PCT7543	MV	694	371	0	0	31	340	210	130
PCT7543	ED	230	141	0	0	16	125	89	36
PCT7543	TO	924	512	0	0	47	465	299	166
PCT7544	MV	731	389	0	0	46	343	202	141
PCT7544	ED	168	164	0	0	17	147	98	49
PCT7544	TO	899	553	0	0	63	490	300	190
PCT7545	MV	723	384	0	0	38	346	189	157
PCT7545	ED	172	149	0	0	16	133	86	47
PCT7545	TO	895	533	0	0	54	479	275	204
PCT7546	MV	770	417	0	0	40	377	233	144
PCT7546	ED	183	219	0	0	21	198	116	82
PCT7546	TO	953	636	0	0	61	575	349	226
PCT7547	MV	798	426	0	0	38	388	267	121
PCT7547	ED	183	180	0	0	19	161	115	46
PCT7547	TO	981	606	0	0	57	549	382	167
PCT7548	MV	802	447	0	0	33	414	237	177
PCT7548	ED	249	204	0	1	16	187	120	67
PCT7548	TO	1051	651	0	1	49	601	357	244
PCT7549	MV	660	357	0	0	39	318	194	124
PCT7549	ED	146	143	0	0	20	123	74	49
PCT7549	TO	806	500	0	0	59	441	268	173
PCT7551	MV	587	303	0	0	22	281	157	124
PCT7551	ED	136	175	0	0	17	158	91	67
PCT7551	TO	723	478	0	0	39	439	248	191
PCT7552	MV	561	285	0	0	36	249	131	118
PCT7552	ED	124	130	0	0	17	113	63	50
PCT7552	TO	685	415	0	0	53	362	194	168
PCT7553	MV	211	95	0	0	10	85	48	37
PCT7553	ED	-20	0	0	0	0	0	0	0
PCT7553	TO	191	95	0	0	10	85	48	37
PCT7554	MV	653	381	0	0	37	344	162	182
PCT7554	ED	168	180	0	0	16	164	75	89
PCT7554	TO	821	561	0	0	53	508	237	271
PCT7555	MV	662	416	0	0	52	364	197	167
PCT7555	ED	210	210	0	0	21	189	102	87
PCT7555	TO	872	626	0	0	73	553	299	254
PCT7556	MV	812	512	0	0	42	470	224	246
PCT7556	ED	154	168	0	0	22	146	70	76
PCT7556	TO	966	680	0	0	64	616	294	322
PCT7601	MV	485	207	0	0	21	186	124	62
PCT7601	ED	192	91	0	0	13	78	57	21
PCT7601	TO	677	298	0	0	34	264	181	83
PCT7602	MV	654	276	0	0	25	251	168	83
PCT7602	ED	232	104	0	0	11	93	68	25
PCT7602	TO	886	380	0	0	36	344	236	108
PCT7603	MV	615	295	0	0	31	264	186	78
PCT7603	ED	200	168	0	0	13	155	115	40
PCT7603	TO	815	463	0	0	44	419	301	118
PCT7604	MV	685	270	0	0	20	250	192	58
PCT7604	ED	259	135	0	0	23	112	87	25
PCT7604	TO	944	405	0	0	43	362	279	83
PCT7605	MV	468	191	0	0	23	168	111	57
PCT7605	ED	193	62	0	0	5	57	46	11
PCT7605	TO	661	253	0	0	28	225	157	68
PCT7606	MV	673	267	0	0	34	233	157	76
PCT7606	ED	210	80	0	0	5	75	59	16
PCT7606	TO	883	347	0	0	39	308	216	92
PCT7607	MV	712	288	0	0	21	267	178	89
PCT7607	ED	207	101	0	0	6	95	63	32
PCT7607	TO	919	389	0	0	27	362	241	121
PCT7608	MV	279	96	0	0	11	85	57	28
PCT7608	ED	101	19	0	0	1	18	13	5
PCT7608	TO	380	115	0	0	12	103	70	33
PCT7609	MV	699	286	0	0	38	248	176	72
PCT7609	ED	185	49	0	0	8	41	33	8
PCT7609	TO	884	335	0	0	46	289	209	80
PCT7611	MV	586	235	0	0	21	214	164	50
PCT7611	ED	202	43	0	0	2	41	35	6
PCT7611	TO	788	278	0	0	23	255	199	56
PCT7612	MV	452	216	0	1	16	199	120	79
PCT7612	ED	105	31	0	0	2	29	19	10
PCT7612	TO	557	247	0	1	18	228	139	89
PCT7613	MV	634	244	0	0	23	221	154	67
PCT7613	ED	249	89	0	0	7	82	66	16
PCT7613	TO	883	333	0	0	30	303	220	83
PCT7614	MV	713	253	0	0	30	223	148	75
PCT7614	ED	203	81	0	0	7	74	51	23
PCT7614	TO	916	334	0	0	37	297	199	98
PCT7615	MV	510	165	0	0	17	148	103	45
PCT7615	ED	240	58	0	0	4	54	46	8
PCT7615	TO	750	223	0	0	21	202	149	53
PCT7616	MV	754	330	0	1	41	288	114	174
PCT7616	ED	82	86	0	0	12	74	36	38
PCT7616	TO	836	416	0	1	53	362	150	212
PCT7617	MV	583	222	0	0	32	190	137	53
PCT7617	ED	169	42	0	0	9	33	26	7
PCT7617	TO	752	264	0	0	41	223	163	60
PCT7618	MV	763	365	0	0	22	343	196	147
PCT7618	ED	151	85	0	0	10	75	38	37
PCT7618	TO	914	450	0	0	32	418	234	184
PCT7619	MV	937	439	0	0	38	401	217	184
PCT7619	ED	170	119	0	0	15	104	64	40
PCT7619	TO	1107	558	0	0	53	505	281	224
PCT7621	MV	1006	443	0	0	36	407	222	185
PCT7621	ED	149	104	0	0	14	90	54	36
PCT7621	TO	1155	547	0	0	50	497	276	221
PCT7622	MV	697	215	0	0	16	199	127	72
PCT7622	ED	263	74	0	0	10	64	47	17
PCT7622	TO	960	289	0	0	26	263	174	89
PCT7623	MV	767	256	0	1	25	230	156	74
PCT7623	ED	237	98	0	0	10	88	69	19
PCT7623	TO	1004	354	0	1	35	318	225	93
PCT7624	MV	652	209	0	0	21	188	116	72
PCT7624	ED	223	73	0	0	10	63	47	16
PCT7624	TO	875	282	0	0	31	251	163	88
PCT7625	MV	749	394	0	0	64	330	212	118
PCT7625	ED	73	34	0	0	1	33	24	9
PCT7625	TO	822	428	0	0	65	363	236	127
PCT7626	MV	944	401	0	0	48	353	129	224
PCT7626	ED	129	108	0	0	7	101	48	53
PCT7626	TO	1073	509	0	0	55	454	177	277
PCT7627	MV	457	196	0	0	20	176	59	117
PCT7627	ED	67	59	0	0	9	50	22	28
PCT7627	TO	524	255	0	0	29	226	81	145
PCT7628	MV	718	331	0	0	24	307	194	113
PCT7628	ED	220	111	0	0	8	103	68	35
PCT7628	TO	938	442	0	0	32	410	262	148
PCT7629	MV	691	276	0	0	26	250	155	95
PCT7629	ED	162	87	0	0	9	78	51	27
PCT7629	TO	853	363	0	0	35	328	206	122
PCT7631	MV	1009	440	0	1	39	400	212	188
PCT7631	ED	210	111	0	0	6	105	62	43
PCT7631	TO	1219	551	0	1	45	505	274	231
PCT7632	MV	1002	413	0	1	29	383	223	160
PCT7632	ED	169	130	0	0	8	122	72	50
PCT7632	TO	1171	543	0	1	37	505	295	210
PCT7633	MV	609	278	0	0	26	252	145	107
PCT7633	ED	126	97	0	0	14	83	42	41
PCT7633	TO	735	375	0	0	40	335	187	148
PCT7634	MV	704	344	0	0	48	296	179	117
PCT7634	ED	186	105	0	0	19	86	52	34
PCT7634	TO	890	449	0	0	67	382	231	151
PCT7635	MV	665	273	0	0	19	254	116	138
PCT7635	ED	188	62	0	0	5	57	27	30
PCT7635	TO	853	335	0	0	24	311	143	168
PCT7636	MV	798	330	0	0	31	299	142	157
PCT7636	ED	161	107	0	0	10	97	54	43
PCT7636	TO	959	437	0	0	41	396	196	200
PCT7637	MV	747	344	0	0	40	304	111	193
PCT7637	ED	121	99	0	0	12	87	33	54
PCT7637	TO	868	443	0	0	52	391	144	247
PCT7638	MV	806	372	0	0	48	324	120	204
PCT7638	ED	83	89	0	0	10	79	21	58
PCT7638	TO	889	461	0	0	58	403	141	262
PCT7639	MV	889	396	0	0	40	356	144	212
PCT7639	ED	133	134	0	0	28	106	47	59
PCT7639	TO	1022	530	0	0	68	462	191	271
PCT7641	MV	817	399	0	0	29	370	159	211
PCT7641	ED	134	93	0	0	4	89	47	42
PCT7641	TO	951	492	0	0	33	459	206	253
PCT7642	MV	647	311	0	0	44	267	144	123
PCT7642	ED	118	82	0	1	18	63	39	24
PCT7642	TO	765	393	0	1	62	330	183	147
PCT7643	MV	810	433	0	0	34	399	224	175
PCT7643	ED	131	106	0	0	16	90	46	44
PCT7643	TO	941	539	0	0	50	489	270	219
PCT7644	MV	1014	403	0	0	48	355	160	195
PCT7644	ED	162	142	0	0	12	130	93	37
PCT7644	TO	1176	545	0	0	60	485	253	232
PCT7645	MV	595	286	0	0	26	260	97	163
PCT7645	ED	61	56	0	0	9	47	26	21
PCT7645	TO	656	342	0	0	35	307	123	184
PCT7646	MV	1032	484	0	0	54	430	192	238
PCT7646	ED	121	134	0	0	25	109	67	42
PCT7646	TO	1153	618	0	0	79	539	259	280
PCT7647	MV	724	210	0	0	9	201	153	48
PCT7647	ED	263	79	0	0	4	75	59	16
PCT7647	TO	987	289	0	0	13	276	212	64
PCT7648	MV	2	1	0	0	1	0	0	0
PCT7648	ED	0	0	0	0	0	0	0	0
PCT7648	TO	2	1	0	0	1	0	0	0
PCT7649	MV	723	286	0	0	18	268	142	126
PCT7649	ED	177	81	0	0	9	72	46	26
PCT7649	TO	900	367	0	0	27	340	188	152
PCT7651	MV	834	332	0	0	37	295	127	168
PCT7651	ED	113	73	0	0	7	66	21	45
PCT7651	TO	947	405	0	0	44	361	148	213
PCT7652	MV	535	207	0	0	23	184	89	95
PCT7652	ED	100	87	0	0	10	77	46	31
PCT7652	TO	635	294	0	0	33	261	135	126
PCT7653	MV	750	334	0	0	47	287	133	154
PCT7653	ED	89	80	0	1	8	71	31	40
PCT7653	TO	839	414	0	1	55	358	164	194
PCT7654	MV	413	191	0	0	13	178	92	86
PCT7654	ED	53	84	0	0	15	69	41	28
PCT7654	TO	466	275	0	0	28	247	133	114
PCT7655	MV	583	215	0	0	18	197	89	108
PCT7655	ED	96	60	0	0	13	47	22	25
PCT7655	TO	679	275	0	0	31	244	111	133
PCT7656	MV	603	308	0	0	37	271	65	206
PCT7656	ED	35	40	0	0	6	34	8	26
PCT7656	TO	638	348	0	0	43	305	73	232
PCT7657	MV	561	269	0	1	31	237	76	161
PCT7657	ED	37	61	0	0	7	54	22	32
PCT7657	TO	598	330	0	1	38	291	98	193
PCT7701	MV	868	481	0	0	55	426	247	179
PCT7701	ED	196	174	0	0	21	153	90	63
PCT7701	TO	1064	655	0	0	76	579	337	242
PCT7702	MV	623	375	0	0	29	346	147	199
PCT7702	ED	133	104	0	0	6	98	51	47
PCT7702	TO	756	479	0	0	35	444	198	246
PCT7703	MV	187	71	0	0	7	64	51	13
PCT7703	ED	-13	0	0	0	0	0	0	0
PCT7703	TO	174	71	0	0	7	64	51	13
PCT7704	MV	798	489	0	0	47	442	186	256
PCT7704	ED	204	173	0	0	10	163	65	98
PCT7704	TO	1002	662	0	0	57	605	251	354
PCT7705	MV	470	285	0	0	19	266	108	158
PCT7705	ED	125	110	0	0	13	97	40	57
PCT7705	TO	595	395	0	0	32	363	148	215
PCT7706	MV	687	447	0	0	40	407	196	211
PCT7706	ED	179	162	0	0	15	147	58	89
PCT7706	TO	866	609	0	0	55	554	254	300
PCT7707	MV	683	432	0	0	40	392	185	207
PCT7707	ED	189	179	0	0	12	167	76	91
PCT7707	TO	872	611	0	0	52	559	261	298
PCT7708	MV	710	461	0	0	52	409	186	223
PCT7708	ED	165	154	0	0	18	136	69	67
PCT7708	TO	875	615	0	0	70	545	255	290
PCT7709	MV	324	193	0	0	13	180	98	82
PCT7709	ED	82	90	0	0	6	84	53	31
PCT7709	TO	406	283	0	0	19	264	151	113
PCT7711	MV	658	379	0	0	39	340	169	171
PCT7711	ED	153	125	0	0	9	116	69	47
PCT7711	TO	811	504	0	0	48	456	238	218
PCT7712	MV	425	258	0	0	17	241	137	104
PCT7712	ED	107	106	0	0	9	97	57	40
PCT7712	TO	532	364	0	0	26	338	194	144
PCT7801	MV	823	478	0	0	40	438	216	222
PCT7801	ED	151	190	0	0	17	173	90	83
PCT7801	TO	974	668	0	0	57	611	306	305
PCT7802	MV	646	401	0	0	37	364	190	174
PCT7802	ED	152	158	0	0	15	143	85	58
PCT7802	TO	798	559	0	0	52	507	275	232
PCT7803	MV	718	476	0	0	41	435	206	229
PCT7803	ED	113	128	0	0	16	112	64	48
PCT7803	TO	831	604	0	0	57	547	270	277
PCT7804	MV	734	463	0	0	60	403	208	195
PCT7804	ED	151	181	0	0	25	156	77	79
PCT7804	TO	885	644	0	0	85	559	285	274
PCT7805	MV	644	399	0	0	43	356	188	168
PCT7805	ED	156	156	0	0	15	141	98	43
PCT7805	TO	800	555	0	0	58	497	286	211
PCT7806	MV	602	361	0	1	36	324	169	155
PCT7806	ED	153	152	0	0	15	137	86	51
PCT7806	TO	755	513	0	1	51	461	255	206
PCT7807	MV	642	361	0	0	28	333	193	140
PCT7807	ED	185	174	0	0	20	154	103	51
PCT7807	TO	827	535	0	0	48	487	296	191
PCT7808	MV	525	296	0	0	31	265	156	109
PCT7808	ED	129	129	0	0	17	112	69	43
PCT7808	TO	654	425	0	0	48	377	225	152
PCT7809	MV	624	351	0	0	26	325	208	117
PCT7809	ED	140	136	0	0	9	127	84	43
PCT7809	TO	764	487	0	0	35	452	292	160
PCT7811	MV	582	311	0	0	30	281	173	108
PCT7811	ED	176	155	0	0	8	147	97	50
PCT7811	TO	758	466	0	0	38	428	270	158
PCT7812	MV	680	369	0	0	37	332	184	148
PCT7812	ED	217	163	0	0	19	144	95	49
PCT7812	TO	897	532	0	0	56	476	279	197
PCT7813	MV	843	483	0	0	29	454	293	161
PCT7813	ED	225	215	0	0	24	191	139	52
PCT7813	TO	1068	698	0	0	53	645	432	213
PCT7814	MV	660	279	0	0	24	255	176	79
PCT7814	ED	241	118	0	0	15	103	80	23
PCT7814	TO	901	397	0	0	39	358	256	102
PCT7815	MV	749	465	0	0	54	411	223	188
PCT7815	ED	168	179	0	0	15	164	105	59
PCT7815	TO	917	644	0	0	69	575	328	247
PCT7816	MV	724	472	0	0	43	429	221	208
PCT7816	ED	148	149	0	0	9	140	75	65
PCT7816	TO	872	621	0	0	52	569	296	273
PCT7817	MV	652	396	0	0	26	370	211	159
PCT7817	ED	186	183	0	0	15	168	106	62
PCT7817	TO	838	579	0	0	41	538	317	221
PCT7818	MV	668	393	0	0	26	367	206	161
PCT7818	ED	171	149	0	0	12	137	85	52
PCT7818	TO	839	542	0	0	38	504	291	213
PCT7819	MV	635	352	0	0	31	321	192	129
PCT7819	ED	139	89	0	0	8	81	54	27
PCT7819	TO	774	441	0	0	39	402	246	156
PCT7821	MV	806	519	0	0	37	482	258	224
PCT7821	ED	170	190	0	0	12	178	95	83
PCT7821	TO	976	709	0	0	49	660	353	307
PCT7822	MV	673	395	0	0	33	362	205	157
PCT7822	ED	219	223	0	0	28	195	119	76
PCT7822	TO	892	618	0	0	61	557	324	233
PCT7823	MV	706	410	0	0	35	375	209	166
PCT7823	ED	177	189	0	0	6	183	131	52
PCT7823	TO	883	599	0	0	41	558	340	218
PCT7824	MV	615	334	0	0	36	298	156	142
PCT7824	ED	153	158	0	0	19	139	90	49
PCT7824	TO	768	492	0	0	55	437	246	191
PCT7825	MV	457	252	0	0	22	230	138	92
PCT7825	ED	151	130	0	0	6	124	81	43
PCT7825	TO	608	382	0	0	28	354	219	135
PCT7826	MV	486	263	0	0	17	246	142	104
PCT7826	ED	204	162	0	0	15	147	98	49
PCT7826	TO	690	425	0	0	32	393	240	153
PCT7827	MV	607	318	0	0	27	291	177	114
PCT7827	ED	219	146	0	0	15	131	97	34
PCT7827	TO	826	464	0	0	42	422	274	148
PCT7828	MV	857	477	0	1	46	430	244	186
PCT7828	ED	171	179	0	0	22	157	91	66
PCT7828	TO	1028	656	0	1	68	587	335	252
PCT7829	MV	742	466	0	0	43	423	226	197
PCT7829	ED	149	151	0	0	8	143	87	56
PCT7829	TO	891	617	0	0	51	566	313	253
PCT7831	MV	763	485	0	0	52	433	210	223
PCT7831	ED	139	138	0	0	11	127	74	53
PCT7831	TO	902	623	0	0	63	560	284	276
PCT7832	MV	663	412	0	0	40	372	206	166
PCT7832	ED	118	127	0	0	9	118	70	48
PCT7832	TO	781	539	0	0	49	490	276	214
PCT7833	MV	587	343	0	0	28	315	176	139
PCT7833	ED	146	145	0	0	19	126	74	52
PCT7833	TO	733	488	0	0	47	441	250	191
PCT7834	MV	700	374	0	0	40	334	185	149
PCT7834	ED	194	177	0	0	22	155	102	53
PCT7834	TO	894	551	0	0	62	489	287	202
PCT7835	MV	721	427	0	0	30	397	221	176
PCT7835	ED	142	147	0	0	14	133	84	49
PCT7835	TO	863	574	0	0	44	530	305	225
PCT7836	MV	850	505	0	0	40	465	281	184
PCT7836	ED	193	170	0	0	10	160	96	64
PCT7836	TO	1043	675	0	0	50	625	377	248
PCT7837	MV	718	424	0	0	56	368	161	207
PCT7837	ED	205	199	0	0	22	177	95	82
PCT7837	TO	923	623	0	0	78	545	256	289
PCT7838	MV	752	492	0	0	48	444	218	226
PCT7838	ED	143	156	0	0	18	138	83	55
PCT7838	TO	895	648	0	0	66	582	301	281
PCT7839	MV	731	456	0	0	45	411	196	215
PCT7839	ED	130	137	0	0	15	122	61	61
PCT7839	TO	861	593	0	0	60	533	257	276
PCT7841	MV	752	457	0	0	41	416	225	191
PCT7841	ED	198	207	0	0	15	192	105	87
PCT7841	TO	950	664	0	0	56	608	330	278
PCT7842	MV	702	393	0	0	36	357	224	133
PCT7842	ED	177	155	0	0	9	146	87	59
PCT7842	TO	879	548	0	0	45	503	311	192
PCT7843	MV	546	295	0	0	22	273	163	110
PCT7843	ED	183	165	0	0	15	150	100	50
PCT7843	TO	729	460	0	0	37	423	263	160
PCT7844	MV	499	281	0	0	22	259	158	101
PCT7844	ED	152	136	0	0	14	122	85	37
PCT7844	TO	651	417	0	0	36	381	243	138
PCT7845	MV	676	405	0	0	38	367	191	176
PCT7845	ED	204	177	0	0	15	162	80	82
PCT7845	TO	880	582	0	0	53	529	271	258
PCT7846	MV	736	463	0	0	47	416	191	225
PCT7846	ED	172	167	0	0	21	146	77	69
PCT7846	TO	908	630	0	0	68	562	268	294
PCT7847	MV	698	427	0	0	60	367	214	153
PCT7847	ED	193	183	0	0	10	173	97	76
PCT7847	TO	891	610	0	0	70	540	311	229
PCT7848	MV	665	437	0	0	32	405	199	206
PCT7848	ED	182	169	0	0	23	146	78	68
PCT7848	TO	847	606	0	0	55	551	277	274
PCT7849	MV	729	441	0	1	39	401	199	202
PCT7849	ED	172	186	0	0	19	167	101	66
PCT7849	TO	901	627	0	1	58	568	300	268
PCT7851	MV	414	272	0	0	28	244	84	160
PCT7851	ED	112	84	0	0	14	70	14	56
PCT7851	TO	526	356	0	0	42	314	98	216
PCT7852	MV	533	350	0	0	42	308	155	153
PCT7852	ED	111	103	0	0	11	92	46	46
PCT7852	TO	644	453	0	0	53	400	201	199
PCT7853	MV	694	394	0	0	41	353	176	177
PCT7853	ED	161	137	0	0	10	127	60	67
PCT7853	TO	855	531	0	0	51	480	236	244
PCT7854	MV	703	430	0	1	46	383	183	200
PCT7854	ED	175	172	0	0	13	159	84	75
PCT7854	TO	878	602	0	1	59	542	267	275
PCT7855	MV	763	450	0	0	49	401	191	210
PCT7855	ED	211	202	0	0	23	179	95	84
PCT7855	TO	974	652	0	0	72	580	286	294
PCT7856	MV	643	372	0	0	26	346	179	167
PCT7856	ED	204	193	0	0	18	175	105	70
PCT7856	TO	847	565	0	0	44	521	284	237
PCT7857	MV	748	435	0	1	40	394	202	192
PCT7857	ED	158	154	0	0	13	141	82	59
PCT7857	TO	906	589	0	1	53	535	284	251
PCT7858	MV	622	349	0	0	34	315	191	124
PCT7858	ED	157	148	0	0	12	136	92	44
PCT7858	TO	779	497	0	0	46	451	283	168
PCT7859	MV	747	464	0	0	45	419	201	218
PCT7859	ED	152	166	0	0	21	145	81	64
PCT7859	TO	899	630	0	0	66	564	282	282
PCT7861	MV	699	431	0	1	35	395	200	195
PCT7861	ED	164	171	0	0	10	161	101	60
PCT7861	TO	863	602	0	1	45	556	301	255
PCT7862	MV	669	400	0	0	31	369	176	193
PCT7862	ED	195	198	0	0	14	184	101	83
PCT7862	TO	864	598	0	0	45	553	277	276
PCT7863	MV	693	371	0	0	35	336	201	135
PCT7863	ED	208	205	0	0	16	189	112	77
PCT7863	TO	901	576	0	0	51	525	313	212
PCT7864	MV	661	374	0	0	48	326	171	155
PCT7864	ED	153	157	0	0	17	140	87	53
PCT7864	TO	814	531	0	0	65	466	258	208
PCT7865	MV	677	408	0	1	48	359	195	164
PCT7865	ED	163	157	0	0	12	145	93	52
PCT7865	TO	840	565	0	1	60	504	288	216
PCT7866	MV	690	446	0	0	41	405	204	201
PCT7866	ED	158	141	0	0	13	128	62	66
PCT7866	TO	848	587	0	0	54	533	266	267
PCT7867	MV	766	470	0	0	42	428	232	196
PCT7867	ED	212	182	0	0	20	162	91	71
PCT7867	TO	978	652	0	0	62	590	323	267
PCT7868	MV	659	374	0	0	30	344	173	171
PCT7868	ED	217	161	0	0	22	139	83	56
PCT7868	TO	876	535	0	0	52	483	256	227
PCT7869	MV	683	440	0	0	31	409	211	198
PCT7869	ED	178	190	0	0	22	168	103	65
PCT7869	TO	861	630	0	0	53	577	314	263
PCT7871	MV	702	463	0	0	48	415	219	196
PCT7871	ED	200	157	0	0	12	145	70	75
PCT7871	TO	902	620	0	0	60	560	289	271
PCT7872	MV	675	420	0	0	37	383	184	199
PCT7872	ED	199	185	0	0	15	170	77	93
PCT7872	TO	874	605	0	0	52	553	261	292
PCT7873	MV	689	444	0	0	37	407	227	180
PCT7873	ED	202	213	0	0	19	194	117	77
PCT7873	TO	891	657	0	0	56	601	344	257
PCT7874	MV	370	189	0	0	17	172	100	72
PCT7874	ED	119	107	0	0	11	96	52	44
PCT7874	TO	489	296	0	0	28	268	152	116
PCT7875	MV	500	252	0	0	22	230	142	88
PCT7875	ED	147	115	0	0	6	109	69	40
PCT7875	TO	647	367	0	0	28	339	211	128
PCT7876	MV	462	256	0	0	32	224	130	94
PCT7876	ED	106	91	0	0	14	77	44	33
PCT7876	TO	568	347	0	0	46	301	174	127
PCT7901	MV	399	191	0	0	14	177	120	57
PCT7901	ED	150	65	0	0	1	64	45	19
PCT7901	TO	549	256	0	0	15	241	165	76
PCT7902	MV	680	290	0	0	17	273	171	102
PCT7902	ED	232	141	0	1	10	130	93	37
PCT7902	TO	912	431	0	1	27	403	264	139
PCT7903	MV	623	284	0	0	23	261	178	83
PCT7903	ED	229	123	0	0	9	114	84	30
PCT7903	TO	852	407	0	0	32	375	262	113
PCT7904	MV	680	297	0	0	24	273	179	94
PCT7904	ED	157	118	0	1	8	109	75	34
PCT7904	TO	837	415	0	1	32	382	254	128
PCT7905	MV	684	356	0	0	24	332	192	140
PCT7905	ED	191	183	0	0	11	172	111	61
PCT7905	TO	875	539	0	0	35	504	303	201
PCT7906	MV	599	283	0	0	17	266	160	106
PCT7906	ED	187	117	0	0	14	103	82	21
PCT7906	TO	786	400	0	0	31	369	242	127
PCT7907	MV	704	343	0	0	22	321	215	106
PCT7907	ED	238	164	0	0	16	148	104	44
PCT7907	TO	942	507	0	0	38	469	319	150
PCT7908	MV	752	365	0	0	28	337	210	127
PCT7908	ED	240	169	0	0	20	149	104	45
PCT7908	TO	992	534	0	0	48	486	314	172
PCT7909	MV	558	310	0	0	22	288	188	100
PCT7909	ED	185	140	0	0	5	135	95	40
PCT7909	TO	743	450	0	0	27	423	283	140
PCT7911	MV	666	320	0	0	27	293	178	115
PCT7911	ED	205	129	0	0	10	119	76	43
PCT7911	TO	871	449	0	0	37	412	254	158
PCT7912	MV	800	370	0	0	27	343	214	129
PCT7912	ED	259	177	0	0	23	154	107	47
PCT7912	TO	1059	547	0	0	50	497	321	176
PCT7913	MV	660	350	0	0	15	335	211	124
PCT7913	ED	263	214	0	0	12	202	134	68
PCT7913	TO	923	564	0	0	27	537	345	192
PCT7914	MV	715	389	0	0	39	350	226	124
PCT7914	ED	187	142	0	0	16	126	90	36
PCT7914	TO	902	531	0	0	55	476	316	160
PCT7915	MV	605	290	0	0	20	270	167	103
PCT7915	ED	238	181	0	0	7	174	130	44
PCT7915	TO	843	471	0	0	27	444	297	147
PCT7916	MV	639	334	0	0	24	310	190	120
PCT7916	ED	219	161	0	0	11	150	108	42
PCT7916	TO	858	495	0	0	35	460	298	162
PCT7917	MV	716	356	0	0	27	329	213	116
PCT7917	ED	271	187	0	0	6	181	142	39
PCT7917	TO	987	543	0	0	33	510	355	155
PCT7918	MV	597	297	0	0	20	277	175	102
PCT7918	ED	227	144	0	0	10	134	95	39
PCT7918	TO	824	441	0	0	30	411	270	141
PCT7919	MV	608	309	0	0	24	285	188	97
PCT7919	ED	258	176	0	0	11	165	124	41
PCT7919	TO	866	485	0	0	35	450	312	138
PCT7921	MV	682	309	0	0	18	291	191	100
PCT7921	ED	229	102	0	0	8	94	59	35
PCT7921	TO	911	411	0	0	26	385	250	135
PCT7922	MV	648	314	0	0	17	297	197	100
PCT7922	ED	210	155	0	0	14	141	104	37
PCT7922	TO	858	469	0	0	31	438	301	137
PCT7923	MV	666	336	0	1	19	316	197	119
PCT7923	ED	214	171	0	0	10	161	122	39
PCT7923	TO	880	507	0	1	29	477	319	158
PCT7924	MV	649	302	0	0	11	291	188	103
PCT7924	ED	202	124	0	0	8	116	80	36
PCT7924	TO	851	426	0	0	19	407	268	139
PCT7925	MV	434	225	0	0	19	206	121	85
PCT7925	ED	110	89	0	0	5	84	61	23
PCT7925	TO	544	314	0	0	24	290	182	108
PCT7926	MV	610	337	0	1	24	312	192	120
PCT7926	ED	178	150	0	0	16	134	80	54
PCT7926	TO	788	487	0	1	40	446	272	174
PCT7927	MV	580	334	0	0	32	302	179	123
PCT7927	ED	162	153	0	1	8	144	89	55
PCT7927	TO	742	487	0	1	40	446	268	178
PCT7928	MV	700	395	0	0	27	368	233	135
PCT7928	ED	217	208	0	0	13	195	126	69
PCT7928	TO	917	603	0	0	40	563	359	204
PCT7929	MV	678	422	0	0	34	388	220	168
PCT7929	ED	169	171	0	0	18	153	95	58
PCT7929	TO	847	593	0	0	52	541	315	226
PCT7931	MV	610	376	0	0	45	331	187	144
PCT7931	ED	141	150	0	0	15	135	78	57
PCT7931	TO	751	526	0	0	60	466	265	201
PCT7932	MV	443	277	0	0	27	250	136	114
PCT7932	ED	118	96	0	0	12	84	51	33
PCT7932	TO	561	373	0	0	39	334	187	147
PCT7933	MV	9	6	0	0	0	6	4	2
PCT7933	ED	-1	0	0	0	0	0	0	0
PCT7933	TO	8	6	0	0	0	6	4	2
PCT7934	MV	702	408	0	0	37	371	246	125
PCT7934	ED	182	155	0	0	21	134	105	29
PCT7934	TO	884	563	0	0	58	505	351	154
PCT7935	MV	716	435	0	0	37	398	241	157
PCT7935	ED	227	225	0	0	20	205	141	64
PCT7935	TO	943	660	0	0	57	603	382	221
PCT7936	MV	620	369	0	1	34	334	211	123
PCT7936	ED	236	220	0	0	15	205	131	74
PCT7936	TO	856	589	0	1	49	539	342	197
PCT7937	MV	698	406	0	0	41	365	239	126
PCT7937	ED	202	171	0	0	13	158	124	34
PCT7937	TO	900	577	0	0	54	523	363	160
PCT7938	MV	536	301	0	0	18	283	170	113
PCT7938	ED	215	121	0	0	9	112	80	32
PCT7938	TO	751	422	0	0	27	395	250	145
PCT7939	MV	481	289	0	0	23	266	173	93
PCT7939	ED	205	191	0	0	16	175	112	63
PCT7939	TO	686	480	0	0	39	441	285	156
PCT7941	MV	576	304	0	0	28	276	194	82
PCT7941	ED	196	171	0	0	16	155	84	71
PCT7941	TO	772	475	0	0	44	431	278	153
PCT7942	MV	658	330	0	0	25	305	193	112
PCT7942	ED	274	141	0	0	8	133	90	43
PCT7942	TO	932	471	0	0	33	438	283	155
PCT7943	MV	687	367	0	0	27	340	204	136
PCT7943	ED	213	156	0	0	14	142	84	58
PCT7943	TO	900	523	0	0	41	482	288	194
PCT7944	MV	584	340	0	0	40	300	182	118
PCT7944	ED	230	196	0	0	18	178	107	71
PCT7944	TO	814	536	0	0	58	478	289	189
PCT7945	MV	726	337	0	0	32	305	179	126
PCT7945	ED	228	83	0	0	9	74	54	20
PCT7945	TO	954	420	0	0	41	379	233	146
PCT7946	MV	779	365	0	0	25	340	177	163
PCT7946	ED	206	115	0	0	13	102	71	31
PCT7946	TO	985	480	0	0	38	442	248	194
PCT7947	MV	792	332	0	0	30	302	175	127
PCT7947	ED	194	94	0	0	6	88	56	32
PCT7947	TO	986	426	0	0	36	390	231	159
PCT7948	MV	730	373	0	0	34	339	186	153
PCT7948	ED	200	119	0	0	7	112	68	44
PCT7948	TO	930	492	0	0	41	451	254	197
PCT7949	MV	484	233	0	0	18	215	85	130
PCT7949	ED	106	56	0	0	9	47	26	21
PCT7949	TO	590	289	0	0	27	262	111	151
PCT7951	MV	731	365	0	0	31	334	153	181
PCT7951	ED	156	90	0	0	8	82	48	34
PCT7951	TO	887	455	0	0	39	416	201	215
PCT7952	MV	730	292	0	0	23	269	144	125
PCT7952	ED	182	86	0	0	12	74	42	32
PCT7952	TO	912	378	0	0	35	343	186	157
PCT7953	MV	669	331	0	0	33	298	134	164
PCT7953	ED	161	106	0	0	8	98	51	47
PCT7953	TO	830	437	0	0	41	396	185	211
PCT7954	MV	0	0	0	0	0	0	0	0
PCT7954	ED	0	0	0	0	0	0	0	0
PCT7954	TO	0	0	0	0	0	0	0	0
PCT7955	MV	774	350	0	0	35	315	161	154
PCT7955	ED	173	98	0	0	12	86	43	43
PCT7955	TO	947	448	0	0	47	401	204	197
PCT7956	MV	699	266	0	0	21	245	146	99
PCT7956	ED	170	39	0	0	2	37	22	15
PCT7956	TO	869	305	0	0	23	282	168	114
PCT7957	MV	538	261	0	1	22	238	151	87
PCT7957	ED	135	85	0	0	11	74	45	29
PCT7957	TO	673	346	0	1	33	312	196	116
PCT7958	MV	320	104	0	0	6	98	58	40
PCT7958	ED	-23	0	0	0	0	0	0	0
PCT7958	TO	297	104	0	0	6	98	58	40
PCT7959	MV	541	230	0	0	24	206	131	75
PCT7959	ED	145	68	0	0	8	60	42	18
PCT7959	TO	686	298	0	0	32	266	173	93
PCT9001	MV	314	100	0	0	3	97	58	39
PCT9001	ED	-30	0	0	0	0	0	0	0
PCT9001	TO	284	100	0	0	3	97	58	39
PCT9101	MV	712	377	0	0	31	346	198	148
PCT9101	ED	201	193	0	0	21	172	104	68
PCT9101	TO	913	570	0	0	52	518	302	216
PCT9102	MV	788	393	0	0	37	356	200	156
PCT9102	ED	204	173	0	0	19	154	88	66
PCT9102	TO	992	566	0	0	56	510	288	222
PCT9103	MV	719	381	0	0	39	342	182	160
PCT9103	ED	238	190	0	0	24	166	92	74
PCT9103	TO	957	571	0	0	63	508	274	234
PCT9104	MV	810	381	0	0	39	342	199	143
PCT9104	ED	220	178	0	0	21	157	102	55
PCT9104	TO	1030	559	0	0	60	499	301	198
PCT9105	MV	719	413	0	0	33	380	192	188
PCT9105	ED	199	221	0	0	27	194	112	82
PCT9105	TO	918	634	0	0	60	574	304	270
PCT9106	MV	748	397	0	0	47	350	172	178
PCT9106	ED	198	223	0	0	29	194	113	81
PCT9106	TO	946	620	0	0	76	544	285	259
PCT9107	MV	636	305	0	0	34	271	172	99
PCT9107	ED	208	165	0	0	20	145	100	45
PCT9107	TO	844	470	0	0	54	416	272	144
PCT9108	MV	610	336	0	0	44	292	172	120
PCT9108	ED	200	140	0	0	12	128	81	47
PCT9108	TO	810	476	0	0	56	420	253	167
PCT9109	MV	672	300	0	0	33	267	143	124
PCT9109	ED	211	196	0	0	17	179	94	85
PCT9109	TO	883	496	0	0	50	446	237	209
PCT9111	MV	639	316	0	0	30	286	171	115
PCT9111	ED	195	169	0	0	27	142	91	51
PCT9111	TO	834	485	0	0	57	428	262	166
PCT9112	MV	742	351	0	0	44	307	179	128
PCT9112	ED	219	204	0	0	21	183	109	74
PCT9112	TO	961	555	0	0	65	490	288	202
PCT9113	MV	796	371	0	0	39	332	180	152
PCT9113	ED	208	241	0	0	30	211	116	95
PCT9113	TO	1004	612	0	0	69	543	296	247
PCT9114	MV	659	290	0	0	25	265	165	100
PCT9114	ED	231	182	0	0	27	155	108	47
PCT9114	TO	890	472	0	0	52	420	273	147
PCT9115	MV	699	322	0	0	31	291	184	107
PCT9115	ED	182	179	0	0	28	151	109	42
PCT9115	TO	881	501	0	0	59	442	293	149
PCT9116	MV	782	345	0	0	24	321	187	134
PCT9116	ED	179	174	0	0	22	152	100	52
PCT9116	TO	961	519	0	0	46	473	287	186
PCT9117	MV	629	326	0	0	33	293	146	147
PCT9117	ED	171	195	0	0	15	180	96	84
PCT9117	TO	800	521	0	0	48	473	242	231
PCT9118	MV	742	340	0	0	35	305	168	137
PCT9118	ED	242	223	0	0	28	195	132	63
PCT9118	TO	984	563	0	0	63	500	300	200
PCT9119	MV	703	387	0	0	33	354	180	174
PCT9119	ED	197	156	0	0	18	138	81	57
PCT9119	TO	900	543	0	0	51	492	261	231
PCT9121	MV	735	335	0	0	33	302	149	153
PCT9121	ED	218	184	0	0	21	163	97	66
PCT9121	TO	953	519	0	0	54	465	246	219
PCT9122	MV	775	364	0	0	32	332	181	151
PCT9122	ED	192	160	0	0	25	135	79	56
PCT9122	TO	967	524	0	0	57	467	260	207
PCT9123	MV	661	319	0	0	23	296	160	136
PCT9123	ED	191	187	0	0	30	157	93	64
PCT9123	TO	852	506	0	0	53	453	253	200
PCT9124	MV	736	351	0	0	21	330	180	150
PCT9124	ED	167	159	0	0	13	146	102	44
PCT9124	TO	903	510	0	0	34	476	282	194
PCT9125	MV	681	358	0	0	29	329	184	145
PCT9125	ED	188	152	0	0	16	136	75	61
PCT9125	TO	869	510	0	0	45	465	259	206
PCT9126	MV	819	385	0	0	46	339	165	174
PCT9126	ED	194	200	0	0	22	178	98	80
PCT9126	TO	1013	585	0	0	68	517	263	254
PCT9127	MV	748	380	0	0	52	328	172	156
PCT9127	ED	223	220	0	0	22	198	111	87
PCT9127	TO	971	600	0	0	74	526	283	243
PCT9128	MV	628	333	0	0	31	302	132	170
PCT9128	ED	190	195	0	0	22	173	98	75
PCT9128	TO	818	528	0	0	53	475	230	245
PCT9129	MV	587	271	0	0	22	249	151	98
PCT9129	ED	151	153	0	0	10	143	90	53
PCT9129	TO	738	424	0	0	32	392	241	151
PCT9131	MV	596	285	0	0	24	261	129	132
PCT9131	ED	138	152	0	0	18	134	85	49
PCT9131	TO	734	437	0	0	42	395	214	181
PCT9132	MV	627	262	0	0	37	225	144	81
PCT9132	ED	194	172	0	0	21	151	99	52
PCT9132	TO	821	434	0	0	58	376	243	133
PCT9133	MV	808	381	0	0	41	340	189	151
PCT9133	ED	209	211	0	0	15	196	109	87
PCT9133	TO	1017	592	0	0	56	536	298	238
PCT9134	MV	736	327	0	0	27	300	160	140
PCT9134	ED	155	103	0	0	12	91	54	37
PCT9134	TO	891	430	0	0	39	391	214	177
PCT9135	MV	640	304	0	0	27	277	159	118
PCT9135	ED	182	154	0	0	17	137	67	70
PCT9135	TO	822	458	0	0	44	414	226	188
PCT9136	MV	706	368	0	0	47	321	184	137
PCT9136	ED	212	162	0	0	20	142	95	47
PCT9136	TO	918	530	0	0	67	463	279	184
PCT9137	MV	806	387	0	0	41	346	204	142
PCT9137	ED	209	175	0	0	16	159	110	49
PCT9137	TO	1015	562	0	0	57	505	314	191
PCT9138	MV	770	398	0	0	33	365	193	172
PCT9138	ED	175	149	0	0	13	136	93	43
PCT9138	TO	945	547	0	0	46	501	286	215
PCT9139	MV	828	422	0	0	36	386	179	207
PCT9139	ED	190	174	0	0	22	152	81	71
PCT9139	TO	1018	596	0	0	58	538	260	278
PCT9141	MV	789	418	0	0	57	361	202	159
PCT9141	ED	184	172	0	0	17	155	88	67
PCT9141	TO	973	590	0	0	74	516	290	226
PCT9142	MV	747	364	0	0	29	335	207	128
PCT9142	ED	239	204	0	0	21	183	111	72
PCT9142	TO	986	568	0	0	50	518	318	200
PCT9143	MV	705	359	0	0	32	327	161	166
PCT9143	ED	209	170	0	0	11	159	82	77
PCT9143	TO	914	529	0	0	43	486	243	243
PCT9144	MV	767	376	0	0	35	341	193	148
PCT9144	ED	203	213	0	0	20	193	126	67
PCT9144	TO	970	589	0	0	55	534	319	215
PCT9145	MV	681	334	0	0	27	307	158	149
PCT9145	ED	194	176	0	0	14	162	88	74
PCT9145	TO	875	510	0	0	41	469	246	223
PCT9146	MV	725	353	0	0	39	314	195	119
PCT9146	ED	160	189	0	0	26	163	101	62
PCT9146	TO	885	542	0	0	65	477	296	181
PCT9147	MV	765	373	0	0	30	343	188	155
PCT9147	ED	225	208	0	0	21	187	117	70
PCT9147	TO	990	581	0	0	51	530	305	225
PCT9148	MV	779	397	0	0	35	362	191	171
PCT9148	ED	235	226	0	0	25	201	111	90
PCT9148	TO	1014	623	0	0	60	563	302	261
PCT9149	MV	813	384	0	0	31	353	194	159
PCT9149	ED	178	248	0	0	24	224	146	78
PCT9149	TO	991	632	0	0	55	577	340	237
PCT9151	MV	693	351	0	0	43	308	183	125
PCT9151	ED	168	114	0	0	7	107	57	50
PCT9151	TO	861	465	0	0	50	415	240	175
PCT9152	MV	550	196	0	0	18	178	113	65
PCT9152	ED	187	142	0	1	15	126	96	30
PCT9152	TO	737	338	0	1	33	304	209	95
PCT9201	MV	785	357	0	0	43	314	210	104
PCT9201	ED	186	226	0	0	23	203	140	63
PCT9201	TO	971	583	0	0	66	517	350	167
PCT9202	MV	819	368	0	1	54	313	160	153
PCT9202	ED	177	223	0	0	26	197	97	100
PCT9202	TO	996	591	0	1	80	510	257	253
PCT9203	MV	847	373	0	0	63	310	107	203
PCT9203	ED	155	188	0	0	29	159	75	84
PCT9203	TO	1002	561	0	0	92	469	182	287
PCT9204	MV	686	309	0	0	44	265	82	183
PCT9204	ED	176	195	0	1	33	161	60	101
PCT9204	TO	862	504	0	1	77	426	142	284
PCT9205	MV	621	288	0	0	41	247	105	142
PCT9205	ED	115	150	0	0	26	124	58	66
PCT9205	TO	736	438	0	0	67	371	163	208
PCT9206	MV	741	350	0	0	42	308	105	203
PCT9206	ED	188	194	0	0	41	153	59	94
PCT9206	TO	929	544	0	0	83	461	164	297
PCT9207	MV	824	369	0	0	38	331	148	183
PCT9207	ED	165	192	0	0	30	162	66	96
PCT9207	TO	989	561	0	0	68	493	214	279
PCT9208	MV	808	357	0	1	47	309	125	184
PCT9208	ED	179	179	0	0	25	154	66	88
PCT9208	TO	987	536	0	1	72	463	191	272
PCT9209	MV	615	275	0	0	30	245	90	155
PCT9209	ED	156	170	0	1	37	132	57	75
PCT9209	TO	771	445	0	1	67	377	147	230
PCT9211	MV	730	314	0	0	42	272	123	149
PCT9211	ED	161	154	0	0	23	131	48	83
PCT9211	TO	891	468	0	0	65	403	171	232
PCT9212	MV	671	284	0	1	35	248	99	149
PCT9212	ED	137	170	0	0	39	131	57	74
PCT9212	TO	808	454	0	1	74	379	156	223
PCT9213	MV	776	349	0	0	42	307	145	162
PCT9213	ED	161	195	0	0	35	160	81	79
PCT9213	TO	937	544	0	0	77	467	226	241
PCT9214	MV	517	236	0	0	22	214	97	117
PCT9214	ED	110	135	0	0	28	107	32	75
PCT9214	TO	627	371	0	0	50	321	129	192
PCT9215	MV	524	246	0	0	23	223	93	130
PCT9215	ED	120	131	0	0	21	110	35	75
PCT9215	TO	644	377	0	0	44	333	128	205
PCT9216	MV	669	264	0	0	42	222	85	137
PCT9216	ED	155	172	0	0	23	149	78	71
PCT9216	TO	824	436	0	0	65	371	163	208
PCT9217	MV	588	268	0	0	22	246	110	136
PCT9217	ED	117	133	0	0	11	122	57	65
PCT9217	TO	705	401	0	0	33	368	167	201
PCT9218	MV	652	278	0	0	34	244	111	133
PCT9218	ED	164	158	0	0	17	141	60	81
PCT9218	TO	816	436	0	0	51	385	171	214
PCT9219	MV	646	288	0	0	41	247	128	119
PCT9219	ED	144	168	0	0	24	144	81	63
PCT9219	TO	790	456	0	0	65	391	209	182
PCT9221	MV	562	322	0	0	27	295	85	210
PCT9221	ED	89	140	0	0	23	117	30	87
PCT9221	TO	651	462	0	0	50	412	115	297
PCT9222	MV	773	373	0	0	41	332	109	223
PCT9222	ED	137	174	0	0	27	147	54	93
PCT9222	TO	910	547	0	0	68	479	163	316
PCT9223	MV	558	266	0	0	28	238	78	160
PCT9223	ED	109	113	0	0	15	98	34	64
PCT9223	TO	667	379	0	0	43	336	112	224
PCT9224	MV	768	380	0	0	35	345	135	210
PCT9224	ED	181	166	0	0	28	138	56	82
PCT9224	TO	949	546	0	0	63	483	191	292
PCT9225	MV	757	303	0	0	38	265	121	144
PCT9225	ED	169	219	0	0	33	186	87	99
PCT9225	TO	926	522	0	0	71	451	208	243
PCT9226	MV	741	355	0	0	48	307	113	194
PCT9226	ED	155	148	0	0	16	132	62	70
PCT9226	TO	896	503	0	0	64	439	175	264
PCT9227	MV	605	371	0	0	42	329	111	218
PCT9227	ED	124	149	0	0	10	139	53	86
PCT9227	TO	729	520	0	0	52	468	164	304
PCT9228	MV	578	314	0	0	27	287	93	194
PCT9228	ED	160	179	0	0	28	151	56	95
PCT9228	TO	738	493	0	0	55	438	149	289
PCT9229	MV	460	257	0	0	33	224	90	134
PCT9229	ED	119	122	0	0	15	107	40	67
PCT9229	TO	579	379	0	0	48	331	130	201
PCT9231	MV	726	352	0	0	35	317	139	178
PCT9231	ED	236	255	0	0	35	220	116	104
PCT9231	TO	962	607	0	0	70	537	255	282
PCT9232	MV	608	293	0	0	34	259	93	166
PCT9232	ED	126	155	0	0	17	138	62	76
PCT9232	TO	734	448	0	0	51	397	155	242
PCT9233	MV	668	330	0	0	45	285	83	202
PCT9233	ED	150	186	0	0	31	155	51	104
PCT9233	TO	818	516	0	0	76	440	134	306
PCT9234	MV	643	319	0	0	27	292	124	168
PCT9234	ED	91	144	0	0	26	118	48	70
PCT9234	TO	734	463	0	0	53	410	172	238
PCT9235	MV	703	365	0	1	38	326	93	233
PCT9235	ED	160	194	0	0	23	171	65	106
PCT9235	TO	863	559	0	1	61	497	158	339
PCT9236	MV	537	282	0	0	27	255	108	147
PCT9236	ED	136	137	0	0	23	114	41	73
PCT9236	TO	673	419	0	0	50	369	149	220
PCT9237	MV	779	395	0	2	42	351	127	224
PCT9237	ED	118	182	0	0	28	154	71	83
PCT9237	TO	897	577	0	2	70	505	198	307
PCT9238	MV	687	330	0	0	41	289	101	188
PCT9238	ED	118	174	0	0	30	144	65	79
PCT9238	TO	805	504	0	0	71	433	166	267
PCT9239	MV	740	390	0	0	58	332	126	206
PCT9239	ED	124	157	0	0	28	129	54	75
PCT9239	TO	864	547	0	0	86	461	180	281
PCT9241	MV	819	403	0	0	42	361	146	215
PCT9241	ED	141	195	0	0	25	170	72	98
PCT9241	TO	960	598	0	0	67	531	218	313
PCT9242	MV	771	348	0	0	46	302	131	171
PCT9242	ED	172	213	0	0	36	177	95	82
PCT9242	TO	943	561	0	0	82	479	226	253
PCT9243	MV	480	241	0	0	31	210	89	121
PCT9243	ED	123	138	0	0	21	117	62	55
PCT9243	TO	603	379	0	0	52	327	151	176
PCT9244	MV	756	394	0	0	57	337	143	194
PCT9244	ED	154	182	0	0	20	162	88	74
PCT9244	TO	910	576	0	0	77	499	231	268
PCT9245	MV	616	300	0	0	43	257	114	143
PCT9245	ED	98	127	0	0	16	111	53	58
PCT9245	TO	714	427	0	0	59	368	167	201
PCT9246	MV	815	430	0	0	41	389	170	219
PCT9246	ED	155	194	0	0	32	162	73	89
PCT9246	TO	970	624	0	0	73	551	243	308
PCT9247	MV	764	380	0	0	37	343	158	185
PCT9247	ED	148	204	0	0	34	170	89	81
PCT9247	TO	912	584	0	0	71	513	247	266
PCT9248	MV	757	358	0	0	41	317	165	152
PCT9248	ED	150	190	0	0	27	163	98	65
PCT9248	TO	907	548	0	0	68	480	263	217
PCT9249	MV	724	379	0	0	46	333	160	173
PCT9249	ED	191	213	0	0	23	190	91	99
PCT9249	TO	915	592	0	0	69	523	251	272
PCT9251	MV	792	392	0	0	48	344	162	182
PCT9251	ED	174	235	0	0	33	202	100	102
PCT9251	TO	966	627	0	0	81	546	262	284
PCT9252	MV	811	381	0	0	44	337	164	173
PCT9252	ED	142	175	0	0	13	162	83	79
PCT9252	TO	953	556	0	0	57	499	247	252
PCT9253	MV	599	300	0	0	28	272	113	159
PCT9253	ED	162	148	0	0	19	129	79	50
PCT9253	TO	761	448	0	0	47	401	192	209
PCT9254	MV	758	414	0	0	38	376	169	207
PCT9254	ED	163	181	0	0	29	152	84	68
PCT9254	TO	921	595	0	0	67	528	253	275
PCT9255	MV	436	196	0	0	32	164	87	77
PCT9255	ED	114	133	0	0	20	113	63	50
PCT9255	TO	550	329	0	0	52	277	150	127
PCT9256	MV	367	169	0	0	17	152	75	77
PCT9256	ED	95	114	0	0	13	101	55	46
PCT9256	TO	462	283	0	0	30	253	130	123
PCT9257	MV	359	161	0	0	21	140	96	44
PCT9257	ED	-39	6	0	0	1	5	4	1
PCT9257	TO	320	167	0	0	22	145	100	45
PCT9258	MV	583	306	0	0	33	273	137	136
PCT9258	ED	120	145	0	0	19	126	72	54
PCT9258	TO	703	451	0	0	52	399	209	190
PCT9401	MV	796	358	0	0	27	331	221	110
PCT9401	ED	242	177	0	0	14	163	125	38
PCT9401	TO	1038	535	0	0	41	494	346	148
PCT9402	MV	775	377	0	0	37	340	212	128
PCT9402	ED	242	159	0	0	12	147	95	52
PCT9402	TO	1017	536	0	0	49	487	307	180
PCT9403	MV	731	346	0	0	20	326	193	133
PCT9403	ED	190	126	0	0	12	114	82	32
PCT9403	TO	921	472	0	0	32	440	275	165
PCT9404	MV	753	345	0	0	28	317	172	145
PCT9404	ED	191	155	0	0	18	137	86	51
PCT9404	TO	944	500	0	0	46	454	258	196
PCT9405	MV	629	276	0	1	34	241	128	113
PCT9405	ED	151	104	0	0	5	99	58	41
PCT9405	TO	780	380	0	1	39	340	186	154
PCT9406	MV	695	327	0	0	31	296	165	131
PCT9406	ED	188	152	0	0	11	141	72	69
PCT9406	TO	883	479	0	0	42	437	237	200
PCT9407	MV	712	368	0	0	32	336	183	153
PCT9407	ED	201	132	0	0	24	108	61	47
PCT9407	TO	913	500	0	0	56	444	244	200
PCT9408	MV	711	321	0	0	36	285	185	100
PCT9408	ED	152	126	0	0	11	115	77	38
PCT9408	TO	863	447	0	0	47	400	262	138
PCT9409	MV	443	226	0	0	25	201	119	82
PCT9409	ED	158	127	0	0	9	118	83	35
PCT9409	TO	601	353	0	0	34	319	202	117
PCT9411	MV	816	376	0	0	37	339	225	114
PCT9411	ED	191	135	0	0	10	125	85	40
PCT9411	TO	1007	511	0	0	47	464	310	154
PCT9412	MV	668	339	0	0	31	308	162	146
PCT9412	ED	202	139	0	0	14	125	75	50
PCT9412	TO	870	478	0	0	45	433	237	196
PCT9413	MV	757	375	0	0	51	324	180	144
PCT9413	ED	179	127	0	0	11	116	76	40
PCT9413	TO	936	502	0	0	62	440	256	184
PCT9414	MV	734	360	0	0	44	316	163	153
PCT9414	ED	186	108	0	0	10	98	50	48
PCT9414	TO	920	468	0	0	54	414	213	201
PCT9415	MV	634	314	0	0	24	290	144	146
PCT9415	ED	154	98	0	0	8	90	54	36
PCT9415	TO	788	412	0	0	32	380	198	182
PCT9416	MV	769	391	0	0	55	336	166	170
PCT9416	ED	230	143	0	0	13	130	70	60
PCT9416	TO	999	534	0	0	68	466	236	230
PCT9417	MV	629	321	0	0	34	287	147	140
PCT9417	ED	145	110	0	0	7	103	60	43
PCT9417	TO	774	431	0	0	41	390	207	183
PCT9418	MV	631	310	0	0	34	276	122	154
PCT9418	ED	188	122	0	0	10	112	71	41
PCT9418	TO	819	432	0	0	44	388	193	195
PCT9419	MV	736	369	0	0	38	331	137	194
PCT9419	ED	173	108	0	0	10	98	44	54
PCT9419	TO	909	477	0	0	48	429	181	248
PCT9421	MV	752	338	0	0	34	304	138	166
PCT9421	ED	173	112	0	0	9	103	54	49
PCT9421	TO	925	450	0	0	43	407	192	215
PCT9422	MV	831	412	0	0	42	370	194	176
PCT9422	ED	270	148	0	0	17	131	79	52
PCT9422	TO	1101	560	0	0	59	501	273	228
PCT9423	MV	714	316	0	0	33	283	143	140
PCT9423	ED	190	121	0	0	11	110	62	48
PCT9423	TO	904	437	0	0	44	393	205	188
PCT9424	MV	799	384	0	0	39	345	171	174
PCT9424	ED	210	116	0	0	12	104	62	42
PCT9424	TO	1009	500	0	0	51	449	233	216
PCT9425	MV	789	346	0	0	48	298	158	140
PCT9425	ED	187	115	0	0	14	101	64	37
PCT9425	TO	976	461	0	0	62	399	222	177
PCT9426	MV	697	323	0	0	31	292	139	153
PCT9426	ED	156	104	0	0	17	87	40	47
PCT9426	TO	853	427	0	0	48	379	179	200
PCT9427	MV	799	381	0	0	33	348	149	199
PCT9427	ED	188	115	0	0	19	96	51	45
PCT9427	TO	987	496	0	0	52	444	200	244
PCT9428	MV	811	351	0	0	36	315	159	156
PCT9428	ED	179	115	0	0	13	102	61	41
PCT9428	TO	990	466	0	0	49	417	220	197
PCT9429	MV	709	343	0	0	34	309	141	168
PCT9429	ED	197	124	0	0	18	106	53	53
PCT9429	TO	906	467	0	0	52	415	194	221
PCT9431	MV	832	411	0	0	45	366	150	216
PCT9431	ED	204	125	0	0	9	116	66	50
PCT9431	TO	1036	536	0	0	54	482	216	266
PCT9432	MV	743	358	0	0	45	313	159	154
PCT9432	ED	215	118	0	0	13	105	54	51
PCT9432	TO	958	476	0	0	58	418	213	205
PCT9433	MV	794	373	0	0	45	328	156	172
PCT9433	ED	164	95	0	0	9	86	36	50
PCT9433	TO	958	468	0	0	54	414	192	222
PCT9434	MV	785	387	0	0	40	347	172	175
PCT9434	ED	227	163	0	0	21	142	81	61
PCT9434	TO	1012	550	0	0	61	489	253	236
PCT9435	MV	779	366	0	0	39	327	155	172
PCT9435	ED	225	158	0	0	10	148	97	51
PCT9435	TO	1004	524	0	0	49	475	252	223
PCT9436	MV	842	386	0	0	29	357	152	205
PCT9436	ED	226	129	0	0	15	114	53	61
PCT9436	TO	1068	515	0	0	44	471	205	266
PCT9437	MV	736	376	0	0	33	343	159	184
PCT9437	ED	191	130	0	0	9	121	75	46
PCT9437	TO	927	506	0	0	42	464	234	230
PCT9438	MV	837	416	0	0	37	379	167	212
PCT9438	ED	152	84	0	0	6	78	42	36
PCT9438	TO	989	500	0	0	43	457	209	248
PCT9439	MV	718	343	0	0	26	317	134	183
PCT9439	ED	199	112	0	0	15	97	53	44
PCT9439	TO	917	455	0	0	41	414	187	227
PCT9441	MV	778	396	0	0	43	353	207	146
PCT9441	ED	193	125	0	0	18	107	67	40
PCT9441	TO	971	521	0	0	61	460	274	186
PCT9442	MV	830	378	0	0	45	333	188	145
PCT9442	ED	210	159	0	0	14	145	82	63
PCT9442	TO	1040	537	0	0	59	478	270	208
PCT9443	MV	759	362	0	0	35	327	178	149
PCT9443	ED	196	109	0	1	10	98	58	40
PCT9443	TO	955	471	0	1	45	425	236	189
PCT9444	MV	768	340	0	0	23	317	149	168
PCT9444	ED	197	94	0	0	12	82	45	37
PCT9444	TO	965	434	0	0	35	399	194	205
PCT9445	MV	829	405	0	0	41	364	175	189
PCT9445	ED	167	114	0	0	10	104	58	46
PCT9445	TO	996	519	0	0	51	468	233	235
PCT9446	MV	900	465	0	0	50	415	199	216
PCT9446	ED	216	146	0	0	16	130	72	58
PCT9446	TO	1116	611	0	0	66	545	271	274
PCT9447	MV	729	392	0	0	28	364	163	201
PCT9447	ED	192	146	0	0	13	133	67	66
PCT9447	TO	921	538	0	0	41	497	230	267
PCT9448	MV	742	346	0	0	32	314	155	159
PCT9448	ED	198	128	0	0	12	116	73	43
PCT9448	TO	940	474	0	0	44	430	228	202
PCT9449	MV	719	340	0	1	37	302	146	156
PCT9449	ED	162	98	0	1	9	88	47	41
PCT9449	TO	881	438	0	2	46	390	193	197
PCT9451	MV	353	178	0	0	17	161	74	87
PCT9451	ED	88	55	0	0	5	50	30	20
PCT9451	TO	441	233	0	0	22	211	104	107
PCT9452	MV	647	334	0	0	32	302	149	153
PCT9452	ED	195	134	0	0	14	120	54	66
PCT9452	TO	842	468	0	0	46	422	203	219
PCT9453	MV	409	217	0	0	19	198	83	115
PCT9453	ED	115	70	0	0	7	63	27	36
PCT9453	TO	524	287	0	0	26	261	110	151
PCT9501	MV	158	92	0	1	12	79	49	30
PCT9501	ED	-8	2	0	0	1	1	1	0
PCT9501	TO	150	94	0	1	13	80	50	30
PCT9502	MV	294	136	0	0	19	117	70	47
PCT9502	ED	-43	2	0	0	0	2	1	1
PCT9502	TO	251	138	0	0	19	119	71	48
PCT9503	MV	550	260	0	0	38	222	125	97
PCT9503	ED	150	83	0	0	7	76	48	28
PCT9503	TO	700	343	0	0	45	298	173	125
PCT9505	MV	589	296	0	0	34	262	177	85
PCT9505	ED	176	113	0	0	10	103	58	45
PCT9505	TO	765	409	0	0	44	365	235	130
PCT9506	MV	547	232	0	0	18	214	118	96
PCT9506	ED	207	132	0	0	16	116	83	33
PCT9506	TO	754	364	0	0	34	330	201	129
PCT9507	MV	556	305	0	1	28	276	163	113
PCT9507	ED	160	155	0	0	17	138	82	56
PCT9507	TO	716	460	0	1	45	414	245	169
PCT9508	MV	632	317	0	0	23	294	196	98
PCT9508	ED	148	141	0	0	11	130	85	45
PCT9508	TO	780	458	0	0	34	424	281	143
PCT9509	MV	585	296	0	0	22	274	147	127
PCT9509	ED	142	134	0	0	10	124	86	38
PCT9509	TO	727	430	0	0	32	398	233	165
PCT9511	MV	458	240	0	0	18	222	129	93
PCT9511	ED	176	122	0	0	11	111	67	44
PCT9511	TO	634	362	0	0	29	333	196	137
PCT9512	MV	617	327	0	0	33	294	181	113
PCT9512	ED	160	136	0	0	10	126	84	42
PCT9512	TO	777	463	0	0	43	420	265	155
PCT9513	MV	686	334	0	0	37	297	190	107
PCT9513	ED	191	133	0	0	12	121	88	33
PCT9513	TO	877	467	0	0	49	418	278	140
PCT9514	MV	713	352	0	0	41	311	175	136
PCT9514	ED	183	172	0	0	19	153	106	47
PCT9514	TO	896	524	0	0	60	464	281	183
PCT9515	MV	543	304	0	0	30	274	146	128
PCT9515	ED	169	135	0	0	15	120	69	51
PCT9515	TO	712	439	0	0	45	394	215	179
PCT9516	MV	705	366	0	0	30	336	205	131
PCT9516	ED	184	158	0	0	14	144	83	61
PCT9516	TO	889	524	0	0	44	480	288	192
PCT9517	MV	626	335	0	0	23	312	180	132
PCT9517	ED	162	137	0	0	22	115	83	32
PCT9517	TO	788	472	0	0	45	427	263	164
PCT9518	MV	642	315	0	0	28	287	181	106
PCT9518	ED	146	149	0	0	11	138	91	47
PCT9518	TO	788	464	0	0	39	425	272	153
PCT9519	MV	693	368	0	0	30	338	204	134
PCT9519	ED	198	170	0	0	14	156	98	58
PCT9519	TO	891	538	0	0	44	494	302	192
PCT9521	MV	687	352	0	0	28	324	187	137
PCT9521	ED	214	193	0	0	19	174	111	63
PCT9521	TO	901	545	0	0	47	498	298	200
PCT9701	MV	498	269	0	0	26	243	143	100
PCT9701	ED	156	135	0	0	9	126	80	46
PCT9701	TO	654	404	0	0	35	369	223	146
PCT9702	MV	554	305	0	0	25	280	146	134
PCT9702	ED	166	148	0	0	11	137	85	52
PCT9702	TO	720	453	0	0	36	417	231	186
PCT9703	MV	809	403	0	0	47	356	185	171
PCT9703	ED	182	143	0	0	13	130	73	57
PCT9703	TO	991	546	0	0	60	486	258	228
PCT9704	MV	760	422	0	0	45	377	171	206
PCT9704	ED	199	197	0	0	20	177	109	68
PCT9704	TO	959	619	0	0	65	554	280	274
PCT9705	MV	754	421	0	0	42	379	190	189
PCT9705	ED	175	144	0	0	15	129	77	52
PCT9705	TO	929	565	0	0	57	508	267	241
PCT9706	MV	57	34	0	0	2	32	16	16
PCT9706	ED	-8	0	0	0	0	0	0	0
PCT9706	TO	49	34	0	0	2	32	16	16
PCT9707	MV	687	358	0	0	25	333	139	194
PCT9707	ED	139	102	0	0	11	91	43	48
PCT9707	TO	826	460	0	0	36	424	182	242
PCT9708	MV	786	429	0	0	55	374	205	169
PCT9708	ED	175	158	0	0	15	143	86	57
PCT9708	TO	961	587	0	0	70	517	291	226
PCT9709	MV	831	427	0	0	47	380	165	215
PCT9709	ED	209	181	0	0	14	167	91	76
PCT9709	TO	1040	608	0	0	61	547	256	291
PCT9711	MV	502	307	0	0	34	273	133	140
PCT9711	ED	144	139	0	0	14	125	57	68
PCT9711	TO	646	446	0	0	48	398	190	208
PCT9712	MV	534	335	0	0	33	302	117	185
PCT9712	ED	127	117	0	0	7	110	51	59
PCT9712	TO	661	452	0	0	40	412	168	244
PCT9713	MV	747	389	0	0	31	358	160	198
PCT9713	ED	203	137	0	0	14	123	68	55
PCT9713	TO	950	526	0	0	45	481	228	253
PCT9714	MV	795	446	0	0	41	405	152	253
PCT9714	ED	156	133	0	0	8	125	58	67
PCT9714	TO	951	579	0	0	49	530	210	320
PCT9715	MV	449	241	0	0	28	213	65	148
PCT9715	ED	130	134	0	0	8	126	42	84
PCT9715	TO	579	375	0	0	36	339	107	232
PCT9716	MV	745	398	0	0	40	358	158	200
PCT9716	ED	221	164	0	0	18	146	73	73
PCT9716	TO	966	562	0	0	58	504	231	273
PCT9717	MV	753	436	0	0	37	399	152	247
PCT9717	ED	224	145	0	0	15	130	58	72
PCT9717	TO	977	581	0	0	52	529	210	319
PCT9718	MV	749	449	0	0	36	413	180	233
PCT9718	ED	152	144	0	0	12	132	56	76
PCT9718	TO	901	593	0	0	48	545	236	309
PCT9719	MV	747	461	0	0	41	420	158	262
PCT9719	ED	173	151	0	0	8	143	59	84
PCT9719	TO	920	612	0	0	49	563	217	346
PCT9721	MV	498	288	0	0	29	259	95	164
PCT9721	ED	164	133	0	0	8	125	46	79
PCT9721	TO	662	421	0	0	37	384	141	243
PCT9722	MV	513	315	0	0	25	290	126	164
PCT9722	ED	84	76	0	0	9	67	29	38
PCT9722	TO	597	391	0	0	34	357	155	202
PCT9723	MV	436	223	0	0	15	208	56	152
PCT9723	ED	72	44	0	0	4	40	10	30
PCT9723	TO	508	267	0	0	19	248	66	182
PCT9724	MV	851	451	0	0	38	413	126	287
PCT9724	ED	169	99	0	0	7	92	39	53
PCT9724	TO	1020	550	0	0	45	505	165	340
PCT9725	MV	814	436	0	0	35	401	162	239
PCT9725	ED	157	96	0	0	11	85	26	59
PCT9725	TO	971	532	0	0	46	486	188	298
PCT9726	MV	630	216	0	0	27	189	126	63
PCT9726	ED	-14	102	0	0	9	93	59	34
PCT9726	TO	616	318	0	0	36	282	185	97
PCT9727	MV	404	227	0	2	19	206	75	131
PCT9727	ED	56	33	0	0	5	28	8	20
PCT9727	TO	460	260	0	2	24	234	83	151
PCT9728	MV	751	446	0	0	35	411	116	295
PCT9728	ED	212	137	0	0	16	121	45	76
PCT9728	TO	963	583	0	0	51	532	161	371
PCT9729	MV	654	335	0	0	27	308	82	226
PCT9729	ED	164	129	0	0	6	123	38	85
PCT9729	TO	818	464	0	0	33	431	120	311
PCT9731	MV	436	245	0	0	24	221	75	146
PCT9731	ED	143	111	0	0	7	104	32	72
PCT9731	TO	579	356	0	0	31	325	107	218
PCT9732	MV	78	47	0	0	4	43	17	26
PCT9732	ED	-5	0	0	0	0	0	0	0
PCT9732	TO	73	47	0	0	4	43	17	26
PCT9733	MV	261	161	0	0	7	154	81	73
PCT9733	ED	-21	0	0	0	0	0	0	0
PCT9733	TO	240	161	0	0	7	154	81	73
PCT9734	MV	473	285	0	0	23	262	97	165
PCT9734	ED	131	109	0	0	9	100	34	66
PCT9734	TO	604	394	0	0	32	362	131	231
PCT9735	MV	650	386	0	0	32	354	140	214
PCT9735	ED	170	133	0	0	16	117	47	70
PCT9735	TO	820	519	0	0	48	471	187	284
PCT9736	MV	586	323	0	0	26	297	116	181
PCT9736	ED	150	153	0	0	14	139	63	76
PCT9736	TO	736	476	0	0	40	436	179	257
PCT9737	MV	637	387	0	0	37	350	163	187
PCT9737	ED	154	135	0	1	7	127	64	63
PCT9737	TO	791	522	0	1	44	477	227	250
PCT9738	MV	688	319	0	0	33	286	180	106
PCT9738	ED	150	64	0	0	5	59	30	29
PCT9738	TO	838	383	0	0	38	345	210	135
PCT9739	MV	674	270	0	0	15	255	181	74
PCT9739	ED	115	88	0	0	6	82	70	12
PCT9739	TO	789	358	0	0	21	337	251	86
PCT9741	MV	837	173	0	0	22	151	128	23
PCT9741	ED	-396	10	0	0	2	8	6	2
PCT9741	TO	441	183	0	0	24	159	134	25
PCT9742	MV	530	229	0	0	15	214	80	134
PCT9742	ED	165	99	0	0	9	90	40	50
PCT9742	TO	695	328	0	0	24	304	120	184
PCT9743	MV	913	400	0	0	32	368	220	148
PCT9743	ED	227	170	0	0	19	151	114	37
PCT9743	TO	1140	570	0	0	51	519	334	185
PCT9744	MV	783	333	0	0	40	293	190	103
PCT9744	ED	160	123	0	0	17	106	74	32
PCT9744	TO	943	456	0	0	57	399	264	135
PCT9745	MV	790	317	0	0	34	283	197	86
PCT9745	ED	202	128	0	0	12	116	80	36
PCT9745	TO	992	445	0	0	46	399	277	122
PCT9746	MV	714	373	0	0	18	355	147	208
PCT9746	ED	189	119	0	0	11	108	44	64
PCT9746	TO	903	492	0	0	29	463	191	272
PCT9747	MV	772	401	0	0	37	364	191	173
PCT9747	ED	204	145	0	0	13	132	68	64
PCT9747	TO	976	546	0	0	50	496	259	237
PCT9748	MV	746	425	0	0	39	386	179	207
PCT9748	ED	167	116	0	0	11	105	54	51
PCT9748	TO	913	541	0	0	50	491	233	258
PCT9749	MV	750	289	0	0	18	271	171	100
PCT9749	ED	188	108	0	0	9	99	63	36
PCT9749	TO	938	397	0	0	27	370	234	136
PCT9751	MV	857	472	0	0	47	425	193	232
PCT9751	ED	214	153	0	0	18	135	66	69
PCT9751	TO	1071	625	0	0	65	560	259	301
PCT9752	MV	563	327	0	0	25	302	141	161
PCT9752	ED	134	108	0	0	9	99	51	48
PCT9752	TO	697	435	0	0	34	401	192	209
PCT9753	MV	617	298	0	0	22	276	154	122
PCT9753	ED	145	123	0	0	3	120	67	53
PCT9753	TO	762	421	0	0	25	396	221	175
PCT9754	MV	545	317	0	0	25	292	181	111
PCT9754	ED	162	113	0	0	9	104	62	42
PCT9754	TO	707	430	0	0	34	396	243	153
PCT9755	MV	441	238	0	0	25	213	117	96
PCT9755	ED	139	99	0	0	7	92	42	50
PCT9755	TO	580	337	0	0	32	305	159	146
PCT9756	MV	805	364	0	0	33	331	167	164
PCT9756	ED	162	106	0	0	10	96	57	39
PCT9756	TO	967	470	0	0	43	427	224	203
PCT9801	MV	320	163	0	0	17	146	84	62
PCT9801	ED	88	52	0	0	5	47	24	23
PCT9801	TO	408	215	0	0	22	193	108	85
PCT9900	MV	0	0	0	0	0	0	0	0
PCT9900	ED	0	0	0	0	0	0	0	0
PCT9900	TO	0	0	0	0	0	0	0	0
PCT9901	MV	0	0	0	0	0	0	0	0
PCT9901	ED	0	0	0	0	0	0	0	0
PCT9901	TO	0	0	0	0	0	0	0	0
PCT9902	MV	0	0	0	0	0	0	0	0
PCT9902	ED	0	0	0	0	0	0	0	0
PCT9902	TO	0	0	0	0	0	0	0	0
CONG12	MV	355594	174452	0	37	17191	157224	84065	73159
CONG12	ED	90254	71265	0	14	7721	63530	37504	26026
CONG12	TO	445848	245717	0	51	24912	220754	121569	99185
CONG14	MV	47252	22340	0	5	1890	20445	10298	10147
CONG14	ED	10799	6956	0	1	614	6341	3457	2884
CONG14	TO	58051	29296	0	6	2504	26786	13755	13031
ASSM17	MV	232787	114347	0	27	10944	103376	57138	46238
ASSM17	ED	59635	43919	0	9	4504	39406	24120	15286
ASSM17	TO	292422	158266	0	36	15448	142782	81258	61524
ASSM19	MV	170059	82445	0	15	8137	74293	37225	37068
ASSM19	ED	41418	34302	0	6	3831	30465	16841	13624
ASSM19	TO	211477	116747	0	21	11968	104758	54066	50692
SUPV1	MV	33868	16565	0	0	1617	14948	8239	6709
SUPV1	ED	9248	8530	0	1	944	7585	4589	2996
SUPV1	TO	43116	25095	0	1	2561	22533	12828	9705
SUPV2	MV	41435	19971	0	6	2344	17621	7453	10168
SUPV2	ED	8611	10149	0	2	1486	8661	4060	4601
SUPV2	TO	50046	30120	0	8	3830	26282	11513	14769
SUPV3	MV	31943	14408	0	3	1529	12876	6873	6003
SUPV3	ED	7434	6360	0	2	832	5526	3283	2243
SUPV3	TO	39377	20768	0	5	2361	18402	10156	8246
SUPV4	MV	35049	16862	0	2	1689	15171	7686	7485
SUPV4	ED	9045	5910	0	2	586	5322	3087	2235
SUPV4	TO	44094	22772	0	4	2275	20493	10773	9720
SUPV5	MV	41966	21496	0	5	2122	19369	11368	8001
SUPV5	ED	10934	9272	0	1	952	8319	5294	3025
SUPV5	TO	52900	30768	0	6	3074	27688	16662	11026
SUPV6	MV	35755	15225	0	6	1533	13686	7406	6280
SUPV6	ED	7940	4383	0	2	506	3875	2376	1499
SUPV6	TO	43695	19608	0	8	2039	17561	9782	7779
SUPV7	MV	38887	20717	0	2	1876	18839	8815	10024
SUPV7	ED	8556	7211	0	1	629	6581	3322	3259
SUPV7	TO	47443	27928	0	3	2505	25420	12137	13283
SUPV8	MV	46370	27474	0	7	2556	24911	13397	11514
SUPV8	ED	11807	11114	0	0	1049	10065	5975	4090
SUPV8	TO	58177	38588	0	7	3605	34976	19372	15604
SUPV9	MV	33165	16755	0	4	1331	15420	9353	6067
SUPV9	ED	10098	7086	0	3	582	6501	4370	2131
SUPV9	TO	43263	23841	0	7	1913	21921	13723	8198
SUPV10	MV	33765	13891	0	4	1343	12544	6834	5710
SUPV10	ED	9348	4201	0	0	401	3800	2288	1512
SUPV10	TO	43113	18092	0	4	1744	16344	9122	7222
SUPV11	MV	30643	13428	0	3	1141	12284	6939	5345
SUPV11	ED	8032	4005	0	1	368	3636	2317	1319
SUPV11	TO	38675	17433	0	4	1509	15920	9256	6664
NEIG1	MV	15464	5936	0	1	588	5347	2972	2375
NEIG1	ED	5021	1551	0	0	143	1408	856	552
NEIG1	TO	20485	7487	0	1	731	6755	3828	2927
NEIG2	MV	14029	6273	0	1	735	5537	2851	2686
NEIG2	ED	3238	2776	0	0	399	2377	1359	1018
NEIG2	TO	17267	9049	0	1	1134	7914	4210	3704
NEIG3	MV	22050	9495	0	4	963	8528	5207	3321
NEIG3	ED	5969	3742	0	1	432	3309	2221	1088
NEIG3	TO	28019	13237	0	5	1395	11837	7428	4409
NEIG4	MV	5630	3491	0	0	334	3157	1581	1576
NEIG4	ED	1430	1237	0	0	132	1105	564	541
NEIG4	TO	7060	4728	0	0	466	4262	2145	2117
NEIG5	MV	22700	10117	0	3	896	9218	5157	4061
NEIG5	ED	5893	2969	0	1	277	2691	1676	1015
NEIG5	TO	28593	13086	0	4	1173	11909	6833	5076
NEIG6	MV	11526	5963	0	1	572	5390	3193	2197
NEIG6	ED	2336	2800	0	1	281	2518	1574	944
NEIG6	TO	13862	8763	0	2	853	7908	4767	3141
NEIG7	MV	9818	4127	0	0	313	3814	2204	1610
NEIG7	ED	2577	1302	0	0	115	1187	785	402
NEIG7	TO	12395	5429	0	0	428	5001	2989	2012
NEIG8	MV	7628	4025	0	0	372	3653	2090	1563
NEIG8	ED	2030	1847	0	0	179	1668	1038	630
NEIG8	TO	9658	5872	0	0	551	5321	3128	2193
NEIG9	MV	7416	3138	0	0	291	2847	1566	1281
NEIG9	ED	842	924	0	0	92	832	508	324
NEIG9	TO	8258	4062	0	0	383	3679	2074	1605
NEIG10	MV	8172	3949	0	1	419	3529	1853	1676
NEIG10	ED	1850	1947	0	1	212	1734	1010	724
NEIG10	TO	10022	5896	0	2	631	5263	2863	2400
NEIG11	MV	33509	15520	0	5	1858	13657	5847	7810
NEIG11	ED	5931	7800	0	2	1195	6603	3121	3482
NEIG11	TO	39440	23320	0	7	3053	20260	8968	11292
NEIG12	MV	23572	11845	0	1	898	10946	6768	4178
NEIG12	ED	7433	5298	0	2	436	4860	3362	1498
NEIG12	TO	31005	17143	0	3	1334	15806	10130	5676
NEIG14	MV	6791	3984	0	2	357	3625	2205	1420
NEIG14	ED	1942	1788	0	1	156	1631	1081	550
NEIG14	TO	8733	5772	0	3	513	5256	3286	1970
NEIG15	MV	5779	2672	0	0	248	2424	1196	1228
NEIG15	ED	1309	1165	0	1	144	1020	564	456
NEIG15	TO	7088	3837	0	1	392	3444	1760	1684
NEIG13	MV	13553	8149	0	5	789	7355	3798	3557
NEIG13	ED	3435	3370	0	0	303	3067	1756	1311
NEIG13	TO	16988	11519	0	5	1092	10422	5554	4868
NEIG26	MV	7830	3522	0	1	303	3218	1699	1519
NEIG26	ED	1802	947	0	0	89	858	513	345
NEIG26	TO	9632	4469	0	1	392	4076	2212	1864
NEIG16	MV	14623	6798	0	4	688	6106	3138	2968
NEIG16	ED	2733	2413	0	1	261	2151	1270	881
NEIG16	TO	17356	9211	0	5	949	8257	4408	3849
NEIG17	MV	29447	14398	0	0	1410	12988	7176	5812
NEIG17	ED	8178	7475	0	0	828	6647	4009	2638
NEIG17	TO	37625	21873	0	0	2238	19635	11185	8450
NEIG19	MV	7165	4013	0	0	337	3676	2159	1517
NEIG19	ED	2406	1869	0	0	163	1706	1029	677
NEIG19	TO	9571	5882	0	0	500	5382	3188	2194
NEIG18	MV	6458	3411	0	1	361	3049	1190	1859
NEIG18	ED	1563	1828	0	0	241	1587	716	871
NEIG18	TO	8021	5239	0	1	602	4636	1906	2730
NEIG20	MV	20910	8905	0	3	880	8022	4044	3978
NEIG20	ED	4167	2452	0	1	285	2166	1218	948
NEIG20	TO	25077	11357	0	4	1165	10188	5262	4926
NEIG21	MV	34606	16636	0	2	1664	14970	7567	7403
NEIG21	ED	8887	5783	0	2	577	5204	3004	2200
NEIG21	TO	43493	22419	0	4	2241	20174	10571	9603
NEIG22	MV	15381	9289	0	1	847	8441	4559	3882
NEIG22	ED	3512	3613	0	0	336	3277	1995	1282
NEIG22	TO	18893	12902	0	1	1183	11718	6554	5164
NEIG23	MV	6638	2508	0	0	231	2277	1232	1045
NEIG23	ED	1850	598	0	0	57	541	323	218
NEIG23	TO	8488	3106	0	0	288	2818	1555	1263
NEIG24	MV	28439	16094	0	2	1466	14626	6485	8141
NEIG24	ED	6935	5684	0	1	489	5194	2472	2722
NEIG24	TO	35374	21778	0	3	1955	19820	8957	10863
NEIG25	MV	23712	12534	0	4	1261	11269	6626	4643
NEIG25	ED	7784	5043	0	0	513	4530	2937	1593
NEIG25	TO	31496	17577	0	4	1774	15799	9563	6236
