area_id	subtotal_type	RSReg	RSCst	RSRej	RSOvr	RSUnd	RSTot	5:YES	6:NO
ALLPCTS	TO	503899	265563	0	53	17430	248080	204128	43952
ALLPCTS	ED	101847	72177	0	13	4886	67278	57004	10274
ALLPCTS	MV	402052	193386	0	40	12544	180802	147124	33678
PCT1101	MV	447	211	0	0	14	197	153	44
PCT1101	ED	115	60	0	0	5	55	45	10
PCT1101	TO	562	271	0	0	19	252	198	54
PCT1102	MV	771	364	0	0	15	349	246	103
PCT1102	ED	233	158	0	0	9	149	117	32
PCT1102	TO	1004	522	0	0	24	498	363	135
PCT1103	MV	748	360	0	0	19	341	263	78
PCT1103	ED	223	142	0	0	6	136	109	27
PCT1103	TO	971	502	0	0	25	477	372	105
PCT1104	MV	750	340	0	0	12	328	262	66
PCT1104	ED	268	119	0	0	5	114	92	22
PCT1104	TO	1018	459	0	0	17	442	354	88
PCT1106	MV	597	246	0	0	15	231	158	73
PCT1106	ED	174	96	0	1	6	89	68	21
PCT1106	TO	771	342	0	1	21	320	226	94
PCT1107	MV	606	281	0	0	13	268	183	85
PCT1107	ED	145	76	0	0	7	69	57	12
PCT1107	TO	751	357	0	0	20	337	240	97
PCT1108	MV	721	350	0	0	16	334	264	70
PCT1108	ED	202	114	0	0	9	105	83	22
PCT1108	TO	923	464	0	0	25	439	347	92
PCT1109	MV	650	278	0	0	12	266	180	86
PCT1109	ED	172	97	0	0	4	93	74	19
PCT1109	TO	822	375	0	0	16	359	254	105
PCT1111	MV	845	346	0	0	16	330	231	99
PCT1111	ED	201	118	0	0	6	112	89	23
PCT1111	TO	1046	464	0	0	22	442	320	122
PCT1112	MV	642	271	0	0	13	258	193	65
PCT1112	ED	160	76	0	0	5	71	59	12
PCT1112	TO	802	347	0	0	18	329	252	77
PCT1113	MV	674	280	0	0	14	266	186	80
PCT1113	ED	121	65	0	0	6	59	49	10
PCT1113	TO	795	345	0	0	20	325	235	90
PCT1114	MV	768	324	0	0	22	302	238	64
PCT1114	ED	223	97	0	0	9	88	78	10
PCT1114	TO	991	421	0	0	31	390	316	74
PCT1115	MV	741	287	0	0	16	271	195	76
PCT1115	ED	195	85	0	0	2	83	67	16
PCT1115	TO	936	372	0	0	18	354	262	92
PCT1116	MV	709	305	0	0	17	288	216	72
PCT1116	ED	222	118	0	0	7	111	102	9
PCT1116	TO	931	423	0	0	24	399	318	81
PCT1117	MV	659	250	0	0	14	236	175	61
PCT1117	ED	187	71	0	0	3	68	59	9
PCT1117	TO	846	321	0	0	17	304	234	70
PCT1118	MV	843	353	0	0	14	339	244	95
PCT1118	ED	222	100	0	0	9	91	71	20
PCT1118	TO	1065	453	0	0	23	430	315	115
PCT1119	MV	659	302	0	0	12	290	225	65
PCT1119	ED	138	73	0	0	6	67	63	4
PCT1119	TO	797	375	0	0	18	357	288	69
PCT1121	MV	556	261	0	0	18	243	160	83
PCT1121	ED	149	81	0	0	6	75	54	21
PCT1121	TO	705	342	0	0	24	318	214	104
PCT1122	MV	519	243	0	0	13	230	161	69
PCT1122	ED	118	70	0	0	5	65	54	11
PCT1122	TO	637	313	0	0	18	295	215	80
PCT1123	MV	722	254	0	0	14	240	164	76
PCT1123	ED	216	89	0	0	6	83	67	16
PCT1123	TO	938	343	0	0	20	323	231	92
PCT1124	MV	621	240	0	2	7	231	175	56
PCT1124	ED	208	72	0	0	3	69	60	9
PCT1124	TO	829	312	0	2	10	300	235	65
PCT1125	MV	916	353	0	0	31	322	223	99
PCT1125	ED	181	65	0	0	6	59	53	6
PCT1125	TO	1097	418	0	0	37	381	276	105
PCT1126	MV	811	304	0	0	16	288	220	68
PCT1126	ED	201	68	0	0	1	67	53	14
PCT1126	TO	1012	372	0	0	17	355	273	82
PCT1127	MV	742	290	0	0	12	278	183	95
PCT1127	ED	223	99	0	0	3	96	75	21
PCT1127	TO	965	389	0	0	15	374	258	116
PCT1128	MV	733	292	0	0	14	278	185	93
PCT1128	ED	146	59	0	0	6	53	42	11
PCT1128	TO	879	351	0	0	20	331	227	104
PCT1129	MV	788	310	0	0	22	288	199	89
PCT1129	ED	248	108	0	0	13	95	68	27
PCT1129	TO	1036	418	0	0	35	383	267	116
PCT1131	MV	693	276	0	0	21	255	179	76
PCT1131	ED	167	60	0	0	4	56	49	7
PCT1131	TO	860	336	0	0	25	311	228	83
PCT1132	MV	837	368	0	0	24	344	251	93
PCT1132	ED	195	59	0	0	0	59	38	21
PCT1132	TO	1032	427	0	0	24	403	289	114
PCT1133	MV	716	332	0	0	12	320	241	79
PCT1133	ED	159	74	0	0	3	71	51	20
PCT1133	TO	875	406	0	0	15	391	292	99
PCT1134	MV	584	285	0	0	10	275	176	99
PCT1134	ED	183	80	0	0	7	73	64	9
PCT1134	TO	767	365	0	0	17	348	240	108
PCT1135	MV	464	216	0	0	5	211	151	60
PCT1135	ED	92	50	0	0	1	49	40	9
PCT1135	TO	556	266	0	0	6	260	191	69
PCT1136	MV	710	335	0	0	15	320	240	80
PCT1136	ED	157	77	0	0	4	73	63	10
PCT1136	TO	867	412	0	0	19	393	303	90
PCT1141	MV	836	387	0	0	18	369	265	104
PCT1141	ED	220	123	0	0	4	119	92	27
PCT1141	TO	1056	510	0	0	22	488	357	131
PCT1142	MV	721	322	0	0	26	296	236	60
PCT1142	ED	175	87	0	0	3	84	73	11
PCT1142	TO	896	409	0	0	29	380	309	71
PCT1143	MV	823	358	0	0	22	336	240	96
PCT1143	ED	226	113	0	0	7	106	91	15
PCT1143	TO	1049	471	0	0	29	442	331	111
PCT1144	MV	727	319	0	0	9	310	215	95
PCT1144	ED	220	121	0	0	9	112	86	26
PCT1144	TO	947	440	0	0	18	422	301	121
PCT1145	MV	752	411	0	0	25	386	274	112
PCT1145	ED	153	114	0	0	8	106	83	23
PCT1145	TO	905	525	0	0	33	492	357	135
PCT1146	MV	837	359	0	0	15	344	271	73
PCT1146	ED	217	109	0	0	7	102	78	24
PCT1146	TO	1054	468	0	0	22	446	349	97
PCT1147	MV	671	303	0	0	11	292	211	81
PCT1147	ED	214	107	0	0	5	102	82	20
PCT1147	TO	885	410	0	0	16	394	293	101
PCT1148	MV	804	364	0	0	16	348	241	107
PCT1148	ED	224	116	0	0	8	108	85	23
PCT1148	TO	1028	480	0	0	24	456	326	130
PCT1149	MV	709	316	0	1	21	294	211	83
PCT1149	ED	230	118	0	0	9	109	83	26
PCT1149	TO	939	434	0	1	30	403	294	109
PCT1151	MV	0	0	0	0	0	0	0	0
PCT1151	ED	0	0	0	0	0	0	0	0
PCT1151	TO	0	0	0	0	0	0	0	0
PCT1152	MV	710	308	0	0	16	292	216	76
PCT1152	ED	180	85	0	0	7	78	58	20
PCT1152	TO	890	393	0	0	23	370	274	96
PCT1153	MV	730	283	0	0	17	266	203	63
PCT1153	ED	210	116	0	0	9	107	76	31
PCT1153	TO	940	399	0	0	26	373	279	94
PCT1154	MV	0	0	0	0	0	0	0	0
PCT1154	ED	0	0	0	0	0	0	0	0
PCT1154	TO	0	0	0	0	0	0	0	0
PCT7001	MV	632	322	0	0	21	301	262	39
PCT7001	ED	141	101	0	0	6	95	83	12
PCT7001	TO	773	423	0	0	27	396	345	51
PCT7002	MV	598	259	0	0	19	240	206	34
PCT7002	ED	116	88	0	0	3	85	73	12
PCT7002	TO	714	347	0	0	22	325	279	46
PCT7003	MV	759	427	0	0	24	403	345	58
PCT7003	ED	147	144	0	0	12	132	108	24
PCT7003	TO	906	571	0	0	36	535	453	82
PCT7004	MV	764	411	0	0	24	387	333	54
PCT7004	ED	149	142	0	0	9	133	110	23
PCT7004	TO	913	553	0	0	33	520	443	77
PCT7005	MV	697	342	0	0	21	321	288	33
PCT7005	ED	162	162	0	0	17	145	133	12
PCT7005	TO	859	504	0	0	38	466	421	45
PCT7006	MV	728	349	0	0	25	324	284	40
PCT7006	ED	204	149	0	0	11	138	114	24
PCT7006	TO	932	498	0	0	36	462	398	64
PCT7007	MV	777	427	0	0	27	400	343	57
PCT7007	ED	180	168	0	0	13	155	134	21
PCT7007	TO	957	595	0	0	40	555	477	78
PCT7008	MV	732	362	0	0	27	335	278	57
PCT7008	ED	177	189	0	0	11	178	152	26
PCT7008	TO	909	551	0	0	38	513	430	83
PCT7009	MV	752	387	0	0	26	361	300	61
PCT7009	ED	119	91	0	0	4	87	73	14
PCT7009	TO	871	478	0	0	30	448	373	75
PCT7011	MV	703	228	0	0	17	211	182	29
PCT7011	ED	270	87	0	0	4	83	74	9
PCT7011	TO	973	315	0	0	21	294	256	38
PCT7012	MV	999	479	0	0	34	445	382	63
PCT7012	ED	227	203	0	0	11	192	168	24
PCT7012	TO	1226	682	0	0	45	637	550	87
PCT7013	MV	984	271	0	0	16	255	227	28
PCT7013	ED	155	151	0	0	10	141	131	10
PCT7013	TO	1139	422	0	0	26	396	358	38
PCT7014	MV	609	295	0	0	18	277	247	30
PCT7014	ED	110	111	0	0	14	97	84	13
PCT7014	TO	719	406	0	0	32	374	331	43
PCT7015	MV	128	39	0	0	5	34	30	4
PCT7015	ED	-18	0	0	0	0	0	0	0
PCT7015	TO	110	39	0	0	5	34	30	4
PCT7016	MV	654	235	0	0	16	219	160	59
PCT7016	ED	278	75	0	0	7	68	58	10
PCT7016	TO	932	310	0	0	23	287	218	69
PCT7017	MV	543	182	0	0	19	163	134	29
PCT7017	ED	238	53	0	0	8	45	40	5
PCT7017	TO	781	235	0	0	27	208	174	34
PCT7018	MV	847	353	0	0	20	333	244	89
PCT7018	ED	200	56	0	0	4	52	46	6
PCT7018	TO	1047	409	0	0	24	385	290	95
PCT7019	MV	733	351	0	0	25	326	239	87
PCT7019	ED	167	73	0	0	8	65	54	11
PCT7019	TO	900	424	0	0	33	391	293	98
PCT7021	MV	679	268	0	0	17	251	205	46
PCT7021	ED	288	106	0	0	9	97	84	13
PCT7021	TO	967	374	0	0	26	348	289	59
PCT7022	MV	770	301	0	0	27	274	226	48
PCT7022	ED	193	54	0	0	2	52	48	4
PCT7022	TO	963	355	0	0	29	326	274	52
PCT7023	MV	687	328	0	0	16	312	249	63
PCT7023	ED	233	71	0	0	6	65	57	8
PCT7023	TO	920	399	0	0	22	377	306	71
PCT7024	MV	251	50	0	0	3	47	42	5
PCT7024	ED	190	20	0	0	3	17	17	0
PCT7024	TO	441	70	0	0	6	64	59	5
PCT7025	MV	316	93	0	0	5	88	77	11
PCT7025	ED	167	39	0	0	1	38	34	4
PCT7025	TO	483	132	0	0	6	126	111	15
PCT7026	MV	818	332	0	1	13	318	209	109
PCT7026	ED	192	72	0	0	4	68	52	16
PCT7026	TO	1010	404	0	1	17	386	261	125
PCT7027	MV	676	266	0	0	19	247	181	66
PCT7027	ED	220	96	0	0	8	88	69	19
PCT7027	TO	896	362	0	0	27	335	250	85
PCT7028	MV	585	215	0	0	13	202	165	37
PCT7028	ED	271	97	0	0	7	90	74	16
PCT7028	TO	856	312	0	0	20	292	239	53
PCT7029	MV	642	205	0	0	20	185	148	37
PCT7029	ED	267	39	0	0	2	37	32	5
PCT7029	TO	909	244	0	0	22	222	180	42
PCT7030	MV	654	274	0	0	9	265	168	97
PCT7030	ED	141	58	0	0	2	56	36	20
PCT7030	TO	795	332	0	0	11	321	204	117
PCT7031	MV	621	257	0	1	23	233	189	44
PCT7031	ED	73	48	0	0	6	42	33	9
PCT7031	TO	694	305	0	1	29	275	222	53
PCT7032	MV	642	264	0	0	19	245	203	42
PCT7032	ED	239	51	0	0	2	49	38	11
PCT7032	TO	881	315	0	0	21	294	241	53
PCT7033	MV	549	210	0	0	17	193	152	41
PCT7033	ED	229	86	0	0	7	79	62	17
PCT7033	TO	778	296	0	0	24	272	214	58
PCT7034	MV	620	136	0	0	15	121	113	8
PCT7034	ED	318	57	0	0	3	54	46	8
PCT7034	TO	938	193	0	0	18	175	159	16
PCT7035	MV	567	232	0	0	17	215	174	41
PCT7035	ED	152	52	0	0	5	47	41	6
PCT7035	TO	719	284	0	0	22	262	215	47
PCT7036	MV	780	259	0	0	12	247	167	80
PCT7036	ED	194	39	0	0	1	38	30	8
PCT7036	TO	974	298	0	0	13	285	197	88
PCT7037	MV	433	62	0	0	4	58	47	11
PCT7037	ED	313	38	0	0	5	33	31	2
PCT7037	TO	746	100	0	0	9	91	78	13
PCT7038	MV	758	304	0	0	19	285	192	93
PCT7038	ED	203	58	0	0	8	50	40	10
PCT7038	TO	961	362	0	0	27	335	232	103
PCT7039	MV	636	240	0	0	14	226	151	75
PCT7039	ED	201	104	0	0	6	98	69	29
PCT7039	TO	837	344	0	0	20	324	220	104
PCT7041	MV	70	29	0	0	4	25	17	8
PCT7041	ED	-4	0	0	0	0	0	0	0
PCT7041	TO	66	29	0	0	4	25	17	8
PCT7042	MV	514	219	0	0	9	210	164	46
PCT7042	ED	146	58	0	0	2	56	43	13
PCT7042	TO	660	277	0	0	11	266	207	59
PCT7043	MV	754	290	0	0	16	274	195	79
PCT7043	ED	224	78	0	0	3	75	56	19
PCT7043	TO	978	368	0	0	19	349	251	98
PCT7044	MV	586	133	0	0	4	129	103	26
PCT7044	ED	266	33	0	0	2	31	27	4
PCT7044	TO	852	166	0	0	6	160	130	30
PCT7045	MV	632	264	0	0	14	250	173	77
PCT7045	ED	154	53	0	0	2	51	34	17
PCT7045	TO	786	317	0	0	16	301	207	94
PCT7046	MV	334	130	0	0	4	126	88	38
PCT7046	ED	96	48	0	0	2	46	36	10
PCT7046	TO	430	178	0	0	6	172	124	48
PCT7047	MV	730	309	0	0	19	290	190	100
PCT7047	ED	153	62	0	0	4	58	47	11
PCT7047	TO	883	371	0	0	23	348	237	111
PCT7048	MV	685	263	0	0	12	251	192	59
PCT7048	ED	196	56	0	0	6	50	38	12
PCT7048	TO	881	319	0	0	18	301	230	71
PCT7049	MV	616	239	0	0	10	229	144	85
PCT7049	ED	210	70	0	0	4	66	53	13
PCT7049	TO	826	309	0	0	14	295	197	98
PCT7051	MV	715	301	0	0	19	282	178	104
PCT7051	ED	165	70	0	0	7	63	50	13
PCT7051	TO	880	371	0	0	26	345	228	117
PCT7052	MV	721	291	0	0	9	282	197	85
PCT7052	ED	185	84	0	0	5	79	68	11
PCT7052	TO	906	375	0	0	14	361	265	96
PCT7053	MV	542	226	0	0	29	197	147	50
PCT7053	ED	43	40	0	0	4	36	32	4
PCT7053	TO	585	266	0	0	33	233	179	54
PCT7054	MV	862	305	0	0	16	289	235	54
PCT7054	ED	274	105	0	0	5	100	73	27
PCT7054	TO	1136	410	0	0	21	389	308	81
PCT7055	MV	732	289	0	0	16	273	221	52
PCT7055	ED	94	76	0	0	7	69	60	9
PCT7055	TO	826	365	0	0	23	342	281	61
PCT7056	MV	618	269	0	0	20	249	216	33
PCT7056	ED	87	119	0	0	13	106	92	14
PCT7056	TO	705	388	0	0	33	355	308	47
PCT7101	MV	162	99	0	0	6	93	88	5
PCT7101	ED	-15	0	0	0	0	0	0	0
PCT7101	TO	147	99	0	0	6	93	88	5
PCT7201	MV	788	374	0	0	20	354	294	60
PCT7201	ED	147	98	0	0	12	86	73	13
PCT7201	TO	935	472	0	0	32	440	367	73
PCT7202	MV	707	303	0	0	22	281	222	59
PCT7202	ED	144	123	0	0	11	112	96	16
PCT7202	TO	851	426	0	0	33	393	318	75
PCT7203	MV	693	316	0	0	31	285	237	48
PCT7203	ED	186	148	0	0	18	130	111	19
PCT7203	TO	879	464	0	0	49	415	348	67
PCT7204	MV	773	411	0	0	40	371	311	60
PCT7204	ED	126	116	0	0	19	97	84	13
PCT7204	TO	899	527	0	0	59	468	395	73
PCT7205	MV	724	357	0	0	26	331	273	58
PCT7205	ED	147	133	0	0	14	119	96	23
PCT7205	TO	871	490	0	0	40	450	369	81
PCT7206	MV	299	127	0	0	9	118	98	20
PCT7206	ED	78	76	0	0	4	72	65	7
PCT7206	TO	377	203	0	0	13	190	163	27
PCT7207	MV	744	329	0	0	25	304	251	53
PCT7207	ED	123	117	0	0	9	108	96	12
PCT7207	TO	867	446	0	0	34	412	347	65
PCT7208	MV	492	248	0	0	26	222	181	41
PCT7208	ED	78	60	0	0	3	57	51	6
PCT7208	TO	570	308	0	0	29	279	232	47
PCT7209	MV	595	338	0	0	26	312	269	43
PCT7209	ED	52	63	0	0	4	59	48	11
PCT7209	TO	647	401	0	0	30	371	317	54
PCT7301	MV	812	312	0	0	16	296	246	50
PCT7301	ED	202	112	0	0	10	102	87	15
PCT7301	TO	1014	424	0	0	26	398	333	65
PCT7302	MV	713	345	0	0	22	323	262	61
PCT7302	ED	136	116	0	0	9	107	98	9
PCT7302	TO	849	461	0	0	31	430	360	70
PCT7303	MV	869	370	0	0	22	348	284	64
PCT7303	ED	199	141	0	0	10	131	114	17
PCT7303	TO	1068	511	0	0	32	479	398	81
PCT7304	MV	802	359	0	0	26	333	254	79
PCT7304	ED	199	163	0	0	10	153	136	17
PCT7304	TO	1001	522	0	0	36	486	390	96
PCT7305	MV	713	372	0	0	23	349	263	86
PCT7305	ED	154	141	0	0	10	131	106	25
PCT7305	TO	867	513	0	0	33	480	369	111
PCT7306	MV	801	365	0	0	34	331	260	71
PCT7306	ED	243	152	0	1	17	134	113	21
PCT7306	TO	1044	517	0	1	51	465	373	92
PCT7307	MV	605	264	0	0	11	253	203	50
PCT7307	ED	169	101	0	0	8	93	77	16
PCT7307	TO	774	365	0	0	19	346	280	66
PCT7308	MV	520	249	0	0	10	239	189	50
PCT7308	ED	105	126	0	0	8	118	98	20
PCT7308	TO	625	375	0	0	18	357	287	70
PCT7309	MV	691	317	0	0	28	289	247	42
PCT7309	ED	167	156	0	0	13	143	125	18
PCT7309	TO	858	473	0	0	41	432	372	60
PCT7311	MV	698	325	0	0	22	303	261	42
PCT7311	ED	208	169	0	0	9	160	143	17
PCT7311	TO	906	494	0	0	31	463	404	59
PCT7312	MV	699	384	0	0	23	361	292	69
PCT7312	ED	111	120	0	0	8	112	90	22
PCT7312	TO	810	504	0	0	31	473	382	91
PCT7313	MV	818	365	0	0	20	345	279	66
PCT7313	ED	185	115	0	0	15	100	87	13
PCT7313	TO	1003	480	0	0	35	445	366	79
PCT7314	MV	612	222	0	0	19	203	154	49
PCT7314	ED	147	56	0	0	7	49	41	8
PCT7314	TO	759	278	0	0	26	252	195	57
PCT7315	MV	570	202	0	0	9	193	151	42
PCT7315	ED	195	117	0	0	6	111	89	22
PCT7315	TO	765	319	0	0	15	304	240	64
PCT7316	MV	654	255	0	0	28	227	183	44
PCT7316	ED	178	100	0	0	12	88	82	6
PCT7316	TO	832	355	0	0	40	315	265	50
PCT7317	MV	744	339	0	0	24	315	254	61
PCT7317	ED	146	107	0	0	8	99	89	10
PCT7317	TO	890	446	0	0	32	414	343	71
PCT7318	MV	605	289	0	0	23	266	229	37
PCT7318	ED	118	99	0	0	12	87	67	20
PCT7318	TO	723	388	0	0	35	353	296	57
PCT7319	MV	861	340	0	0	27	313	262	51
PCT7319	ED	188	113	0	0	12	101	84	17
PCT7319	TO	1049	453	0	0	39	414	346	68
PCT7321	MV	557	200	0	0	20	180	138	42
PCT7321	ED	102	62	0	0	3	59	46	13
PCT7321	TO	659	262	0	0	23	239	184	55
PCT7322	MV	742	292	0	0	24	268	207	61
PCT7322	ED	146	25	0	0	0	25	23	2
PCT7322	TO	888	317	0	0	24	293	230	63
PCT7323	MV	789	362	0	0	34	328	280	48
PCT7323	ED	167	126	0	0	11	115	93	22
PCT7323	TO	956	488	0	0	45	443	373	70
PCT7324	MV	586	253	0	0	23	230	187	43
PCT7324	ED	151	88	0	0	5	83	68	15
PCT7324	TO	737	341	0	0	28	313	255	58
PCT7325	MV	714	315	0	0	32	283	236	47
PCT7325	ED	172	121	0	0	10	111	93	18
PCT7325	TO	886	436	0	0	42	394	329	65
PCT7326	MV	685	298	0	0	25	273	212	61
PCT7326	ED	174	116	0	0	13	103	90	13
PCT7326	TO	859	414	0	0	38	376	302	74
PCT7327	MV	561	224	0	0	23	201	147	54
PCT7327	ED	126	37	0	0	1	36	30	6
PCT7327	TO	687	261	0	0	24	237	177	60
PCT7328	MV	829	321	0	0	35	286	233	53
PCT7328	ED	173	46	0	0	6	40	35	5
PCT7328	TO	1002	367	0	0	41	326	268	58
PCT7329	MV	556	222	0	0	20	202	167	35
PCT7329	ED	95	56	0	0	3	53	46	7
PCT7329	TO	651	278	0	0	23	255	213	42
PCT7331	MV	710	358	0	0	32	326	274	52
PCT7331	ED	160	129	0	0	15	114	92	22
PCT7331	TO	870	487	0	0	47	440	366	74
PCT7332	MV	654	256	0	0	21	235	208	27
PCT7332	ED	136	113	0	0	3	110	99	11
PCT7332	TO	790	369	0	0	24	345	307	38
PCT7333	MV	822	385	0	0	34	351	291	60
PCT7333	ED	193	161	0	0	12	149	128	21
PCT7333	TO	1015	546	0	0	46	500	419	81
PCT7334	MV	686	301	0	0	17	284	248	36
PCT7334	ED	133	105	0	0	6	99	85	14
PCT7334	TO	819	406	0	0	23	383	333	50
PCT7335	MV	788	385	0	0	33	352	292	60
PCT7335	ED	146	144	0	0	11	133	123	10
PCT7335	TO	934	529	0	0	44	485	415	70
PCT7336	MV	778	396	0	1	23	372	292	80
PCT7336	ED	176	128	0	0	13	115	97	18
PCT7336	TO	954	524	0	1	36	487	389	98
PCT7337	MV	772	379	0	0	30	349	284	65
PCT7337	ED	125	84	0	0	6	78	65	13
PCT7337	TO	897	463	0	0	36	427	349	78
PCT7338	MV	769	353	0	0	27	326	268	58
PCT7338	ED	126	70	0	0	6	64	54	10
PCT7338	TO	895	423	0	0	33	390	322	68
PCT7339	MV	605	262	0	0	18	244	207	37
PCT7339	ED	150	89	0	0	4	85	76	9
PCT7339	TO	755	351	0	0	22	329	283	46
PCT7341	MV	675	288	0	0	29	259	215	44
PCT7341	ED	178	131	0	0	6	125	114	11
PCT7341	TO	853	419	0	0	35	384	329	55
PCT7342	MV	673	316	0	0	18	298	254	44
PCT7342	ED	231	200	0	1	13	186	164	22
PCT7342	TO	904	516	0	1	31	484	418	66
PCT7343	MV	554	242	0	0	18	224	204	20
PCT7343	ED	150	116	0	0	12	104	93	11
PCT7343	TO	704	358	0	0	30	328	297	31
PCT7344	MV	863	378	0	0	27	351	297	54
PCT7344	ED	201	160	0	0	7	153	133	20
PCT7344	TO	1064	538	0	0	34	504	430	74
PCT7345	MV	903	418	0	0	23	395	352	43
PCT7345	ED	211	170	0	0	11	159	142	17
PCT7345	TO	1114	588	0	0	34	554	494	60
PCT7346	MV	680	280	0	1	15	264	232	32
PCT7346	ED	209	126	0	0	13	113	102	11
PCT7346	TO	889	406	0	1	28	377	334	43
PCT7347	MV	833	356	0	1	34	321	299	22
PCT7347	ED	170	98	0	0	6	92	85	7
PCT7347	TO	1003	454	0	1	40	413	384	29
PCT7348	MV	649	268	0	0	19	249	219	30
PCT7348	ED	194	100	0	0	6	94	84	10
PCT7348	TO	843	368	0	0	25	343	303	40
PCT7349	MV	710	310	0	0	21	289	249	40
PCT7349	ED	202	104	0	0	6	98	90	8
PCT7349	TO	912	414	0	0	27	387	339	48
PCT7501	MV	456	241	0	0	24	217	168	49
PCT7501	ED	95	90	0	0	10	80	66	14
PCT7501	TO	551	331	0	0	34	297	234	63
PCT7502	MV	668	310	0	0	23	287	228	59
PCT7502	ED	121	99	0	0	11	88	77	11
PCT7502	TO	789	409	0	0	34	375	305	70
PCT7503	MV	614	281	0	0	22	259	224	35
PCT7503	ED	148	100	0	0	12	88	72	16
PCT7503	TO	762	381	0	0	34	347	296	51
PCT7504	MV	404	173	0	0	15	158	137	21
PCT7504	ED	84	52	0	0	7	45	41	4
PCT7504	TO	488	225	0	0	22	203	178	25
PCT7505	MV	729	397	0	0	30	367	341	26
PCT7505	ED	133	96	0	0	2	94	87	7
PCT7505	TO	862	493	0	0	32	461	428	33
PCT7506	MV	842	360	0	0	34	326	281	45
PCT7506	ED	158	111	0	0	8	103	99	4
PCT7506	TO	1000	471	0	0	42	429	380	49
PCT7507	MV	693	286	0	0	17	269	234	35
PCT7507	ED	263	95	0	0	3	92	76	16
PCT7507	TO	956	381	0	0	20	361	310	51
PCT7508	MV	618	370	0	0	29	341	296	45
PCT7508	ED	126	103	0	0	7	96	84	12
PCT7508	TO	744	473	0	0	36	437	380	57
PCT7509	MV	756	396	0	0	28	368	317	51
PCT7509	ED	173	145	0	0	8	137	121	16
PCT7509	TO	929	541	0	0	36	505	438	67
PCT7512	MV	475	245	0	0	19	226	190	36
PCT7512	ED	125	85	0	0	7	78	71	7
PCT7512	TO	600	330	0	0	26	304	261	43
PCT7513	MV	575	243	0	0	23	220	202	18
PCT7513	ED	231	107	0	0	16	91	82	9
PCT7513	TO	806	350	0	0	39	311	284	27
PCT7514	MV	709	238	0	0	24	214	174	40
PCT7514	ED	207	59	0	0	10	49	43	6
PCT7514	TO	916	297	0	0	34	263	217	46
PCT7515	MV	663	311	0	0	16	295	244	51
PCT7515	ED	201	90	0	0	12	78	70	8
PCT7515	TO	864	401	0	0	28	373	314	59
PCT7516	MV	773	415	0	0	27	388	330	58
PCT7516	ED	147	118	0	0	6	112	93	19
PCT7516	TO	920	533	0	0	33	500	423	77
PCT7517	MV	645	354	0	0	26	328	290	38
PCT7517	ED	223	179	0	0	12	167	147	20
PCT7517	TO	868	533	0	0	38	495	437	58
PCT7518	MV	708	381	0	0	29	352	305	47
PCT7518	ED	218	185	0	0	11	174	160	14
PCT7518	TO	926	566	0	0	40	526	465	61
PCT7519	MV	543	254	0	0	25	229	208	21
PCT7519	ED	172	136	0	0	5	131	118	13
PCT7519	TO	715	390	0	0	30	360	326	34
PCT7521	MV	597	312	0	1	17	294	266	28
PCT7521	ED	182	149	0	0	4	145	132	13
PCT7521	TO	779	461	0	1	21	439	398	41
PCT7522	MV	588	291	0	0	17	274	247	27
PCT7522	ED	171	158	0	0	15	143	131	12
PCT7522	TO	759	449	0	0	32	417	378	39
PCT7523	MV	564	282	0	0	20	262	242	20
PCT7523	ED	180	169	0	0	9	160	147	13
PCT7523	TO	744	451	0	0	29	422	389	33
PCT7524	MV	480	221	0	0	21	200	187	13
PCT7524	ED	144	102	0	0	6	96	90	6
PCT7524	TO	624	323	0	0	27	296	277	19
PCT7525	MV	594	243	0	1	24	218	200	18
PCT7525	ED	170	94	0	0	9	85	83	2
PCT7525	TO	764	337	0	1	33	303	283	20
PCT7526	MV	825	390	0	0	39	351	327	24
PCT7526	ED	163	147	0	0	13	134	126	8
PCT7526	TO	988	537	0	0	52	485	453	32
PCT7527	MV	538	291	0	0	21	270	240	30
PCT7527	ED	172	112	0	0	4	108	99	9
PCT7527	TO	710	403	0	0	25	378	339	39
PCT7529	MV	748	361	0	0	21	340	317	23
PCT7529	ED	155	185	0	0	8	177	165	12
PCT7529	TO	903	546	0	0	29	517	482	35
PCT7531	MV	714	328	0	0	22	306	285	21
PCT7531	ED	159	132	0	0	4	128	112	16
PCT7531	TO	873	460	0	0	26	434	397	37
PCT7532	MV	668	325	0	0	23	302	277	25
PCT7532	ED	167	126	0	0	9	117	98	19
PCT7532	TO	835	451	0	0	32	419	375	44
PCT7533	MV	776	395	0	0	33	362	327	35
PCT7533	ED	194	185	0	0	14	171	157	14
PCT7533	TO	970	580	0	0	47	533	484	49
PCT7534	MV	670	363	0	0	31	332	289	43
PCT7534	ED	233	177	0	0	15	162	149	13
PCT7534	TO	903	540	0	0	46	494	438	56
PCT7535	MV	606	297	0	0	19	278	248	30
PCT7535	ED	139	151	0	0	15	136	126	10
PCT7535	TO	745	448	0	0	34	414	374	40
PCT7536	MV	670	337	0	0	13	324	287	37
PCT7536	ED	163	170	0	1	14	155	137	18
PCT7536	TO	833	507	0	1	27	479	424	55
PCT7537	MV	619	294	0	0	22	272	250	22
PCT7537	ED	126	148	0	0	11	137	128	9
PCT7537	TO	745	442	0	0	33	409	378	31
PCT7538	MV	562	313	0	0	18	295	275	20
PCT7538	ED	189	172	0	0	10	162	142	20
PCT7538	TO	751	485	0	0	28	457	417	40
PCT7539	MV	696	363	0	0	19	344	323	21
PCT7539	ED	225	187	0	0	13	174	161	13
PCT7539	TO	921	550	0	0	32	518	484	34
PCT7541	MV	600	289	0	0	22	267	240	27
PCT7541	ED	170	159	0	0	12	147	130	17
PCT7541	TO	770	448	0	0	34	414	370	44
PCT7542	MV	631	315	0	0	13	302	270	32
PCT7542	ED	193	166	0	0	7	159	141	18
PCT7542	TO	824	481	0	0	20	461	411	50
PCT7543	MV	694	365	0	0	12	353	316	37
PCT7543	ED	230	138	0	0	10	128	112	16
PCT7543	TO	924	503	0	0	22	481	428	53
PCT7544	MV	731	383	0	0	36	347	314	33
PCT7544	ED	168	159	0	0	10	149	139	10
PCT7544	TO	899	542	0	0	46	496	453	43
PCT7545	MV	723	385	0	0	25	360	322	38
PCT7545	ED	172	146	0	1	11	134	122	12
PCT7545	TO	895	531	0	1	36	494	444	50
PCT7546	MV	770	413	0	0	22	391	364	27
PCT7546	ED	183	209	0	0	17	192	171	21
PCT7546	TO	953	622	0	0	39	583	535	48
PCT7547	MV	796	413	0	0	31	382	357	25
PCT7547	ED	185	172	0	0	11	161	155	6
PCT7547	TO	981	585	0	0	42	543	512	31
PCT7548	MV	802	434	0	0	24	410	371	39
PCT7548	ED	249	201	0	0	10	191	175	16
PCT7548	TO	1051	635	0	0	34	601	546	55
PCT7549	MV	660	350	0	0	25	325	289	36
PCT7549	ED	146	140	0	0	13	127	116	11
PCT7549	TO	806	490	0	0	38	452	405	47
PCT7551	MV	587	295	0	0	13	282	258	24
PCT7551	ED	136	171	0	0	8	163	147	16
PCT7551	TO	723	466	0	0	21	445	405	40
PCT7552	MV	561	282	0	0	22	260	239	21
PCT7552	ED	124	127	0	0	11	116	99	17
PCT7552	TO	685	409	0	0	33	376	338	38
PCT7553	MV	211	94	0	1	5	88	77	11
PCT7553	ED	-20	0	0	0	0	0	0	0
PCT7553	TO	191	94	0	1	5	88	77	11
PCT7554	MV	653	372	0	0	24	348	311	37
PCT7554	ED	168	177	0	0	15	162	146	16
PCT7554	TO	821	549	0	0	39	510	457	53
PCT7555	MV	662	407	0	0	26	381	336	45
PCT7555	ED	210	210	0	0	18	192	174	18
PCT7555	TO	872	617	0	0	44	573	510	63
PCT7556	MV	813	505	0	0	30	475	425	50
PCT7556	ED	153	165	0	0	10	155	129	26
PCT7556	TO	966	670	0	0	40	630	554	76
PCT7601	MV	485	205	0	0	13	192	176	16
PCT7601	ED	192	89	0	1	10	78	68	10
PCT7601	TO	677	294	0	1	23	270	244	26
PCT7602	MV	654	271	0	0	13	258	234	24
PCT7602	ED	232	103	0	0	9	94	85	9
PCT7602	TO	886	374	0	0	22	352	319	33
PCT7603	MV	612	285	0	0	22	263	232	31
PCT7603	ED	203	167	0	0	12	155	137	18
PCT7603	TO	815	452	0	0	34	418	369	49
PCT7604	MV	685	261	0	0	11	250	226	24
PCT7604	ED	259	133	0	0	14	119	102	17
PCT7604	TO	944	394	0	0	25	369	328	41
PCT7605	MV	468	184	0	1	15	168	143	25
PCT7605	ED	193	62	0	0	6	56	52	4
PCT7605	TO	661	246	0	1	21	224	195	29
PCT7606	MV	673	263	0	0	27	236	208	28
PCT7606	ED	210	79	0	0	6	73	64	9
PCT7606	TO	883	342	0	0	33	309	272	37
PCT7607	MV	712	282	0	0	19	263	229	34
PCT7607	ED	207	100	0	0	4	96	85	11
PCT7607	TO	919	382	0	0	23	359	314	45
PCT7608	MV	279	96	0	0	6	90	74	16
PCT7608	ED	101	19	0	0	0	19	18	1
PCT7608	TO	380	115	0	0	6	109	92	17
PCT7609	MV	699	280	0	0	19	261	234	27
PCT7609	ED	185	49	0	1	5	43	37	6
PCT7609	TO	884	329	0	1	24	304	271	33
PCT7611	MV	586	230	0	0	17	213	191	22
PCT7611	ED	202	43	0	0	2	41	37	4
PCT7611	TO	788	273	0	0	19	254	228	26
PCT7612	MV	452	213	0	0	11	202	171	31
PCT7612	ED	105	29	0	0	1	28	20	8
PCT7612	TO	557	242	0	0	12	230	191	39
PCT7613	MV	634	236	0	0	18	218	195	23
PCT7613	ED	249	86	0	0	5	81	74	7
PCT7613	TO	883	322	0	0	23	299	269	30
PCT7614	MV	712	244	0	0	24	220	193	27
PCT7614	ED	204	78	0	0	4	74	58	16
PCT7614	TO	916	322	0	0	28	294	251	43
PCT7615	MV	510	162	0	0	6	156	132	24
PCT7615	ED	240	58	0	0	4	54	46	8
PCT7615	TO	750	220	0	0	10	210	178	32
PCT7616	MV	754	325	0	0	35	290	262	28
PCT7616	ED	82	86	0	0	7	79	73	6
PCT7616	TO	836	411	0	0	42	369	335	34
PCT7617	MV	583	218	0	0	20	198	175	23
PCT7617	ED	169	42	0	0	7	35	28	7
PCT7617	TO	752	260	0	0	27	233	203	30
PCT7618	MV	763	360	0	0	20	340	278	62
PCT7618	ED	151	84	0	0	9	75	65	10
PCT7618	TO	914	444	0	0	29	415	343	72
PCT7619	MV	937	432	0	0	28	404	355	49
PCT7619	ED	170	117	0	0	9	108	96	12
PCT7619	TO	1107	549	0	0	37	512	451	61
PCT7621	MV	1006	437	0	0	29	408	369	39
PCT7621	ED	149	103	0	0	10	93	79	14
PCT7621	TO	1155	540	0	0	39	501	448	53
PCT7622	MV	697	213	0	0	9	204	178	26
PCT7622	ED	263	73	0	0	9	64	60	4
PCT7622	TO	960	286	0	0	18	268	238	30
PCT7623	MV	767	255	0	2	17	236	215	21
PCT7623	ED	237	98	0	0	9	89	81	8
PCT7623	TO	1004	353	0	2	26	325	296	29
PCT7624	MV	651	205	0	0	12	193	176	17
PCT7624	ED	224	72	0	0	11	61	60	1
PCT7624	TO	875	277	0	0	23	254	236	18
PCT7625	MV	749	386	0	2	38	346	293	53
PCT7625	ED	73	34	0	0	1	33	32	1
PCT7625	TO	822	420	0	2	39	379	325	54
PCT7626	MV	944	396	0	0	42	354	304	50
PCT7626	ED	129	105	0	0	4	101	94	7
PCT7626	TO	1073	501	0	0	46	455	398	57
PCT7627	MV	456	194	0	0	18	176	139	37
PCT7627	ED	68	57	0	0	6	51	42	9
PCT7627	TO	524	251	0	0	24	227	181	46
PCT7628	MV	718	324	0	0	16	308	273	35
PCT7628	ED	220	110	0	0	2	108	95	13
PCT7628	TO	938	434	0	0	18	416	368	48
PCT7629	MV	691	266	0	0	20	246	221	25
PCT7629	ED	162	86	0	0	5	81	72	9
PCT7629	TO	853	352	0	0	25	327	293	34
PCT7631	MV	1009	433	0	0	32	401	352	49
PCT7631	ED	210	110	0	0	8	102	89	13
PCT7631	TO	1219	543	0	0	40	503	441	62
PCT7632	MV	1002	411	0	0	20	391	343	48
PCT7632	ED	169	128	0	0	8	120	107	13
PCT7632	TO	1171	539	0	0	28	511	450	61
PCT7633	MV	609	278	0	0	19	259	222	37
PCT7633	ED	126	96	0	0	6	90	83	7
PCT7633	TO	735	374	0	0	25	349	305	44
PCT7634	MV	704	338	0	0	34	304	263	41
PCT7634	ED	186	101	0	0	9	92	81	11
PCT7634	TO	890	439	0	0	43	396	344	52
PCT7635	MV	665	267	0	0	14	253	212	41
PCT7635	ED	188	62	0	0	4	58	49	9
PCT7635	TO	853	329	0	0	18	311	261	50
PCT7636	MV	797	321	0	0	24	297	251	46
PCT7636	ED	162	107	0	0	7	100	81	19
PCT7636	TO	959	428	0	0	31	397	332	65
PCT7637	MV	747	340	0	0	29	311	243	68
PCT7637	ED	121	98	0	0	10	88	76	12
PCT7637	TO	868	438	0	0	39	399	319	80
PCT7638	MV	806	370	0	0	24	346	273	73
PCT7638	ED	83	87	0	0	8	79	55	24
PCT7638	TO	889	457	0	0	32	425	328	97
PCT7639	MV	889	390	0	0	32	358	285	73
PCT7639	ED	133	132	0	0	23	109	92	17
PCT7639	TO	1022	522	0	0	55	467	377	90
PCT7641	MV	817	397	0	0	17	380	302	78
PCT7641	ED	134	92	0	0	4	88	75	13
PCT7641	TO	951	489	0	0	21	468	377	91
PCT7642	MV	647	305	0	0	35	270	242	28
PCT7642	ED	118	79	0	0	15	64	58	6
PCT7642	TO	765	384	0	0	50	334	300	34
PCT7643	MV	810	429	0	1	26	402	329	73
PCT7643	ED	131	105	0	0	10	95	84	11
PCT7643	TO	941	534	0	1	36	497	413	84
PCT7644	MV	1014	397	0	0	35	362	307	55
PCT7644	ED	162	142	0	0	10	132	120	12
PCT7644	TO	1176	539	0	0	45	494	427	67
PCT7645	MV	595	282	0	1	19	262	210	52
PCT7645	ED	61	56	0	0	6	50	43	7
PCT7645	TO	656	338	0	1	25	312	253	59
PCT7646	MV	1032	480	0	0	36	444	377	67
PCT7646	ED	121	133	0	0	16	117	105	12
PCT7646	TO	1153	613	0	0	52	561	482	79
PCT7647	MV	724	206	0	0	10	196	166	30
PCT7647	ED	263	79	0	0	5	74	69	5
PCT7647	TO	987	285	0	0	15	270	235	35
PCT7648	MV	2	1	0	0	0	1	1	0
PCT7648	ED	0	0	0	0	0	0	0	0
PCT7648	TO	2	1	0	0	0	1	1	0
PCT7649	MV	722	284	0	0	12	272	231	41
PCT7649	ED	178	78	0	0	5	73	60	13
PCT7649	TO	900	362	0	0	17	345	291	54
PCT7651	MV	834	323	0	0	22	301	254	47
PCT7651	ED	113	72	0	0	5	67	57	10
PCT7651	TO	947	395	0	0	27	368	311	57
PCT7652	MV	534	200	0	0	14	186	155	31
PCT7652	ED	101	86	0	0	5	81	73	8
PCT7652	TO	635	286	0	0	19	267	228	39
PCT7653	MV	750	322	0	0	32	290	257	33
PCT7653	ED	89	79	0	0	7	72	60	12
PCT7653	TO	839	401	0	0	39	362	317	45
PCT7654	MV	413	188	0	0	10	178	148	30
PCT7654	ED	53	83	0	0	7	76	70	6
PCT7654	TO	466	271	0	0	17	254	218	36
PCT7655	MV	582	211	0	0	8	203	176	27
PCT7655	ED	97	59	0	0	9	50	44	6
PCT7655	TO	679	270	0	0	17	253	220	33
PCT7656	MV	603	302	0	0	23	279	235	44
PCT7656	ED	35	40	0	0	3	37	24	13
PCT7656	TO	638	342	0	0	26	316	259	57
PCT7657	MV	561	265	0	0	21	244	208	36
PCT7657	ED	37	61	0	0	5	56	49	7
PCT7657	TO	598	326	0	0	26	300	257	43
PCT7701	MV	868	474	0	0	37	437	377	60
PCT7701	ED	196	173	0	0	8	165	147	18
PCT7701	TO	1064	647	0	0	45	602	524	78
PCT7702	MV	623	369	0	0	18	351	274	77
PCT7702	ED	133	103	0	0	9	94	74	20
PCT7702	TO	756	472	0	0	27	445	348	97
PCT7703	MV	187	71	0	0	2	69	65	4
PCT7703	ED	-13	0	0	0	0	0	0	0
PCT7703	TO	174	71	0	0	2	69	65	4
PCT7704	MV	798	485	0	0	36	449	336	113
PCT7704	ED	204	173	0	0	2	171	125	46
PCT7704	TO	1002	658	0	0	38	620	461	159
PCT7705	MV	470	281	0	0	15	266	199	67
PCT7705	ED	125	110	0	0	9	101	80	21
PCT7705	TO	595	391	0	0	24	367	279	88
PCT7706	MV	686	446	0	0	24	422	323	99
PCT7706	ED	180	162	0	0	8	154	120	34
PCT7706	TO	866	608	0	0	32	576	443	133
PCT7707	MV	683	424	0	0	22	402	329	73
PCT7707	ED	189	179	0	0	7	172	128	44
PCT7707	TO	872	603	0	0	29	574	457	117
PCT7708	MV	710	455	0	0	34	421	327	94
PCT7708	ED	165	152	0	0	13	139	115	24
PCT7708	TO	875	607	0	0	47	560	442	118
PCT7709	MV	322	191	0	0	9	182	152	30
PCT7709	ED	84	90	0	0	7	83	71	12
PCT7709	TO	406	281	0	0	16	265	223	42
PCT7711	MV	658	372	0	0	21	351	285	66
PCT7711	ED	153	125	0	0	4	121	106	15
PCT7711	TO	811	497	0	0	25	472	391	81
PCT7712	MV	423	254	0	0	10	244	199	45
PCT7712	ED	109	106	0	0	7	99	82	17
PCT7712	TO	532	360	0	0	17	343	281	62
PCT7801	MV	823	469	0	0	22	447	370	77
PCT7801	ED	151	190	0	0	11	179	140	39
PCT7801	TO	974	659	0	0	33	626	510	116
PCT7802	MV	646	393	0	0	26	367	323	44
PCT7802	ED	152	157	0	1	6	150	137	13
PCT7802	TO	798	550	0	1	32	517	460	57
PCT7803	MV	718	470	0	0	27	443	379	64
PCT7803	ED	113	128	0	0	10	118	100	18
PCT7803	TO	831	598	0	0	37	561	479	82
PCT7804	MV	733	459	0	0	46	413	372	41
PCT7804	ED	152	180	0	0	17	163	147	16
PCT7804	TO	885	639	0	0	63	576	519	57
PCT7805	MV	644	389	0	0	36	353	304	49
PCT7805	ED	156	155	0	0	11	144	133	11
PCT7805	TO	800	544	0	0	47	497	437	60
PCT7806	MV	602	353	0	0	23	330	301	29
PCT7806	ED	153	152	0	0	11	141	122	19
PCT7806	TO	755	505	0	0	34	471	423	48
PCT7807	MV	642	353	0	1	16	336	312	24
PCT7807	ED	185	174	0	0	12	162	151	11
PCT7807	TO	827	527	0	1	28	498	463	35
PCT7808	MV	525	288	0	0	20	268	236	32
PCT7808	ED	129	129	0	0	12	117	106	11
PCT7808	TO	654	417	0	0	32	385	342	43
PCT7809	MV	624	348	0	0	21	327	300	27
PCT7809	ED	140	135	0	0	13	122	118	4
PCT7809	TO	764	483	0	0	34	449	418	31
PCT7811	MV	582	303	0	0	23	280	259	21
PCT7811	ED	176	155	0	0	10	145	130	15
PCT7811	TO	758	458	0	0	33	425	389	36
PCT7812	MV	680	364	0	0	23	341	310	31
PCT7812	ED	217	163	0	0	5	158	137	21
PCT7812	TO	897	527	0	0	28	499	447	52
PCT7813	MV	842	478	0	0	21	457	414	43
PCT7813	ED	226	214	0	0	16	198	175	23
PCT7813	TO	1068	692	0	0	37	655	589	66
PCT7814	MV	660	274	0	0	15	259	228	31
PCT7814	ED	241	118	0	0	8	110	102	8
PCT7814	TO	901	392	0	0	23	369	330	39
PCT7815	MV	749	460	0	0	47	413	365	48
PCT7815	ED	168	176	0	0	9	167	153	14
PCT7815	TO	917	636	0	0	56	580	518	62
PCT7816	MV	724	466	0	0	35	431	376	55
PCT7816	ED	148	149	0	0	6	143	121	22
PCT7816	TO	872	615	0	0	41	574	497	77
PCT7817	MV	652	386	0	0	9	377	344	33
PCT7817	ED	186	182	0	1	7	174	154	20
PCT7817	TO	838	568	0	1	16	551	498	53
PCT7818	MV	668	389	0	0	25	364	324	40
PCT7818	ED	171	149	0	0	7	142	133	9
PCT7818	TO	839	538	0	0	32	506	457	49
PCT7819	MV	635	346	0	0	21	325	276	49
PCT7819	ED	139	89	0	0	5	84	79	5
PCT7819	TO	774	435	0	0	26	409	355	54
PCT7821	MV	806	513	0	0	25	488	427	61
PCT7821	ED	170	189	0	0	10	179	161	18
PCT7821	TO	976	702	0	0	35	667	588	79
PCT7822	MV	673	390	0	1	24	365	320	45
PCT7822	ED	219	222	0	0	21	201	166	35
PCT7822	TO	892	612	0	1	45	566	486	80
PCT7823	MV	706	398	0	0	24	374	329	45
PCT7823	ED	177	188	0	0	4	184	167	17
PCT7823	TO	883	586	0	0	28	558	496	62
PCT7824	MV	614	324	0	0	22	302	269	33
PCT7824	ED	154	158	0	0	13	145	133	12
PCT7824	TO	768	482	0	0	35	447	402	45
PCT7825	MV	457	248	0	0	13	235	224	11
PCT7825	ED	151	130	0	0	3	127	111	16
PCT7825	TO	608	378	0	0	16	362	335	27
PCT7826	MV	486	256	0	1	17	238	216	22
PCT7826	ED	204	162	0	0	11	151	139	12
PCT7826	TO	690	418	0	1	28	389	355	34
PCT7827	MV	607	312	0	0	16	296	261	35
PCT7827	ED	219	145	0	0	12	133	123	10
PCT7827	TO	826	457	0	0	28	429	384	45
PCT7828	MV	857	469	0	0	34	435	363	72
PCT7828	ED	171	177	0	0	17	160	137	23
PCT7828	TO	1028	646	0	0	51	595	500	95
PCT7829	MV	742	456	0	0	24	432	363	69
PCT7829	ED	149	151	0	0	4	147	132	15
PCT7829	TO	891	607	0	0	28	579	495	84
PCT7831	MV	763	478	0	0	39	439	379	60
PCT7831	ED	139	137	0	0	7	130	111	19
PCT7831	TO	902	615	0	0	46	569	490	79
PCT7832	MV	663	401	0	0	27	374	333	41
PCT7832	ED	118	127	0	0	7	120	106	14
PCT7832	TO	781	528	0	0	34	494	439	55
PCT7833	MV	587	339	0	0	18	321	289	32
PCT7833	ED	146	145	0	0	15	130	116	14
PCT7833	TO	733	484	0	0	33	451	405	46
PCT7834	MV	700	363	0	0	27	336	311	25
PCT7834	ED	194	175	0	0	12	163	148	15
PCT7834	TO	894	538	0	0	39	499	459	40
PCT7835	MV	721	423	0	0	27	396	323	73
PCT7835	ED	142	147	0	0	10	137	117	20
PCT7835	TO	863	570	0	0	37	533	440	93
PCT7836	MV	850	503	0	0	24	479	411	68
PCT7836	ED	193	169	0	0	6	163	133	30
PCT7836	TO	1043	672	0	0	30	642	544	98
PCT7837	MV	717	416	0	0	38	378	316	62
PCT7837	ED	206	198	0	0	7	191	168	23
PCT7837	TO	923	614	0	0	45	569	484	85
PCT7838	MV	752	484	0	0	33	451	376	75
PCT7838	ED	143	155	0	0	9	146	126	20
PCT7838	TO	895	639	0	0	42	597	502	95
PCT7839	MV	731	445	0	0	30	415	351	64
PCT7839	ED	130	136	0	0	8	128	113	15
PCT7839	TO	861	581	0	0	38	543	464	79
PCT7841	MV	752	449	0	0	31	418	363	55
PCT7841	ED	198	207	0	0	9	198	176	22
PCT7841	TO	950	656	0	0	40	616	539	77
PCT7842	MV	702	382	0	0	22	360	319	41
PCT7842	ED	177	154	0	0	9	145	130	15
PCT7842	TO	879	536	0	0	31	505	449	56
PCT7843	MV	546	289	0	0	11	278	245	33
PCT7843	ED	183	163	0	0	11	152	135	17
PCT7843	TO	729	452	0	0	22	430	380	50
PCT7844	MV	499	276	0	0	24	252	233	19
PCT7844	ED	152	136	0	0	11	125	111	14
PCT7844	TO	651	412	0	0	35	377	344	33
PCT7845	MV	676	393	0	0	21	372	339	33
PCT7845	ED	204	177	0	0	10	167	140	27
PCT7845	TO	880	570	0	0	31	539	479	60
PCT7846	MV	736	454	0	0	33	421	361	60
PCT7846	ED	172	166	0	0	12	154	130	24
PCT7846	TO	908	620	0	0	45	575	491	84
PCT7847	MV	698	421	0	0	31	390	343	47
PCT7847	ED	193	181	0	0	7	174	146	28
PCT7847	TO	891	602	0	0	38	564	489	75
PCT7848	MV	665	427	0	0	20	407	347	60
PCT7848	ED	182	168	0	0	17	151	129	22
PCT7848	TO	847	595	0	0	37	558	476	82
PCT7849	MV	729	427	0	0	30	397	347	50
PCT7849	ED	172	186	0	0	12	174	158	16
PCT7849	TO	901	613	0	0	42	571	505	66
PCT7851	MV	414	266	0	0	19	247	191	56
PCT7851	ED	112	84	0	0	7	77	57	20
PCT7851	TO	526	350	0	0	26	324	248	76
PCT7852	MV	533	347	0	0	24	323	262	61
PCT7852	ED	111	103	0	0	7	96	80	16
PCT7852	TO	644	450	0	0	31	419	342	77
PCT7853	MV	694	382	0	0	27	355	297	58
PCT7853	ED	161	137	0	0	9	128	108	20
PCT7853	TO	855	519	0	0	36	483	405	78
PCT7854	MV	703	422	0	0	25	397	341	56
PCT7854	ED	175	172	0	0	10	162	142	20
PCT7854	TO	878	594	0	0	35	559	483	76
PCT7855	MV	763	440	0	0	35	405	353	52
PCT7855	ED	211	202	0	0	16	186	167	19
PCT7855	TO	974	642	0	0	51	591	520	71
PCT7856	MV	643	362	0	0	19	343	302	41
PCT7856	ED	204	193	0	0	12	181	156	25
PCT7856	TO	847	555	0	0	31	524	458	66
PCT7857	MV	748	427	0	0	32	395	342	53
PCT7857	ED	158	153	0	0	8	145	135	10
PCT7857	TO	906	580	0	0	40	540	477	63
PCT7858	MV	622	345	0	0	20	325	291	34
PCT7858	ED	157	147	0	0	8	139	121	18
PCT7858	TO	779	492	0	0	28	464	412	52
PCT7859	MV	747	457	0	0	31	426	349	77
PCT7859	ED	152	165	0	0	18	147	118	29
PCT7859	TO	899	622	0	0	49	573	467	106
PCT7861	MV	699	424	0	0	20	404	334	70
PCT7861	ED	164	171	0	0	8	163	143	20
PCT7861	TO	863	595	0	0	28	567	477	90
PCT7862	MV	669	397	0	0	20	377	334	43
PCT7862	ED	195	197	0	0	10	187	170	17
PCT7862	TO	864	594	0	0	30	564	504	60
PCT7863	MV	692	361	0	0	21	340	296	44
PCT7863	ED	209	205	0	0	11	194	165	29
PCT7863	TO	901	566	0	0	32	534	461	73
PCT7864	MV	661	365	0	0	27	338	280	58
PCT7864	ED	153	157	0	0	13	144	120	24
PCT7864	TO	814	522	0	0	40	482	400	82
PCT7865	MV	677	402	0	0	30	372	313	59
PCT7865	ED	163	157	0	0	9	148	121	27
PCT7865	TO	840	559	0	0	39	520	434	86
PCT7866	MV	690	444	0	0	16	428	328	100
PCT7866	ED	158	141	0	0	8	133	103	30
PCT7866	TO	848	585	0	0	24	561	431	130
PCT7867	MV	766	462	0	0	20	442	378	64
PCT7867	ED	212	182	0	0	11	171	145	26
PCT7867	TO	978	644	0	0	31	613	523	90
PCT7868	MV	659	368	0	0	14	354	302	52
PCT7868	ED	217	161	0	0	11	150	128	22
PCT7868	TO	876	529	0	0	25	504	430	74
PCT7869	MV	682	436	0	0	26	410	357	53
PCT7869	ED	179	189	0	0	11	178	160	18
PCT7869	TO	861	625	0	0	37	588	517	71
PCT7871	MV	702	456	0	0	35	421	368	53
PCT7871	ED	200	157	0	1	10	146	117	29
PCT7871	TO	902	613	0	1	45	567	485	82
PCT7872	MV	675	410	0	0	23	387	333	54
PCT7872	ED	199	185	0	0	8	177	149	28
PCT7872	TO	874	595	0	0	31	564	482	82
PCT7873	MV	688	437	0	0	28	409	361	48
PCT7873	ED	203	212	0	0	15	197	172	25
PCT7873	TO	891	649	0	0	43	606	533	73
PCT7874	MV	370	187	0	0	8	179	147	32
PCT7874	ED	119	107	0	0	5	102	85	17
PCT7874	TO	489	294	0	0	13	281	232	49
PCT7875	MV	500	247	0	0	15	232	190	42
PCT7875	ED	147	114	0	0	5	109	93	16
PCT7875	TO	647	361	0	0	20	341	283	58
PCT7876	MV	462	250	0	0	18	232	213	19
PCT7876	ED	106	91	0	0	10	81	75	6
PCT7876	TO	568	341	0	0	28	313	288	25
PCT7901	MV	399	191	0	0	9	182	167	15
PCT7901	ED	150	65	0	0	2	63	56	7
PCT7901	TO	549	256	0	0	11	245	223	22
PCT7902	MV	680	286	0	0	14	272	240	32
PCT7902	ED	232	139	0	0	7	132	120	12
PCT7902	TO	912	425	0	0	21	404	360	44
PCT7903	MV	622	278	0	0	20	258	240	18
PCT7903	ED	230	123	0	0	9	114	106	8
PCT7903	TO	852	401	0	0	29	372	346	26
PCT7904	MV	678	289	0	0	20	269	235	34
PCT7904	ED	159	115	0	0	8	107	96	11
PCT7904	TO	837	404	0	0	28	376	331	45
PCT7905	MV	684	354	0	0	18	336	300	36
PCT7905	ED	191	183	0	0	8	175	162	13
PCT7905	TO	875	537	0	0	26	511	462	49
PCT7906	MV	599	276	0	0	16	260	233	27
PCT7906	ED	187	115	0	0	12	103	95	8
PCT7906	TO	786	391	0	0	28	363	328	35
PCT7907	MV	704	339	0	0	18	321	290	31
PCT7907	ED	238	163	0	0	15	148	131	17
PCT7907	TO	942	502	0	0	33	469	421	48
PCT7908	MV	752	359	0	1	21	337	312	25
PCT7908	ED	240	169	0	0	14	155	150	5
PCT7908	TO	992	528	0	1	35	492	462	30
PCT7909	MV	558	308	0	0	18	290	264	26
PCT7909	ED	185	140	0	0	5	135	127	8
PCT7909	TO	743	448	0	0	23	425	391	34
PCT7911	MV	666	315	0	0	22	293	253	40
PCT7911	ED	205	129	0	0	6	123	109	14
PCT7911	TO	871	444	0	0	28	416	362	54
PCT7912	MV	800	368	0	0	21	347	330	17
PCT7912	ED	259	176	0	0	18	158	150	8
PCT7912	TO	1059	544	0	0	39	505	480	25
PCT7913	MV	659	345	0	0	11	334	284	50
PCT7913	ED	264	212	0	0	6	206	185	21
PCT7913	TO	923	557	0	0	17	540	469	71
PCT7914	MV	715	381	0	0	25	356	311	45
PCT7914	ED	187	140	0	0	12	128	109	19
PCT7914	TO	902	521	0	0	37	484	420	64
PCT7915	MV	605	279	0	0	20	259	230	29
PCT7915	ED	238	181	0	0	3	178	161	17
PCT7915	TO	843	460	0	0	23	437	391	46
PCT7916	MV	639	321	0	0	16	305	272	33
PCT7916	ED	219	160	0	0	10	150	142	8
PCT7916	TO	858	481	0	0	26	455	414	41
PCT7917	MV	716	353	0	0	20	333	303	30
PCT7917	ED	271	187	0	0	6	181	170	11
PCT7917	TO	987	540	0	0	26	514	473	41
PCT7918	MV	597	296	0	0	14	282	267	15
PCT7918	ED	227	143	0	0	6	137	123	14
PCT7918	TO	824	439	0	0	20	419	390	29
PCT7919	MV	608	305	0	0	16	289	264	25
PCT7919	ED	258	175	0	0	8	167	157	10
PCT7919	TO	866	480	0	0	24	456	421	35
PCT7921	MV	682	302	0	0	16	286	253	33
PCT7921	ED	229	101	0	0	6	95	84	11
PCT7921	TO	911	403	0	0	22	381	337	44
PCT7922	MV	648	309	0	0	10	299	268	31
PCT7922	ED	210	155	0	0	10	145	133	12
PCT7922	TO	858	464	0	0	20	444	401	43
PCT7923	MV	666	331	0	0	14	317	261	56
PCT7923	ED	214	170	0	0	10	160	142	18
PCT7923	TO	880	501	0	0	24	477	403	74
PCT7924	MV	649	294	0	0	10	284	249	35
PCT7924	ED	202	124	0	0	8	116	104	12
PCT7924	TO	851	418	0	0	18	400	353	47
PCT7925	MV	434	222	0	0	14	208	179	29
PCT7925	ED	110	89	0	0	6	83	75	8
PCT7925	TO	544	311	0	0	20	291	254	37
PCT7926	MV	610	328	0	0	21	307	272	35
PCT7926	ED	178	150	0	0	6	144	123	21
PCT7926	TO	788	478	0	0	27	451	395	56
PCT7927	MV	580	325	0	0	28	297	263	34
PCT7927	ED	162	152	0	0	5	147	131	16
PCT7927	TO	742	477	0	0	33	444	394	50
PCT7928	MV	700	389	0	0	20	369	328	41
PCT7928	ED	217	208	0	0	7	201	181	20
PCT7928	TO	917	597	0	0	27	570	509	61
PCT7929	MV	678	419	0	0	22	397	348	49
PCT7929	ED	169	170	0	0	6	164	147	17
PCT7929	TO	847	589	0	0	28	561	495	66
PCT7931	MV	610	368	0	0	28	340	292	48
PCT7931	ED	141	149	0	0	7	142	125	17
PCT7931	TO	751	517	0	0	35	482	417	65
PCT7932	MV	443	276	0	0	16	260	215	45
PCT7932	ED	118	95	0	0	8	87	76	11
PCT7932	TO	561	371	0	0	24	347	291	56
PCT7933	MV	9	6	0	0	0	6	4	2
PCT7933	ED	-1	0	0	0	0	0	0	0
PCT7933	TO	8	6	0	0	0	6	4	2
PCT7934	MV	702	398	0	0	26	372	342	30
PCT7934	ED	182	154	0	0	17	137	124	13
PCT7934	TO	884	552	0	0	43	509	466	43
PCT7935	MV	715	429	0	0	28	401	353	48
PCT7935	ED	228	225	0	0	13	212	195	17
PCT7935	TO	943	654	0	0	41	613	548	65
PCT7936	MV	620	365	0	0	23	342	303	39
PCT7936	ED	236	220	0	1	10	209	187	22
PCT7936	TO	856	585	0	1	33	551	490	61
PCT7937	MV	698	404	0	0	25	379	339	40
PCT7937	ED	202	171	0	0	7	164	145	19
PCT7937	TO	900	575	0	0	32	543	484	59
PCT7938	MV	536	297	0	0	12	285	250	35
PCT7938	ED	215	120	0	0	7	113	98	15
PCT7938	TO	751	417	0	0	19	398	348	50
PCT7939	MV	481	279	0	0	13	266	241	25
PCT7939	ED	205	191	0	0	11	180	163	17
PCT7939	TO	686	470	0	0	24	446	404	42
PCT7941	MV	575	298	0	0	22	276	239	37
PCT7941	ED	197	170	0	0	9	161	139	22
PCT7941	TO	772	468	0	0	31	437	378	59
PCT7942	MV	658	324	0	0	14	310	266	44
PCT7942	ED	274	141	0	0	4	137	121	16
PCT7942	TO	932	465	0	0	18	447	387	60
PCT7943	MV	687	361	0	0	16	345	281	64
PCT7943	ED	213	156	0	0	12	144	117	27
PCT7943	TO	900	517	0	0	28	489	398	91
PCT7944	MV	584	332	0	0	21	311	271	40
PCT7944	ED	230	196	0	0	12	184	155	29
PCT7944	TO	814	528	0	0	33	495	426	69
PCT7945	MV	726	331	0	0	25	306	265	41
PCT7945	ED	228	82	0	0	7	75	68	7
PCT7945	TO	954	413	0	0	32	381	333	48
PCT7946	MV	779	361	0	0	18	343	232	111
PCT7946	ED	206	114	0	0	7	107	83	24
PCT7946	TO	985	475	0	0	25	450	315	135
PCT7947	MV	791	329	0	0	26	303	194	109
PCT7947	ED	195	93	0	0	4	89	66	23
PCT7947	TO	986	422	0	0	30	392	260	132
PCT7948	MV	730	364	0	0	25	339	223	116
PCT7948	ED	200	119	0	0	4	115	89	26
PCT7948	TO	930	483	0	0	29	454	312	142
PCT7949	MV	484	230	0	0	11	219	136	83
PCT7949	ED	106	56	0	0	6	50	35	15
PCT7949	TO	590	286	0	0	17	269	171	98
PCT7951	MV	730	363	0	0	27	336	215	121
PCT7951	ED	157	90	0	0	4	86	66	20
PCT7951	TO	887	453	0	0	31	422	281	141
PCT7952	MV	730	290	0	0	19	271	167	104
PCT7952	ED	182	86	0	0	7	79	57	22
PCT7952	TO	912	376	0	0	26	350	224	126
PCT7953	MV	669	327	0	0	18	309	214	95
PCT7953	ED	161	106	0	0	4	102	65	37
PCT7953	TO	830	433	0	0	22	411	279	132
PCT7954	MV	0	0	0	0	0	0	0	0
PCT7954	ED	0	0	0	0	0	0	0	0
PCT7954	TO	0	0	0	0	0	0	0	0
PCT7955	MV	774	341	0	0	15	326	221	105
PCT7955	ED	173	97	0	0	11	86	61	25
PCT7955	TO	947	438	0	0	26	412	282	130
PCT7956	MV	699	260	0	0	9	251	166	85
PCT7956	ED	170	39	0	0	2	37	31	6
PCT7956	TO	869	299	0	0	11	288	197	91
PCT7957	MV	538	256	0	0	13	243	188	55
PCT7957	ED	135	83	0	0	5	78	66	12
PCT7957	TO	673	339	0	0	18	321	254	67
PCT7958	MV	320	103	0	0	6	97	74	23
PCT7958	ED	-23	0	0	0	0	0	0	0
PCT7958	TO	297	103	0	0	6	97	74	23
PCT7959	MV	541	226	0	0	17	209	192	17
PCT7959	ED	145	65	0	0	6	59	54	5
PCT7959	TO	686	291	0	0	23	268	246	22
PCT9001	MV	314	99	0	0	3	96	84	12
PCT9001	ED	-30	0	0	0	0	0	0	0
PCT9001	TO	284	99	0	0	3	96	84	12
PCT9101	MV	712	372	0	0	23	349	270	79
PCT9101	ED	201	150	0	0	4	146	123	23
PCT9101	TO	913	522	0	0	27	495	393	102
PCT9102	MV	787	388	0	0	25	363	298	65
PCT9102	ED	205	126	0	0	3	123	102	21
PCT9102	TO	992	514	0	0	28	486	400	86
PCT9103	MV	718	377	0	0	23	354	285	69
PCT9103	ED	239	153	0	0	12	141	105	36
PCT9103	TO	957	530	0	0	35	495	390	105
PCT9104	MV	810	381	0	0	31	350	279	71
PCT9104	ED	220	152	0	0	7	145	121	24
PCT9104	TO	1030	533	0	0	38	495	400	95
PCT9105	MV	719	410	0	0	20	390	315	75
PCT9105	ED	199	173	0	0	12	161	129	32
PCT9105	TO	918	583	0	0	32	551	444	107
PCT9106	MV	746	384	0	0	21	363	295	68
PCT9106	ED	200	178	0	0	12	166	150	16
PCT9106	TO	946	562	0	0	33	529	445	84
PCT9107	MV	635	300	0	0	23	277	235	42
PCT9107	ED	209	118	0	0	9	109	99	10
PCT9107	TO	844	418	0	0	32	386	334	52
PCT9108	MV	610	332	0	0	31	301	254	47
PCT9108	ED	200	136	0	0	8	128	114	14
PCT9108	TO	810	468	0	0	39	429	368	61
PCT9109	MV	672	293	0	0	24	269	221	48
PCT9109	ED	211	162	0	0	5	157	128	29
PCT9109	TO	883	455	0	0	29	426	349	77
PCT9111	MV	638	315	0	0	23	292	248	44
PCT9111	ED	196	134	0	0	10	124	106	18
PCT9111	TO	834	449	0	0	33	416	354	62
PCT9112	MV	742	346	0	0	23	323	263	60
PCT9112	ED	219	160	0	0	11	149	131	18
PCT9112	TO	961	506	0	0	34	472	394	78
PCT9113	MV	795	365	0	0	24	341	269	72
PCT9113	ED	209	180	0	0	14	166	131	35
PCT9113	TO	1004	545	0	0	38	507	400	107
PCT9114	MV	659	289	0	0	16	273	234	39
PCT9114	ED	231	147	0	0	11	136	122	14
PCT9114	TO	890	436	0	0	27	409	356	53
PCT9115	MV	699	319	0	0	25	294	250	44
PCT9115	ED	182	155	0	0	15	140	120	20
PCT9115	TO	881	474	0	0	40	434	370	64
PCT9116	MV	782	342	0	0	18	324	262	62
PCT9116	ED	179	148	0	0	11	137	112	25
PCT9116	TO	961	490	0	0	29	461	374	87
PCT9117	MV	629	325	0	0	16	309	239	70
PCT9117	ED	171	158	0	0	7	151	120	31
PCT9117	TO	800	483	0	0	23	460	359	101
PCT9118	MV	738	338	0	0	25	313	235	78
PCT9118	ED	246	165	0	0	12	153	126	27
PCT9118	TO	984	503	0	0	37	466	361	105
PCT9119	MV	703	383	0	0	22	361	276	85
PCT9119	ED	197	120	0	0	15	105	90	15
PCT9119	TO	900	503	0	0	37	466	366	100
PCT9121	MV	734	326	0	0	18	308	241	67
PCT9121	ED	219	141	0	0	8	133	101	32
PCT9121	TO	953	467	0	0	26	441	342	99
PCT9122	MV	774	362	0	0	22	340	243	97
PCT9122	ED	193	122	0	0	12	110	90	20
PCT9122	TO	967	484	0	0	34	450	333	117
PCT9123	MV	661	319	0	0	20	299	223	76
PCT9123	ED	191	139	0	0	9	130	114	16
PCT9123	TO	852	458	0	0	29	429	337	92
PCT9124	MV	735	347	0	0	14	333	252	81
PCT9124	ED	168	118	0	0	6	112	89	23
PCT9124	TO	903	465	0	0	20	445	341	104
PCT9125	MV	680	350	0	0	17	333	263	70
PCT9125	ED	189	124	0	0	8	116	104	12
PCT9125	TO	869	474	0	0	25	449	367	82
PCT9126	MV	819	379	0	0	19	360	264	96
PCT9126	ED	194	152	0	0	7	145	119	26
PCT9126	TO	1013	531	0	0	26	505	383	122
PCT9127	MV	748	375	0	0	25	350	289	61
PCT9127	ED	223	184	0	0	9	175	147	28
PCT9127	TO	971	559	0	0	34	525	436	89
PCT9128	MV	628	330	0	0	22	308	236	72
PCT9128	ED	190	166	0	0	14	152	129	23
PCT9128	TO	818	496	0	0	36	460	365	95
PCT9129	MV	587	268	0	0	11	257	206	51
PCT9129	ED	151	129	0	0	8	121	107	14
PCT9129	TO	738	397	0	0	19	378	313	65
PCT9131	MV	596	280	0	0	11	269	204	65
PCT9131	ED	138	111	0	0	6	105	86	19
PCT9131	TO	734	391	0	0	17	374	290	84
PCT9132	MV	627	258	0	0	14	244	215	29
PCT9132	ED	194	130	0	0	7	123	106	17
PCT9132	TO	821	388	0	0	21	367	321	46
PCT9133	MV	808	373	0	0	20	353	294	59
PCT9133	ED	209	157	0	0	11	146	122	24
PCT9133	TO	1017	530	0	0	31	499	416	83
PCT9134	MV	736	254	0	0	15	239	165	74
PCT9134	ED	155	102	0	0	9	93	75	18
PCT9134	TO	891	356	0	0	24	332	240	92
PCT9135	MV	640	301	0	0	19	282	229	53
PCT9135	ED	182	125	0	0	6	119	88	31
PCT9135	TO	822	426	0	0	25	401	317	84
PCT9136	MV	706	360	0	0	24	336	264	72
PCT9136	ED	212	139	0	0	14	125	103	22
PCT9136	TO	918	499	0	0	38	461	367	94
PCT9137	MV	804	381	0	0	26	355	275	80
PCT9137	ED	211	133	0	0	5	128	108	20
PCT9137	TO	1015	514	0	0	31	483	383	100
PCT9138	MV	770	396	0	0	23	373	285	88
PCT9138	ED	175	119	0	0	10	109	100	9
PCT9138	TO	945	515	0	0	33	482	385	97
PCT9139	MV	828	415	0	0	26	389	288	101
PCT9139	ED	190	141	0	0	10	131	109	22
PCT9139	TO	1018	556	0	0	36	520	397	123
PCT9141	MV	789	413	0	0	31	382	287	95
PCT9141	ED	184	144	0	0	9	135	112	23
PCT9141	TO	973	557	0	0	40	517	399	118
PCT9142	MV	747	360	0	0	20	340	280	60
PCT9142	ED	239	162	0	0	13	149	121	28
PCT9142	TO	986	522	0	0	33	489	401	88
PCT9143	MV	705	357	0	0	20	337	261	76
PCT9143	ED	209	150	0	0	3	147	115	32
PCT9143	TO	914	507	0	0	23	484	376	108
PCT9144	MV	766	371	0	0	21	350	267	83
PCT9144	ED	204	177	0	0	8	169	149	20
PCT9144	TO	970	548	0	0	29	519	416	103
PCT9145	MV	681	329	0	0	18	311	251	60
PCT9145	ED	194	157	0	0	9	148	117	31
PCT9145	TO	875	486	0	0	27	459	368	91
PCT9146	MV	725	350	0	0	25	325	280	45
PCT9146	ED	160	143	0	0	14	129	106	23
PCT9146	TO	885	493	0	0	39	454	386	68
PCT9147	MV	765	368	0	0	19	349	288	61
PCT9147	ED	225	161	0	0	6	155	127	28
PCT9147	TO	990	529	0	0	25	504	415	89
PCT9148	MV	778	389	0	0	17	372	316	56
PCT9148	ED	236	177	0	0	14	163	145	18
PCT9148	TO	1014	566	0	0	31	535	461	74
PCT9149	MV	812	372	0	0	19	353	288	65
PCT9149	ED	179	240	0	0	13	227	196	31
PCT9149	TO	991	612	0	0	32	580	484	96
PCT9151	MV	693	342	0	0	25	317	273	44
PCT9151	ED	168	111	0	0	5	106	87	19
PCT9151	TO	861	453	0	0	30	423	360	63
PCT9152	MV	550	196	0	0	10	186	161	25
PCT9152	ED	187	124	0	0	8	116	103	13
PCT9152	TO	737	320	0	0	18	302	264	38
PCT9201	MV	784	347	0	0	24	323	298	25
PCT9201	ED	187	166	0	0	6	160	142	18
PCT9201	TO	971	513	0	0	30	483	440	43
PCT9202	MV	819	361	0	0	29	332	289	43
PCT9202	ED	177	164	0	0	10	154	128	26
PCT9202	TO	996	525	0	0	39	486	417	69
PCT9203	MV	847	366	0	0	50	316	242	74
PCT9203	ED	155	120	0	0	15	105	66	39
PCT9203	TO	1002	486	0	0	65	421	308	113
PCT9204	MV	686	302	0	0	30	272	206	66
PCT9204	ED	176	138	0	0	9	129	98	31
PCT9204	TO	862	440	0	0	39	401	304	97
PCT9205	MV	621	278	0	0	33	245	212	33
PCT9205	ED	115	92	0	0	11	81	60	21
PCT9205	TO	736	370	0	0	44	326	272	54
PCT9206	MV	741	349	0	0	22	327	246	81
PCT9206	ED	188	149	0	0	22	127	98	29
PCT9206	TO	929	498	0	0	44	454	344	110
PCT9207	MV	824	366	0	0	29	337	261	76
PCT9207	ED	165	130	0	0	11	119	92	27
PCT9207	TO	989	496	0	0	40	456	353	103
PCT9208	MV	808	348	0	0	26	322	264	58
PCT9208	ED	179	127	0	0	12	115	96	19
PCT9208	TO	987	475	0	0	38	437	360	77
PCT9209	MV	615	274	0	0	23	251	195	56
PCT9209	ED	156	119	0	0	13	106	83	23
PCT9209	TO	771	393	0	0	36	357	278	79
PCT9211	MV	730	308	0	0	30	278	219	59
PCT9211	ED	161	132	0	0	16	116	87	29
PCT9211	TO	891	440	0	0	46	394	306	88
PCT9212	MV	671	278	0	1	24	253	201	52
PCT9212	ED	137	114	0	0	18	96	78	18
PCT9212	TO	808	392	0	1	42	349	279	70
PCT9213	MV	776	342	0	0	35	307	240	67
PCT9213	ED	161	130	0	0	14	116	100	16
PCT9213	TO	937	472	0	0	49	423	340	83
PCT9214	MV	517	232	0	0	16	216	175	41
PCT9214	ED	110	103	0	0	11	92	70	22
PCT9214	TO	627	335	0	0	27	308	245	63
PCT9215	MV	524	240	0	0	14	226	181	45
PCT9215	ED	120	100	0	0	11	89	70	19
PCT9215	TO	644	340	0	0	25	315	251	64
PCT9216	MV	669	260	0	0	31	229	167	62
PCT9216	ED	155	125	0	0	8	117	91	26
PCT9216	TO	824	385	0	0	39	346	258	88
PCT9217	MV	587	263	0	0	11	252	202	50
PCT9217	ED	118	87	0	0	5	82	61	21
PCT9217	TO	705	350	0	0	16	334	263	71
PCT9218	MV	652	275	0	0	26	249	190	59
PCT9218	ED	164	112	0	0	5	107	88	19
PCT9218	TO	816	387	0	0	31	356	278	78
PCT9219	MV	646	285	0	0	28	257	226	31
PCT9219	ED	144	116	0	0	7	109	92	17
PCT9219	TO	790	401	0	0	35	366	318	48
PCT9221	MV	562	318	0	0	19	299	217	82
PCT9221	ED	89	99	0	0	8	91	70	21
PCT9221	TO	651	417	0	0	27	390	287	103
PCT9222	MV	773	365	0	0	28	337	270	67
PCT9222	ED	137	116	0	0	9	107	81	26
PCT9222	TO	910	481	0	0	37	444	351	93
PCT9223	MV	558	264	0	0	16	248	195	53
PCT9223	ED	109	59	0	0	6	53	39	14
PCT9223	TO	667	323	0	0	22	301	234	67
PCT9224	MV	768	376	0	0	24	352	283	69
PCT9224	ED	181	151	0	0	14	137	103	34
PCT9224	TO	949	527	0	0	38	489	386	103
PCT9225	MV	757	301	0	0	19	282	232	50
PCT9225	ED	169	156	0	0	18	138	116	22
PCT9225	TO	926	457	0	0	37	420	348	72
PCT9226	MV	741	350	0	0	36	314	271	43
PCT9226	ED	155	143	0	0	8	135	117	18
PCT9226	TO	896	493	0	0	44	449	388	61
PCT9227	MV	605	363	0	0	25	338	256	82
PCT9227	ED	124	114	0	0	4	110	85	25
PCT9227	TO	729	477	0	0	29	448	341	107
PCT9228	MV	577	306	0	3	19	284	212	72
PCT9228	ED	161	141	0	0	6	135	116	19
PCT9228	TO	738	447	0	3	25	419	328	91
PCT9229	MV	460	252	0	0	21	231	201	30
PCT9229	ED	119	106	0	0	2	104	90	14
PCT9229	TO	579	358	0	0	23	335	291	44
PCT9231	MV	726	340	0	0	19	321	257	64
PCT9231	ED	236	208	0	0	13	195	173	22
PCT9231	TO	962	548	0	0	32	516	430	86
PCT9232	MV	608	288	0	0	24	264	204	60
PCT9232	ED	126	140	0	0	10	130	102	28
PCT9232	TO	734	428	0	0	34	394	306	88
PCT9233	MV	668	317	0	0	25	292	220	72
PCT9233	ED	150	141	0	0	15	126	107	19
PCT9233	TO	818	458	0	0	40	418	327	91
PCT9234	MV	643	306	0	0	19	287	223	64
PCT9234	ED	91	112	0	0	13	99	79	20
PCT9234	TO	734	418	0	0	32	386	302	84
PCT9235	MV	703	356	0	0	25	331	236	95
PCT9235	ED	160	140	0	0	10	130	103	27
PCT9235	TO	863	496	0	0	35	461	339	122
PCT9236	MV	537	274	0	0	20	254	212	42
PCT9236	ED	136	101	0	0	11	90	73	17
PCT9236	TO	673	375	0	0	31	344	285	59
PCT9237	MV	779	388	0	0	27	361	287	74
PCT9237	ED	118	134	0	0	8	126	105	21
PCT9237	TO	897	522	0	0	35	487	392	95
PCT9238	MV	687	325	0	0	35	290	241	49
PCT9238	ED	118	118	0	0	15	103	86	17
PCT9238	TO	805	443	0	0	50	393	327	66
PCT9239	MV	740	383	0	0	38	345	288	57
PCT9239	ED	124	117	0	0	7	110	93	17
PCT9239	TO	864	500	0	0	45	455	381	74
PCT9241	MV	819	394	0	0	27	367	301	66
PCT9241	ED	141	139	0	0	10	129	114	15
PCT9241	TO	960	533	0	0	37	496	415	81
PCT9242	MV	771	341	0	0	36	305	256	49
PCT9242	ED	172	155	0	0	15	140	115	25
PCT9242	TO	943	496	0	0	51	445	371	74
PCT9243	MV	480	239	0	0	23	216	181	35
PCT9243	ED	123	113	0	0	13	100	87	13
PCT9243	TO	603	352	0	0	36	316	268	48
PCT9244	MV	755	390	0	0	41	349	297	52
PCT9244	ED	155	121	0	0	8	113	98	15
PCT9244	TO	910	511	0	0	49	462	395	67
PCT9245	MV	616	292	0	0	29	263	217	46
PCT9245	ED	98	91	0	0	9	82	70	12
PCT9245	TO	714	383	0	0	38	345	287	58
PCT9246	MV	815	425	0	0	31	394	314	80
PCT9246	ED	155	140	0	0	18	122	111	11
PCT9246	TO	970	565	0	0	49	516	425	91
PCT9247	MV	764	376	0	0	23	353	291	62
PCT9247	ED	148	156	0	0	20	136	114	22
PCT9247	TO	912	532	0	0	43	489	405	84
PCT9248	MV	757	354	0	0	29	325	283	42
PCT9248	ED	150	145	0	0	13	132	118	14
PCT9248	TO	907	499	0	0	42	457	401	56
PCT9249	MV	724	369	0	0	29	340	294	46
PCT9249	ED	191	171	0	0	15	156	129	27
PCT9249	TO	915	540	0	0	44	496	423	73
PCT9251	MV	792	389	0	0	26	363	303	60
PCT9251	ED	174	179	0	0	9	170	133	37
PCT9251	TO	966	568	0	0	35	533	436	97
PCT9252	MV	810	374	0	0	26	348	279	69
PCT9252	ED	143	127	0	0	9	118	105	13
PCT9252	TO	953	501	0	0	35	466	384	82
PCT9253	MV	599	295	0	0	15	280	236	44
PCT9253	ED	162	116	0	0	8	108	93	15
PCT9253	TO	761	411	0	0	23	388	329	59
PCT9254	MV	758	403	0	0	22	381	316	65
PCT9254	ED	163	155	0	0	17	138	120	18
PCT9254	TO	921	558	0	0	39	519	436	83
PCT9255	MV	436	194	0	0	18	176	153	23
PCT9255	ED	114	112	0	0	11	101	84	17
PCT9255	TO	550	306	0	0	29	277	237	40
PCT9256	MV	367	166	0	0	9	157	132	25
PCT9256	ED	95	74	0	0	7	67	58	9
PCT9256	TO	462	240	0	0	16	224	190	34
PCT9257	MV	359	157	0	0	14	143	125	18
PCT9257	ED	-39	0	0	0	0	0	0	0
PCT9257	TO	320	157	0	0	14	143	125	18
PCT9258	MV	583	301	0	0	28	273	225	48
PCT9258	ED	120	103	0	0	5	98	92	6
PCT9258	TO	703	404	0	0	33	371	317	54
PCT9401	MV	794	354	0	0	21	333	285	48
PCT9401	ED	244	176	0	0	11	165	149	16
PCT9401	TO	1038	530	0	0	32	498	434	64
PCT9402	MV	774	369	0	0	15	354	289	65
PCT9402	ED	243	159	0	0	11	148	126	22
PCT9402	TO	1017	528	0	0	26	502	415	87
PCT9403	MV	731	338	0	0	13	325	247	78
PCT9403	ED	190	123	0	0	8	115	107	8
PCT9403	TO	921	461	0	0	21	440	354	86
PCT9404	MV	752	344	0	0	20	324	246	78
PCT9404	ED	192	154	0	0	8	146	117	29
PCT9404	TO	944	498	0	0	28	470	363	107
PCT9405	MV	628	275	0	0	19	256	191	65
PCT9405	ED	152	104	0	0	5	99	76	23
PCT9405	TO	780	379	0	0	24	355	267	88
PCT9406	MV	694	323	0	0	20	303	230	73
PCT9406	ED	189	150	0	0	6	144	110	34
PCT9406	TO	883	473	0	0	26	447	340	107
PCT9407	MV	712	363	0	0	16	347	290	57
PCT9407	ED	201	131	0	0	13	118	96	22
PCT9407	TO	913	494	0	0	29	465	386	79
PCT9408	MV	709	310	0	0	24	286	252	34
PCT9408	ED	154	125	0	0	9	116	103	13
PCT9408	TO	863	435	0	0	33	402	355	47
PCT9409	MV	443	220	0	0	15	205	178	27
PCT9409	ED	158	127	0	0	5	122	109	13
PCT9409	TO	601	347	0	0	20	327	287	40
PCT9411	MV	816	364	0	0	22	342	291	51
PCT9411	ED	191	135	0	0	7	128	109	19
PCT9411	TO	1007	499	0	0	29	470	400	70
PCT9412	MV	668	335	0	0	16	319	237	82
PCT9412	ED	202	138	0	0	9	129	106	23
PCT9412	TO	870	473	0	0	25	448	343	105
PCT9413	MV	757	366	0	0	22	344	254	90
PCT9413	ED	179	127	0	0	6	121	99	22
PCT9413	TO	936	493	0	0	28	465	353	112
PCT9414	MV	734	358	0	1	23	334	246	88
PCT9414	ED	186	107	0	0	6	101	85	16
PCT9414	TO	920	465	0	1	29	435	331	104
PCT9415	MV	634	307	0	0	16	291	226	65
PCT9415	ED	154	96	0	0	6	90	78	12
PCT9415	TO	788	403	0	0	22	381	304	77
PCT9416	MV	768	382	0	0	31	351	264	87
PCT9416	ED	231	143	0	0	4	139	111	28
PCT9416	TO	999	525	0	0	35	490	375	115
PCT9417	MV	628	317	0	0	15	302	219	83
PCT9417	ED	146	110	0	0	4	106	80	26
PCT9417	TO	774	427	0	0	19	408	299	109
PCT9418	MV	627	304	0	0	24	280	197	83
PCT9418	ED	192	122	0	0	7	115	81	34
PCT9418	TO	819	426	0	0	31	395	278	117
PCT9419	MV	736	363	0	0	19	344	246	98
PCT9419	ED	173	107	0	0	8	99	69	30
PCT9419	TO	909	470	0	0	27	443	315	128
PCT9421	MV	752	330	0	0	21	309	209	100
PCT9421	ED	173	112	0	0	6	106	76	30
PCT9421	TO	925	442	0	0	27	415	285	130
PCT9422	MV	831	406	0	0	23	383	279	104
PCT9422	ED	270	145	0	0	8	137	113	24
PCT9422	TO	1101	551	0	0	31	520	392	128
PCT9423	MV	711	309	0	0	22	287	203	84
PCT9423	ED	193	121	0	0	9	112	90	22
PCT9423	TO	904	430	0	0	31	399	293	106
PCT9424	MV	797	379	0	0	16	363	256	107
PCT9424	ED	212	114	0	0	7	107	82	25
PCT9424	TO	1009	493	0	0	23	470	338	132
PCT9425	MV	789	339	0	0	23	316	230	86
PCT9425	ED	187	114	0	0	7	107	83	24
PCT9425	TO	976	453	0	0	30	423	313	110
PCT9426	MV	696	317	0	0	21	296	209	87
PCT9426	ED	157	104	0	0	11	93	64	29
PCT9426	TO	853	421	0	0	32	389	273	116
PCT9427	MV	797	377	0	0	18	359	224	135
PCT9427	ED	190	115	0	0	14	101	74	27
PCT9427	TO	987	492	0	0	32	460	298	162
PCT9428	MV	809	343	0	0	23	320	235	85
PCT9428	ED	181	113	0	0	8	105	86	19
PCT9428	TO	990	456	0	0	31	425	321	104
PCT9429	MV	707	339	0	1	20	318	218	100
PCT9429	ED	199	124	0	0	13	111	85	26
PCT9429	TO	906	463	0	1	33	429	303	126
PCT9431	MV	831	408	0	0	35	373	244	129
PCT9431	ED	205	125	0	0	5	120	90	30
PCT9431	TO	1036	533	0	0	40	493	334	159
PCT9432	MV	742	352	0	0	29	323	238	85
PCT9432	ED	216	117	0	0	7	110	88	22
PCT9432	TO	958	469	0	0	36	433	326	107
PCT9433	MV	792	372	0	0	27	345	225	120
PCT9433	ED	166	93	0	0	3	90	62	28
PCT9433	TO	958	465	0	0	30	435	287	148
PCT9434	MV	780	384	0	0	25	359	267	92
PCT9434	ED	232	162	0	0	18	144	119	25
PCT9434	TO	1012	546	0	0	43	503	386	117
PCT9435	MV	776	364	0	0	13	351	246	105
PCT9435	ED	228	157	0	0	7	150	109	41
PCT9435	TO	1004	521	0	0	20	501	355	146
PCT9436	MV	840	379	0	0	13	366	258	108
PCT9436	ED	228	129	0	0	10	119	89	30
PCT9436	TO	1068	508	0	0	23	485	347	138
PCT9437	MV	735	369	0	0	20	349	238	111
PCT9437	ED	192	130	0	0	3	127	98	29
PCT9437	TO	927	499	0	0	23	476	336	140
PCT9438	MV	836	410	0	0	23	387	265	122
PCT9438	ED	153	83	0	0	6	77	55	22
PCT9438	TO	989	493	0	0	29	464	320	144
PCT9439	MV	718	337	0	0	18	319	228	91
PCT9439	ED	199	111	0	0	9	102	76	26
PCT9439	TO	917	448	0	0	27	421	304	117
PCT9441	MV	773	390	0	0	25	365	261	104
PCT9441	ED	198	125	0	0	14	111	87	24
PCT9441	TO	971	515	0	0	39	476	348	128
PCT9442	MV	827	370	0	0	33	337	219	118
PCT9442	ED	213	156	0	0	9	147	115	32
PCT9442	TO	1040	526	0	0	42	484	334	150
PCT9443	MV	759	353	0	1	18	334	254	80
PCT9443	ED	196	109	0	0	4	105	79	26
PCT9443	TO	955	462	0	1	22	439	333	106
PCT9444	MV	764	332	0	0	14	318	213	105
PCT9444	ED	201	94	0	0	6	88	71	17
PCT9444	TO	965	426	0	0	20	406	284	122
PCT9445	MV	824	399	0	0	24	375	275	100
PCT9445	ED	172	113	0	0	8	105	81	24
PCT9445	TO	996	512	0	0	32	480	356	124
PCT9446	MV	900	461	0	0	29	432	283	149
PCT9446	ED	216	145	0	0	12	133	108	25
PCT9446	TO	1116	606	0	0	41	565	391	174
PCT9447	MV	728	387	0	0	19	368	258	110
PCT9447	ED	193	143	0	0	11	132	106	26
PCT9447	TO	921	530	0	0	30	500	364	136
PCT9448	MV	740	338	0	0	18	320	220	100
PCT9448	ED	200	127	0	0	7	120	101	19
PCT9448	TO	940	465	0	0	25	440	321	119
PCT9449	MV	717	337	0	0	19	318	201	117
PCT9449	ED	164	96	0	0	5	91	69	22
PCT9449	TO	881	433	0	0	24	409	270	139
PCT9451	MV	353	176	0	0	7	169	110	59
PCT9451	ED	88	54	0	0	4	50	37	13
PCT9451	TO	441	230	0	0	11	219	147	72
PCT9452	MV	647	327	0	0	18	309	221	88
PCT9452	ED	195	134	0	0	7	127	87	40
PCT9452	TO	842	461	0	0	25	436	308	128
PCT9453	MV	409	216	0	0	9	207	138	69
PCT9453	ED	115	70	0	0	5	65	48	17
PCT9453	TO	524	286	0	0	14	272	186	86
PCT9501	MV	158	92	0	2	7	83	67	16
PCT9501	ED	-8	0	0	0	0	0	0	0
PCT9501	TO	150	92	0	2	7	83	67	16
PCT9502	MV	294	133	0	0	9	124	107	17
PCT9502	ED	-43	0	0	0	0	0	0	0
PCT9502	TO	251	133	0	0	9	124	107	17
PCT9503	MV	550	259	0	0	28	231	213	18
PCT9503	ED	150	82	0	0	5	77	73	4
PCT9503	TO	700	341	0	0	33	308	286	22
PCT9505	MV	589	291	0	0	25	266	229	37
PCT9505	ED	176	110	0	0	7	103	92	11
PCT9505	TO	765	401	0	0	32	369	321	48
PCT9506	MV	547	229	0	0	14	215	194	21
PCT9506	ED	207	128	0	0	9	119	109	10
PCT9506	TO	754	357	0	0	23	334	303	31
PCT9507	MV	556	301	0	0	20	281	255	26
PCT9507	ED	160	152	0	0	14	138	121	17
PCT9507	TO	716	453	0	0	34	419	376	43
PCT9508	MV	632	306	0	0	19	287	266	21
PCT9508	ED	148	132	0	0	11	121	111	10
PCT9508	TO	780	438	0	0	30	408	377	31
PCT9509	MV	585	294	0	0	21	273	246	27
PCT9509	ED	142	121	0	0	7	114	109	5
PCT9509	TO	727	415	0	0	28	387	355	32
PCT9511	MV	457	235	0	0	16	219	193	26
PCT9511	ED	177	120	0	0	6	114	98	16
PCT9511	TO	634	355	0	0	22	333	291	42
PCT9512	MV	617	319	0	1	17	301	267	34
PCT9512	ED	160	132	0	0	3	129	119	10
PCT9512	TO	777	451	0	1	20	430	386	44
PCT9513	MV	686	323	0	0	21	302	288	14
PCT9513	ED	191	126	0	0	7	119	110	9
PCT9513	TO	877	449	0	0	28	421	398	23
PCT9514	MV	713	347	0	0	31	316	282	34
PCT9514	ED	183	167	0	0	14	153	140	13
PCT9514	TO	896	514	0	0	45	469	422	47
PCT9515	MV	542	293	0	0	18	275	236	39
PCT9515	ED	170	133	0	0	12	121	103	18
PCT9515	TO	712	426	0	0	30	396	339	57
PCT9516	MV	705	357	0	0	22	335	292	43
PCT9516	ED	184	157	0	0	6	151	118	33
PCT9516	TO	889	514	0	0	28	486	410	76
PCT9517	MV	625	333	0	0	25	308	279	29
PCT9517	ED	163	135	0	0	15	120	104	16
PCT9517	TO	788	468	0	0	40	428	383	45
PCT9518	MV	641	312	0	0	25	287	263	24
PCT9518	ED	147	146	0	0	5	141	127	14
PCT9518	TO	788	458	0	0	30	428	390	38
PCT9519	MV	693	361	0	0	16	345	308	37
PCT9519	ED	198	170	0	0	16	154	135	19
PCT9519	TO	891	531	0	0	32	499	443	56
PCT9521	MV	687	348	0	0	25	323	289	34
PCT9521	ED	214	190	0	0	12	178	161	17
PCT9521	TO	901	538	0	0	37	501	450	51
PCT9701	MV	498	266	0	0	18	248	199	49
PCT9701	ED	156	135	0	0	4	131	117	14
PCT9701	TO	654	401	0	0	22	379	316	63
PCT9702	MV	553	296	0	0	14	282	236	46
PCT9702	ED	167	143	0	0	2	141	123	18
PCT9702	TO	720	439	0	0	16	423	359	64
PCT9703	MV	808	398	0	0	30	368	257	111
PCT9703	ED	183	142	0	0	7	135	107	28
PCT9703	TO	991	540	0	0	37	503	364	139
PCT9704	MV	759	417	0	0	31	386	301	85
PCT9704	ED	200	196	0	0	12	184	154	30
PCT9704	TO	959	613	0	0	43	570	455	115
PCT9705	MV	753	403	0	0	27	376	304	72
PCT9705	ED	176	142	0	0	8	134	120	14
PCT9705	TO	929	545	0	0	35	510	424	86
PCT9706	MV	57	33	0	0	0	33	33	0
PCT9706	ED	-8	0	0	0	0	0	0	0
PCT9706	TO	49	33	0	0	0	33	33	0
PCT9707	MV	687	352	0	0	19	333	227	106
PCT9707	ED	139	101	0	0	7	94	72	22
PCT9707	TO	826	453	0	0	26	427	299	128
PCT9708	MV	786	425	0	0	40	385	312	73
PCT9708	ED	175	157	0	0	5	152	127	25
PCT9708	TO	961	582	0	0	45	537	439	98
PCT9709	MV	831	418	0	1	33	384	273	111
PCT9709	ED	209	178	0	0	5	173	125	48
PCT9709	TO	1040	596	0	1	38	557	398	159
PCT9711	MV	502	306	0	0	16	290	223	67
PCT9711	ED	144	138	0	0	6	132	96	36
PCT9711	TO	646	444	0	0	22	422	319	103
PCT9712	MV	534	327	0	0	23	304	221	83
PCT9712	ED	127	116	0	0	1	115	86	29
PCT9712	TO	661	443	0	0	24	419	307	112
PCT9713	MV	746	384	0	0	21	363	251	112
PCT9713	ED	204	137	0	0	9	128	85	43
PCT9713	TO	950	521	0	0	30	491	336	155
PCT9714	MV	795	436	0	0	31	405	285	120
PCT9714	ED	156	133	0	0	4	129	94	35
PCT9714	TO	951	569	0	0	35	534	379	155
PCT9715	MV	449	237	0	0	11	226	161	65
PCT9715	ED	130	134	0	0	4	130	101	29
PCT9715	TO	579	371	0	0	15	356	262	94
PCT9716	MV	744	394	0	0	21	373	279	94
PCT9716	ED	222	164	0	0	12	152	116	36
PCT9716	TO	966	558	0	0	33	525	395	130
PCT9717	MV	753	424	0	0	19	405	310	95
PCT9717	ED	224	144	0	0	8	136	102	34
PCT9717	TO	977	568	0	0	27	541	412	129
PCT9718	MV	742	443	0	0	23	420	329	91
PCT9718	ED	159	144	0	0	4	140	104	36
PCT9718	TO	901	587	0	0	27	560	433	127
PCT9719	MV	747	451	0	1	25	425	318	107
PCT9719	ED	173	150	0	0	6	144	108	36
PCT9719	TO	920	601	0	1	31	569	426	143
PCT9721	MV	498	284	0	0	16	268	200	68
PCT9721	ED	164	133	0	1	4	128	95	33
PCT9721	TO	662	417	0	1	20	396	295	101
PCT9722	MV	513	311	0	0	19	292	221	71
PCT9722	ED	84	76	0	0	5	71	57	14
PCT9722	TO	597	387	0	0	24	363	278	85
PCT9723	MV	434	219	0	0	9	210	110	100
PCT9723	ED	74	44	0	0	4	40	24	16
PCT9723	TO	508	263	0	0	13	250	134	116
PCT9724	MV	848	450	0	0	24	426	245	181
PCT9724	ED	172	99	0	1	4	94	65	29
PCT9724	TO	1020	549	0	1	28	520	310	210
PCT9725	MV	806	431	0	0	24	407	255	152
PCT9725	ED	165	95	0	0	7	88	53	35
PCT9725	TO	971	526	0	0	31	495	308	187
PCT9726	MV	565	214	0	0	17	197	168	29
PCT9726	ED	51	102	0	0	6	96	83	13
PCT9726	TO	616	316	0	0	23	293	251	42
PCT9727	MV	403	220	0	2	12	206	144	62
PCT9727	ED	57	33	0	0	2	31	22	9
PCT9727	TO	460	253	0	2	14	237	166	71
PCT9728	MV	750	441	0	0	20	421	285	136
PCT9728	ED	213	137	0	0	8	129	91	38
PCT9728	TO	963	578	0	0	28	550	376	174
PCT9729	MV	654	331	0	0	18	313	213	100
PCT9729	ED	164	128	0	0	5	123	90	33
PCT9729	TO	818	459	0	0	23	436	303	133
PCT9731	MV	436	238	0	0	12	226	154	72
PCT9731	ED	143	111	0	0	3	108	82	26
PCT9731	TO	579	349	0	0	15	334	236	98
PCT9732	MV	78	47	0	0	5	42	29	13
PCT9732	ED	-5	0	0	0	0	0	0	0
PCT9732	TO	73	47	0	0	5	42	29	13
PCT9733	MV	261	154	0	0	3	151	130	21
PCT9733	ED	-21	0	0	0	0	0	0	0
PCT9733	TO	240	154	0	0	3	151	130	21
PCT9734	MV	473	283	0	0	14	269	194	75
PCT9734	ED	131	109	0	0	2	107	78	29
PCT9734	TO	604	392	0	0	16	376	272	104
PCT9735	MV	650	384	0	2	23	359	267	92
PCT9735	ED	170	132	0	0	18	114	89	25
PCT9735	TO	820	516	0	2	41	473	356	117
PCT9736	MV	586	318	0	0	18	300	225	75
PCT9736	ED	150	151	0	0	9	142	113	29
PCT9736	TO	736	469	0	0	27	442	338	104
PCT9737	MV	636	383	0	0	20	363	261	102
PCT9737	ED	155	135	0	0	5	130	109	21
PCT9737	TO	791	518	0	0	25	493	370	123
PCT9738	MV	687	311	0	0	22	289	236	53
PCT9738	ED	151	64	0	0	5	59	49	10
PCT9738	TO	838	375	0	0	27	348	285	63
PCT9739	MV	639	263	0	0	9	254	230	24
PCT9739	ED	150	88	0	0	2	86	82	4
PCT9739	TO	789	351	0	0	11	340	312	28
PCT9741	MV	508	168	0	0	15	153	144	9
PCT9741	ED	-67	10	0	0	2	8	8	0
PCT9741	TO	441	178	0	0	17	161	152	9
PCT9742	MV	529	222	0	0	6	216	142	74
PCT9742	ED	166	98	0	0	4	94	72	22
PCT9742	TO	695	320	0	0	10	310	214	96
PCT9743	MV	898	393	0	0	21	372	309	63
PCT9743	ED	242	170	0	0	13	157	139	18
PCT9743	TO	1140	563	0	0	34	529	448	81
PCT9744	MV	752	328	0	0	24	304	260	44
PCT9744	ED	191	121	0	0	11	110	95	15
PCT9744	TO	943	449	0	0	35	414	355	59
PCT9745	MV	755	313	0	0	22	291	259	32
PCT9745	ED	237	128	0	0	11	117	111	6
PCT9745	TO	992	441	0	0	33	408	370	38
PCT9746	MV	712	365	0	0	10	355	258	97
PCT9746	ED	191	118	0	0	7	111	88	23
PCT9746	TO	903	483	0	0	17	466	346	120
PCT9747	MV	768	393	0	0	16	377	274	103
PCT9747	ED	208	145	0	0	11	134	107	27
PCT9747	TO	976	538	0	0	27	511	381	130
PCT9748	MV	746	420	0	0	24	396	315	81
PCT9748	ED	167	116	0	0	6	110	81	29
PCT9748	TO	913	536	0	0	30	506	396	110
PCT9749	MV	749	281	0	0	11	270	213	57
PCT9749	ED	189	108	0	0	2	106	83	23
PCT9749	TO	938	389	0	0	13	376	296	80
PCT9751	MV	856	463	0	0	31	432	320	112
PCT9751	ED	215	151	0	0	15	136	104	32
PCT9751	TO	1071	614	0	0	46	568	424	144
PCT9752	MV	563	323	0	0	19	304	218	86
PCT9752	ED	134	108	0	0	4	104	80	24
PCT9752	TO	697	431	0	0	23	408	298	110
PCT9753	MV	617	293	0	0	13	280	224	56
PCT9753	ED	145	123	0	0	1	122	101	21
PCT9753	TO	762	416	0	0	14	402	325	77
PCT9754	MV	544	316	0	2	17	297	252	45
PCT9754	ED	163	113	0	0	6	107	93	14
PCT9754	TO	707	429	0	2	23	404	345	59
PCT9755	MV	441	238	0	0	16	222	174	48
PCT9755	ED	139	99	0	0	3	96	75	21
PCT9755	TO	580	337	0	0	19	318	249	69
PCT9756	MV	801	362	0	0	27	335	218	117
PCT9756	ED	166	106	0	0	6	100	78	22
PCT9756	TO	967	468	0	0	33	435	296	139
PCT9801	MV	320	158	0	0	12	146	114	32
PCT9801	ED	88	52	0	0	4	48	42	6
PCT9801	TO	408	210	0	0	16	194	156	38
PCT9900	MV	0	0	0	0	0	0	0	0
PCT9900	ED	0	0	0	0	0	0	0	0
PCT9900	TO	0	0	0	0	0	0	0	0
PCT9901	MV	0	0	0	0	0	0	0	0
PCT9901	ED	0	0	0	0	0	0	0	0
PCT9901	TO	0	0	0	0	0	0	0	0
PCT9902	MV	0	0	0	0	0	0	0	0
PCT9902	ED	0	0	0	0	0	0	0	0
PCT9902	TO	0	0	0	0	0	0	0	0
CONG12	MV	355422	171399	0	31	11367	160001	131836	28165
CONG12	ED	90426	65251	0	10	4495	60746	51811	8935
CONG12	TO	445848	236650	0	41	15862	220747	183647	37100
CONG14	MV	46630	21987	0	9	1177	20801	15288	5513
CONG14	ED	11421	6926	0	3	391	6532	5193	1339
CONG14	TO	58051	28913	0	12	1568	27333	20481	6852
ASSM17	MV	232714	112342	0	20	7419	104903	88515	16388
ASSM17	ED	59708	41964	0	10	2883	39071	33963	5108
ASSM17	TO	292422	154306	0	30	10302	143974	122478	21496
ASSM19	MV	169338	81044	0	20	5125	75899	58609	17290
ASSM19	ED	42139	30213	0	3	2003	28207	23041	5166
ASSM19	TO	211477	111257	0	23	7128	104106	81650	22456
SUPV1	MV	33848	16279	0	0	990	15289	12204	3085
SUPV1	ED	9268	6893	0	0	439	6454	5404	1050
SUPV1	TO	43116	23172	0	0	1429	21743	17608	4135
SUPV2	MV	41429	19608	0	4	1571	18033	14658	3375
SUPV2	ED	8617	7551	0	0	662	6889	5699	1190
SUPV2	TO	50046	27159	0	4	2233	24922	20357	4565
SUPV3	MV	31930	14092	0	3	1062	13027	10765	2262
SUPV3	ED	7447	5109	0	2	392	4715	4076	639
SUPV3	TO	39377	19201	0	5	1454	17742	14841	2901
SUPV4	MV	34985	16592	0	3	974	15615	11313	4302
SUPV4	ED	9109	5869	0	0	376	5493	4339	1154
SUPV4	TO	44094	22461	0	3	1350	21108	15652	5456
SUPV5	MV	41957	21096	0	6	1480	19610	17519	2091
SUPV5	ED	10943	8955	0	2	632	8321	7476	845
SUPV5	TO	52900	30051	0	8	2112	27931	24995	2936
SUPV6	MV	35745	14963	0	7	1073	13883	11918	1965
SUPV6	ED	7950	4327	0	2	366	3959	3464	495
SUPV6	TO	43695	19290	0	9	1439	17842	15382	2460
SUPV7	MV	38328	20392	0	8	1187	19197	14532	4665
SUPV7	ED	9115	7178	0	2	369	6807	5382	1425
SUPV7	TO	47443	27570	0	10	1556	26004	19914	6090
SUPV8	MV	46363	26976	0	3	1706	25267	21927	3340
SUPV8	ED	11814	11078	0	3	694	10381	9072	1309
SUPV8	TO	58177	38054	0	6	2400	35648	30999	4649
SUPV9	MV	33157	16480	0	1	947	15532	13099	2433
SUPV9	ED	10106	7052	0	1	403	6648	5855	793
SUPV9	TO	43263	23532	0	2	1350	22180	18954	3226
SUPV10	MV	33748	13671	0	2	870	12799	10086	2713
SUPV10	ED	9365	4180	0	0	305	3875	3237	638
SUPV10	TO	43113	17851	0	2	1175	16674	13323	3351
SUPV11	MV	30562	13237	0	3	684	12550	9103	3447
SUPV11	ED	8113	3985	0	1	248	3736	3000	736
SUPV11	TO	38675	17222	0	4	932	16286	12103	4183
NEIG1	MV	15456	5842	0	2	392	5448	4189	1259
NEIG1	ED	5029	1543	0	0	113	1430	1177	253
NEIG1	TO	20485	7385	0	2	505	6878	5366	1512
NEIG2	MV	14025	6157	0	0	511	5646	4592	1054
NEIG2	ED	3242	2161	0	1	183	1977	1680	297
NEIG2	TO	17267	8318	0	1	694	7623	6272	1351
NEIG3	MV	22038	9268	0	4	683	8581	7441	1140
NEIG3	ED	5981	3247	0	3	239	3005	2645	360
NEIG3	TO	28019	12515	0	7	922	11586	10086	1500
NEIG4	MV	5628	3436	0	0	196	3240	2674	566
NEIG4	ED	1432	1236	0	1	88	1147	938	209
NEIG4	TO	7060	4672	0	1	284	4387	3612	775
NEIG5	MV	22668	9994	0	1	544	9449	6832	2617
NEIG5	ED	5925	2958	0	0	185	2773	2201	572
NEIG5	TO	28593	12952	0	1	729	12222	9033	3189
NEIG6	MV	11525	5835	0	1	389	5445	4908	537
NEIG6	ED	2337	2735	0	1	186	2548	2304	244
NEIG6	TO	13862	8570	0	2	575	7993	7212	781
NEIG7	MV	9764	4044	0	2	190	3852	2816	1036
NEIG7	ED	2631	1293	0	1	75	1217	1002	215
NEIG7	TO	12395	5337	0	3	265	5069	3818	1251
NEIG8	MV	7624	3949	0	1	263	3685	3239	446
NEIG8	ED	2034	1820	0	0	119	1701	1499	202
NEIG8	TO	9658	5769	0	1	382	5386	4738	648
NEIG9	MV	6892	3090	0	0	187	2903	2216	687
NEIG9	ED	1366	921	0	1	65	855	709	146
NEIG9	TO	8258	4011	0	1	252	3758	2925	833
NEIG10	MV	8170	3814	0	0	261	3553	2985	568
NEIG10	ED	1852	1658	0	0	113	1545	1327	218
NEIG10	TO	10022	5472	0	0	374	5098	4312	786
NEIG11	MV	33505	15264	0	1	1276	13987	11406	2581
NEIG11	ED	5935	5701	0	0	541	5160	4245	915
NEIG11	TO	39440	20965	0	1	1817	19147	15651	3496
NEIG12	MV	23568	11636	0	2	664	10970	9796	1174
NEIG12	ED	7437	5267	0	0	327	4940	4485	455
NEIG12	TO	31005	16903	0	2	991	15910	14281	1629
NEIG14	MV	6790	3923	0	0	251	3672	3234	438
NEIG14	ED	1943	1783	0	1	92	1690	1509	181
NEIG14	TO	8733	5706	0	1	343	5362	4743	619
NEIG15	MV	5778	2610	0	0	154	2456	1955	501
NEIG15	ED	1310	1007	0	0	73	934	805	129
NEIG15	TO	7088	3617	0	0	227	3390	2760	630
NEIG13	MV	13551	7997	0	0	517	7480	6421	1059
NEIG13	ED	3437	3361	0	0	196	3165	2742	423
NEIG13	TO	16988	11358	0	0	713	10645	9163	1482
NEIG26	MV	7828	3472	0	0	200	3272	2211	1061
NEIG26	ED	1804	941	0	0	56	885	662	223
NEIG26	TO	9632	4413	0	0	256	4157	2873	1284
NEIG16	MV	14619	6688	0	1	464	6223	5330	893
NEIG16	ED	2737	2400	0	0	187	2213	1924	289
NEIG16	TO	17356	9088	0	1	651	8436	7254	1182
NEIG17	MV	29430	14222	0	0	874	13348	10619	2729
NEIG17	ED	8195	5965	0	0	380	5585	4664	921
NEIG17	TO	37625	20187	0	0	1254	18933	15283	3650
NEIG19	MV	7162	3939	0	0	223	3716	3201	515
NEIG19	ED	2409	1863	0	0	106	1757	1520	237
NEIG19	TO	9571	5802	0	0	329	5473	4721	752
NEIG18	MV	6455	3322	0	3	218	3101	2419	682
NEIG18	ED	1566	1453	0	0	97	1356	1134	222
NEIG18	TO	8021	4775	0	3	315	4457	3553	904
NEIG20	MV	20904	8767	0	5	617	8145	6939	1206
NEIG20	ED	4173	2417	0	0	206	2211	1927	284
NEIG20	TO	25077	11184	0	5	823	10356	8866	1490
NEIG21	MV	34542	16372	0	3	959	15410	11135	4275
NEIG21	ED	8951	5742	0	0	371	5371	4230	1141
NEIG21	TO	43493	22114	0	3	1330	20781	15365	5416
NEIG22	MV	15378	9122	0	2	592	8528	7477	1051
NEIG22	ED	3515	3598	0	2	218	3378	2987	391
NEIG22	TO	18893	12720	0	4	810	11906	10464	1442
NEIG23	MV	6633	2470	0	0	130	2340	1606	734
NEIG23	ED	1855	598	0	0	45	553	428	125
NEIG23	TO	8488	3068	0	0	175	2893	2034	859
NEIG24	MV	28412	15843	0	8	920	14915	11251	3664
NEIG24	ED	6962	5659	0	1	283	5375	4190	1185
NEIG24	TO	35374	21502	0	9	1203	20290	15441	4849
NEIG25	MV	23707	12310	0	4	869	11437	10232	1205
NEIG25	ED	7789	4850	0	1	342	4507	4070	437
NEIG25	TO	31496	17160	0	5	1211	15944	14302	1642
