area_id	subtotal_type	RSReg	RSCst	RSRej	RSOvr	RSUnd	RSTot	5:YES	6:NO
ALLPCTS	TO	503899	304940	0	59	22838	282043	233656	48387
ALLPCTS	ED	101263	107004	0	19	9788	97197	83015	14182
ALLPCTS	MV	402636	197936	0	40	13050	184846	150641	34205
PCT1101	MV	448	216	0	0	14	202	155	47
PCT1101	ED	114	93	0	0	9	84	73	11
PCT1101	TO	562	309	0	0	23	286	228	58
PCT1102	MV	774	370	0	0	15	355	251	104
PCT1102	ED	230	209	0	0	15	194	153	41
PCT1102	TO	1004	579	0	0	30	549	404	145
PCT1103	MV	749	373	0	0	19	354	272	82
PCT1103	ED	222	194	0	0	12	182	143	39
PCT1103	TO	971	567	0	0	31	536	415	121
PCT1104	MV	751	343	0	0	12	331	263	68
PCT1104	ED	267	169	0	0	16	153	122	31
PCT1104	TO	1018	512	0	0	28	484	385	99
PCT1106	MV	598	256	0	0	16	240	164	76
PCT1106	ED	173	149	0	1	11	137	109	28
PCT1106	TO	771	405	0	1	27	377	273	104
PCT1107	MV	612	288	0	0	14	274	187	87
PCT1107	ED	139	125	0	0	10	115	98	17
PCT1107	TO	751	413	0	0	24	389	285	104
PCT1108	MV	725	360	0	0	17	343	272	71
PCT1108	ED	198	159	0	0	15	144	119	25
PCT1108	TO	923	519	0	0	32	487	391	96
PCT1109	MV	653	285	0	0	12	273	184	89
PCT1109	ED	169	141	0	0	10	131	108	23
PCT1109	TO	822	426	0	0	22	404	292	112
PCT1111	MV	849	354	0	0	17	337	235	102
PCT1111	ED	197	189	0	0	13	176	141	35
PCT1111	TO	1046	543	0	0	30	513	376	137
PCT1112	MV	643	280	0	0	14	266	200	66
PCT1112	ED	159	119	0	0	7	112	96	16
PCT1112	TO	802	399	0	0	21	378	296	82
PCT1113	MV	675	287	0	0	15	272	191	81
PCT1113	ED	120	108	0	0	15	93	78	15
PCT1113	TO	795	395	0	0	30	365	269	96
PCT1114	MV	769	328	0	0	22	306	240	66
PCT1114	ED	222	167	0	0	19	148	130	18
PCT1114	TO	991	495	0	0	41	454	370	84
PCT1115	MV	743	296	0	0	16	280	202	78
PCT1115	ED	193	131	0	0	11	120	98	22
PCT1115	TO	936	427	0	0	27	400	300	100
PCT1116	MV	715	309	0	0	18	291	217	74
PCT1116	ED	216	197	0	0	17	180	158	22
PCT1116	TO	931	506	0	0	35	471	375	96
PCT1117	MV	665	259	0	0	14	245	184	61
PCT1117	ED	181	152	0	0	16	136	117	19
PCT1117	TO	846	411	0	0	30	381	301	80
PCT1118	MV	846	366	0	0	16	350	248	102
PCT1118	ED	219	164	0	0	15	149	119	30
PCT1118	TO	1065	530	0	0	31	499	367	132
PCT1119	MV	659	305	0	0	13	292	227	65
PCT1119	ED	138	117	0	0	12	105	96	9
PCT1119	TO	797	422	0	0	25	397	323	74
PCT1121	MV	556	269	0	0	20	249	165	84
PCT1121	ED	149	123	0	0	7	116	90	26
PCT1121	TO	705	392	0	0	27	365	255	110
PCT1122	MV	519	247	0	0	13	234	164	70
PCT1122	ED	118	97	0	0	8	89	73	16
PCT1122	TO	637	344	0	0	21	323	237	86
PCT1123	MV	730	258	0	0	17	241	164	77
PCT1123	ED	208	151	0	0	14	137	107	30
PCT1123	TO	938	409	0	0	31	378	271	107
PCT1124	MV	631	246	0	2	7	237	180	57
PCT1124	ED	198	125	0	0	7	118	104	14
PCT1124	TO	829	371	0	2	14	355	284	71
PCT1125	MV	919	365	0	0	31	334	232	102
PCT1125	ED	178	115	0	0	10	105	95	10
PCT1125	TO	1097	480	0	0	41	439	327	112
PCT1126	MV	812	308	0	0	16	292	223	69
PCT1126	ED	200	108	0	0	3	105	84	21
PCT1126	TO	1012	416	0	0	19	397	307	90
PCT1127	MV	743	296	0	0	12	284	189	95
PCT1127	ED	222	148	0	0	3	145	119	26
PCT1127	TO	965	444	0	0	15	429	308	121
PCT1128	MV	734	287	0	0	13	274	180	94
PCT1128	ED	145	108	0	0	11	97	80	17
PCT1128	TO	879	395	0	0	24	371	260	111
PCT1129	MV	790	314	0	0	22	292	201	91
PCT1129	ED	246	146	0	0	17	129	98	31
PCT1129	TO	1036	460	0	0	39	421	299	122
PCT1131	MV	694	280	0	0	22	258	181	77
PCT1131	ED	166	111	0	0	12	99	87	12
PCT1131	TO	860	391	0	0	34	357	268	89
PCT1132	MV	838	370	0	0	24	346	252	94
PCT1132	ED	194	103	0	0	7	96	70	26
PCT1132	TO	1032	473	0	0	31	442	322	120
PCT1133	MV	716	336	0	0	12	324	244	80
PCT1133	ED	159	113	0	0	7	106	75	31
PCT1133	TO	875	449	0	0	19	430	319	111
PCT1134	MV	585	293	0	0	11	282	180	102
PCT1134	ED	182	127	0	0	11	116	100	16
PCT1134	TO	767	420	0	0	22	398	280	118
PCT1135	MV	465	220	0	0	5	215	155	60
PCT1135	ED	91	61	0	0	1	60	50	10
PCT1135	TO	556	281	0	0	6	275	205	70
PCT1136	MV	710	342	0	0	16	326	245	81
PCT1136	ED	157	117	0	0	6	111	94	17
PCT1136	TO	867	459	0	0	22	437	339	98
PCT1141	MV	836	394	0	0	20	374	269	105
PCT1141	ED	220	185	0	0	11	174	137	37
PCT1141	TO	1056	579	0	0	31	548	406	142
PCT1142	MV	721	330	0	0	26	304	243	61
PCT1142	ED	175	119	0	0	6	113	98	15
PCT1142	TO	896	449	0	0	32	417	341	76
PCT1143	MV	824	360	0	0	22	338	242	96
PCT1143	ED	225	189	0	0	16	173	152	21
PCT1143	TO	1049	549	0	0	38	511	394	117
PCT1144	MV	727	327	0	0	10	317	221	96
PCT1144	ED	220	165	0	0	20	145	114	31
PCT1144	TO	947	492	0	0	30	462	335	127
PCT1145	MV	753	411	0	0	25	386	274	112
PCT1145	ED	152	152	0	0	12	140	112	28
PCT1145	TO	905	563	0	0	37	526	386	140
PCT1146	MV	839	364	0	0	15	349	276	73
PCT1146	ED	215	160	0	0	12	148	116	32
PCT1146	TO	1054	524	0	0	27	497	392	105
PCT1147	MV	673	310	0	0	11	299	215	84
PCT1147	ED	212	159	0	0	12	147	115	32
PCT1147	TO	885	469	0	0	23	446	330	116
PCT1148	MV	804	370	0	0	16	354	246	108
PCT1148	ED	224	158	0	0	17	141	114	27
PCT1148	TO	1028	528	0	0	33	495	360	135
PCT1149	MV	710	320	0	1	22	297	213	84
PCT1149	ED	229	161	0	0	11	150	120	30
PCT1149	TO	939	481	0	1	33	447	333	114
PCT1151	MV	0	0	0	0	0	0	0	0
PCT1151	ED	0	0	0	0	0	0	0	0
PCT1151	TO	0	0	0	0	0	0	0	0
PCT1152	MV	710	315	0	0	17	298	222	76
PCT1152	ED	180	137	0	0	10	127	101	26
PCT1152	TO	890	452	0	0	27	425	323	102
PCT1153	MV	730	285	0	0	17	268	205	63
PCT1153	ED	210	181	0	0	14	167	128	39
PCT1153	TO	940	466	0	0	31	435	333	102
PCT1154	MV	0	0	0	0	0	0	0	0
PCT1154	ED	0	0	0	0	0	0	0	0
PCT1154	TO	0	0	0	0	0	0	0	0
PCT7001	MV	632	331	0	0	21	310	271	39
PCT7001	ED	141	149	0	0	12	137	122	15
PCT7001	TO	773	480	0	0	33	447	393	54
PCT7002	MV	598	271	0	0	22	249	214	35
PCT7002	ED	116	142	0	0	12	130	113	17
PCT7002	TO	714	413	0	0	34	379	327	52
PCT7003	MV	759	436	0	0	25	411	351	60
PCT7003	ED	147	193	0	0	21	172	144	28
PCT7003	TO	906	629	0	0	46	583	495	88
PCT7004	MV	764	419	0	0	25	394	338	56
PCT7004	ED	149	225	0	0	23	202	172	30
PCT7004	TO	913	644	0	0	48	596	510	86
PCT7005	MV	698	351	0	0	23	328	294	34
PCT7005	ED	161	230	0	0	23	207	193	14
PCT7005	TO	859	581	0	0	46	535	487	48
PCT7006	MV	729	361	0	0	27	334	294	40
PCT7006	ED	203	240	0	0	25	215	180	35
PCT7006	TO	932	601	0	0	52	549	474	75
PCT7007	MV	777	438	0	0	30	408	351	57
PCT7007	ED	180	242	0	0	19	223	197	26
PCT7007	TO	957	680	0	0	49	631	548	83
PCT7008	MV	732	369	0	0	30	339	282	57
PCT7008	ED	177	254	0	0	24	230	197	33
PCT7008	TO	909	623	0	0	54	569	479	90
PCT7009	MV	752	391	0	0	26	365	303	62
PCT7009	ED	119	160	0	0	14	146	124	22
PCT7009	TO	871	551	0	0	40	511	427	84
PCT7011	MV	704	231	0	0	18	213	184	29
PCT7011	ED	269	142	0	0	12	130	118	12
PCT7011	TO	973	373	0	0	30	343	302	41
PCT7012	MV	999	489	0	0	34	455	392	63
PCT7012	ED	227	308	0	0	29	279	244	35
PCT7012	TO	1226	797	0	0	63	734	636	98
PCT7013	MV	984	431	0	0	27	404	363	41
PCT7013	ED	155	259	0	0	27	232	207	25
PCT7013	TO	1139	690	0	0	54	636	570	66
PCT7014	MV	610	305	0	0	18	287	255	32
PCT7014	ED	109	182	0	1	24	157	136	21
PCT7014	TO	719	487	0	1	42	444	391	53
PCT7015	MV	110	41	0	0	5	36	32	4
PCT7015	ED	0	5	0	0	0	5	3	2
PCT7015	TO	110	46	0	0	5	41	35	6
PCT7016	MV	655	239	0	0	16	223	162	61
PCT7016	ED	277	124	0	0	9	115	102	13
PCT7016	TO	932	363	0	0	25	338	264	74
PCT7017	MV	543	182	0	0	18	164	136	28
PCT7017	ED	238	92	0	0	13	79	70	9
PCT7017	TO	781	274	0	0	31	243	206	37
PCT7018	MV	847	358	0	0	20	338	248	90
PCT7018	ED	200	103	0	0	7	96	82	14
PCT7018	TO	1047	461	0	0	27	434	330	104
PCT7019	MV	734	356	0	0	25	331	243	88
PCT7019	ED	166	112	0	0	12	100	83	17
PCT7019	TO	900	468	0	0	37	431	326	105
PCT7021	MV	679	271	0	0	18	253	207	46
PCT7021	ED	288	159	0	0	18	141	121	20
PCT7021	TO	967	430	0	0	36	394	328	66
PCT7022	MV	770	340	0	0	27	313	263	50
PCT7022	ED	193	93	0	0	5	88	83	5
PCT7022	TO	963	433	0	0	32	401	346	55
PCT7023	MV	687	331	0	0	16	315	252	63
PCT7023	ED	233	118	0	0	10	108	91	17
PCT7023	TO	920	449	0	0	26	423	343	80
PCT7024	MV	251	51	0	0	3	48	43	5
PCT7024	ED	190	35	0	0	4	31	30	1
PCT7024	TO	441	86	0	0	7	79	73	6
PCT7025	MV	316	97	0	0	5	92	79	13
PCT7025	ED	167	66	0	0	1	65	55	10
PCT7025	TO	483	163	0	0	6	157	134	23
PCT7026	MV	819	338	0	1	13	324	212	112
PCT7026	ED	191	125	0	0	14	111	86	25
PCT7026	TO	1010	463	0	1	27	435	298	137
PCT7027	MV	677	272	0	0	19	253	186	67
PCT7027	ED	219	143	0	0	13	130	109	21
PCT7027	TO	896	415	0	0	32	383	295	88
PCT7028	MV	586	221	0	0	15	206	169	37
PCT7028	ED	270	151	0	0	13	138	115	23
PCT7028	TO	856	372	0	0	28	344	284	60
PCT7029	MV	643	209	0	0	20	189	149	40
PCT7029	ED	266	82	0	0	6	76	66	10
PCT7029	TO	909	291	0	0	26	265	215	50
PCT7030	MV	654	274	0	0	9	265	168	97
PCT7030	ED	141	80	0	0	3	77	54	23
PCT7030	TO	795	354	0	0	12	342	222	120
PCT7031	MV	622	266	0	1	24	241	195	46
PCT7031	ED	72	78	0	0	12	66	56	10
PCT7031	TO	694	344	0	1	36	307	251	56
PCT7032	MV	643	266	0	0	20	246	204	42
PCT7032	ED	238	105	0	0	8	97	78	19
PCT7032	TO	881	371	0	0	28	343	282	61
PCT7033	MV	549	214	0	0	17	197	154	43
PCT7033	ED	229	136	0	0	13	123	103	20
PCT7033	TO	778	350	0	0	30	320	257	63
PCT7034	MV	620	142	0	0	15	127	118	9
PCT7034	ED	318	111	0	0	8	103	92	11
PCT7034	TO	938	253	0	0	23	230	210	20
PCT7035	MV	567	238	0	0	17	221	179	42
PCT7035	ED	152	101	0	0	9	92	80	12
PCT7035	TO	719	339	0	0	26	313	259	54
PCT7036	MV	781	267	0	0	14	253	169	84
PCT7036	ED	193	79	0	0	9	70	60	10
PCT7036	TO	974	346	0	0	23	323	229	94
PCT7037	MV	434	64	0	0	4	60	49	11
PCT7037	ED	312	65	0	0	12	53	48	5
PCT7037	TO	746	129	0	0	16	113	97	16
PCT7038	MV	758	308	0	0	20	288	194	94
PCT7038	ED	203	105	0	0	13	92	79	13
PCT7038	TO	961	413	0	0	33	380	273	107
PCT7039	MV	636	244	0	0	14	230	155	75
PCT7039	ED	201	146	0	0	7	139	100	39
PCT7039	TO	837	390	0	0	21	369	255	114
PCT7041	MV	66	29	0	0	4	25	17	8
PCT7041	ED	0	2	0	0	0	2	1	1
PCT7041	TO	66	31	0	0	4	27	18	9
PCT7042	MV	514	224	0	0	9	215	169	46
PCT7042	ED	146	96	0	0	5	91	74	17
PCT7042	TO	660	320	0	0	14	306	243	63
PCT7043	MV	754	295	0	0	17	278	198	80
PCT7043	ED	224	122	0	0	11	111	87	24
PCT7043	TO	978	417	0	0	28	389	285	104
PCT7044	MV	586	150	0	0	5	145	117	28
PCT7044	ED	266	95	0	0	12	83	70	13
PCT7044	TO	852	245	0	0	17	228	187	41
PCT7045	MV	632	268	0	0	14	254	175	79
PCT7045	ED	154	80	0	0	9	71	50	21
PCT7045	TO	786	348	0	0	23	325	225	100
PCT7046	MV	334	134	0	0	4	130	91	39
PCT7046	ED	96	76	0	0	4	72	58	14
PCT7046	TO	430	210	0	0	8	202	149	53
PCT7047	MV	733	315	0	0	20	295	193	102
PCT7047	ED	150	100	0	0	12	88	71	17
PCT7047	TO	883	415	0	0	32	383	264	119
PCT7048	MV	685	267	0	0	12	255	195	60
PCT7048	ED	196	80	0	0	9	71	55	16
PCT7048	TO	881	347	0	0	21	326	250	76
PCT7049	MV	616	248	0	0	12	236	150	86
PCT7049	ED	210	104	0	0	6	98	81	17
PCT7049	TO	826	352	0	0	18	334	231	103
PCT7051	MV	715	311	0	0	21	290	184	106
PCT7051	ED	165	105	0	0	8	97	80	17
PCT7051	TO	880	416	0	0	29	387	264	123
PCT7052	MV	722	298	0	0	9	289	202	87
PCT7052	ED	184	135	0	0	13	122	101	21
PCT7052	TO	906	433	0	0	22	411	303	108
PCT7053	MV	542	227	0	0	29	198	148	50
PCT7053	ED	43	70	0	0	5	65	55	10
PCT7053	TO	585	297	0	0	34	263	203	60
PCT7054	MV	863	310	0	0	16	294	240	54
PCT7054	ED	273	170	0	0	10	160	123	37
PCT7054	TO	1136	480	0	0	26	454	363	91
PCT7055	MV	732	292	0	0	16	276	224	52
PCT7055	ED	94	150	0	0	20	130	113	17
PCT7055	TO	826	442	0	0	36	406	337	69
PCT7056	MV	619	277	0	0	20	257	224	33
PCT7056	ED	86	179	0	0	23	156	138	18
PCT7056	TO	705	456	0	0	43	413	362	51
PCT7101	MV	147	99	0	0	6	93	88	5
PCT7101	ED	0	9	0	0	2	7	7	0
PCT7101	TO	147	108	0	0	8	100	95	5
PCT7201	MV	789	384	0	0	23	361	298	63
PCT7201	ED	146	195	0	0	24	171	147	24
PCT7201	TO	935	579	0	0	47	532	445	87
PCT7202	MV	708	309	0	0	23	286	226	60
PCT7202	ED	143	188	0	0	17	171	143	28
PCT7202	TO	851	497	0	0	40	457	369	88
PCT7203	MV	693	321	0	0	33	288	239	49
PCT7203	ED	186	217	0	0	24	193	160	33
PCT7203	TO	879	538	0	0	57	481	399	82
PCT7204	MV	773	425	0	0	43	382	322	60
PCT7204	ED	126	206	0	0	32	174	148	26
PCT7204	TO	899	631	0	0	75	556	470	86
PCT7205	MV	724	360	0	0	26	334	274	60
PCT7205	ED	147	203	0	0	19	184	150	34
PCT7205	TO	871	563	0	0	45	518	424	94
PCT7206	MV	299	129	0	0	10	119	98	21
PCT7206	ED	78	130	0	0	15	115	99	16
PCT7206	TO	377	259	0	0	25	234	197	37
PCT7207	MV	744	333	0	0	25	308	255	53
PCT7207	ED	123	177	0	0	15	162	143	19
PCT7207	TO	867	510	0	0	40	470	398	72
PCT7208	MV	492	254	0	0	27	227	185	42
PCT7208	ED	78	110	0	0	11	99	92	7
PCT7208	TO	570	364	0	0	38	326	277	49
PCT7209	MV	595	343	0	0	28	315	271	44
PCT7209	ED	52	82	0	0	6	76	62	14
PCT7209	TO	647	425	0	0	34	391	333	58
PCT7301	MV	813	319	0	0	16	303	253	50
PCT7301	ED	201	154	0	0	16	138	112	26
PCT7301	TO	1014	473	0	0	32	441	365	76
PCT7302	MV	713	352	0	0	22	330	269	61
PCT7302	ED	136	153	0	0	14	139	126	13
PCT7302	TO	849	505	0	0	36	469	395	74
PCT7303	MV	869	376	0	0	23	353	289	64
PCT7303	ED	199	255	0	0	36	219	186	33
PCT7303	TO	1068	631	0	0	59	572	475	97
PCT7304	MV	803	368	0	0	28	340	261	79
PCT7304	ED	198	239	0	0	16	223	200	23
PCT7304	TO	1001	607	0	0	44	563	461	102
PCT7305	MV	714	390	0	0	26	364	275	89
PCT7305	ED	153	206	0	0	16	190	156	34
PCT7305	TO	867	596	0	0	42	554	431	123
PCT7306	MV	801	375	0	0	36	339	265	74
PCT7306	ED	243	222	0	1	41	180	153	27
PCT7306	TO	1044	597	0	1	77	519	418	101
PCT7307	MV	605	276	0	0	14	262	212	50
PCT7307	ED	169	155	0	0	19	136	119	17
PCT7307	TO	774	431	0	0	33	398	331	67
PCT7308	MV	520	257	0	0	10	247	196	51
PCT7308	ED	105	175	0	0	17	158	134	24
PCT7308	TO	625	432	0	0	27	405	330	75
PCT7309	MV	691	324	0	0	29	295	253	42
PCT7309	ED	167	214	0	0	23	191	166	25
PCT7309	TO	858	538	0	0	52	486	419	67
PCT7311	MV	698	336	0	0	23	313	268	45
PCT7311	ED	208	250	0	0	20	230	205	25
PCT7311	TO	906	586	0	0	43	543	473	70
PCT7312	MV	700	397	0	0	26	371	301	70
PCT7312	ED	110	176	0	0	16	160	132	28
PCT7312	TO	810	573	0	0	42	531	433	98
PCT7313	MV	819	375	0	0	23	352	285	67
PCT7313	ED	184	181	0	0	27	154	132	22
PCT7313	TO	1003	556	0	0	50	506	417	89
PCT7314	MV	612	226	0	0	19	207	158	49
PCT7314	ED	147	89	0	0	15	74	65	9
PCT7314	TO	759	315	0	0	34	281	223	58
PCT7315	MV	570	207	0	0	9	198	156	42
PCT7315	ED	195	181	0	0	17	164	138	26
PCT7315	TO	765	388	0	0	26	362	294	68
PCT7316	MV	654	261	0	0	28	233	188	45
PCT7316	ED	178	161	0	0	17	144	131	13
PCT7316	TO	832	422	0	0	45	377	319	58
PCT7317	MV	744	350	0	0	25	325	263	62
PCT7317	ED	146	162	0	0	14	148	134	14
PCT7317	TO	890	512	0	0	39	473	397	76
PCT7318	MV	605	294	0	0	24	270	233	37
PCT7318	ED	118	150	0	0	25	125	97	28
PCT7318	TO	723	444	0	0	49	395	330	65
PCT7319	MV	861	346	0	0	27	319	266	53
PCT7319	ED	188	208	0	0	25	183	156	27
PCT7319	TO	1049	554	0	0	52	502	422	80
PCT7321	MV	557	202	0	0	20	182	140	42
PCT7321	ED	102	106	0	0	11	95	75	20
PCT7321	TO	659	308	0	0	31	277	215	62
PCT7322	MV	742	296	0	0	25	271	209	62
PCT7322	ED	146	56	0	0	3	53	50	3
PCT7322	TO	888	352	0	0	28	324	259	65
PCT7323	MV	790	369	0	0	34	335	284	51
PCT7323	ED	166	180	0	0	20	160	133	27
PCT7323	TO	956	549	0	0	54	495	417	78
PCT7324	MV	587	260	0	0	24	236	193	43
PCT7324	ED	150	136	0	0	13	123	102	21
PCT7324	TO	737	396	0	0	37	359	295	64
PCT7325	MV	714	328	0	0	33	295	246	49
PCT7325	ED	172	183	0	0	20	163	136	27
PCT7325	TO	886	511	0	0	53	458	382	76
PCT7326	MV	685	304	0	0	25	279	218	61
PCT7326	ED	174	187	0	0	28	159	140	19
PCT7326	TO	859	491	0	0	53	438	358	80
PCT7327	MV	561	230	0	0	24	206	152	54
PCT7327	ED	126	59	0	0	4	55	49	6
PCT7327	TO	687	289	0	0	28	261	201	60
PCT7328	MV	829	334	0	0	36	298	243	55
PCT7328	ED	173	85	0	0	18	67	59	8
PCT7328	TO	1002	419	0	0	54	365	302	63
PCT7329	MV	556	228	0	0	20	208	172	36
PCT7329	ED	95	105	0	0	15	90	79	11
PCT7329	TO	651	333	0	0	35	298	251	47
PCT7331	MV	710	363	0	0	33	330	278	52
PCT7331	ED	160	170	0	0	22	148	123	25
PCT7331	TO	870	533	0	0	55	478	401	77
PCT7332	MV	654	265	0	0	22	243	215	28
PCT7332	ED	136	173	0	0	15	158	140	18
PCT7332	TO	790	438	0	0	37	401	355	46
PCT7333	MV	822	392	0	0	34	358	297	61
PCT7333	ED	193	241	0	0	24	217	190	27
PCT7333	TO	1015	633	0	0	58	575	487	88
PCT7334	MV	688	308	0	0	17	291	254	37
PCT7334	ED	131	170	0	0	16	154	132	22
PCT7334	TO	819	478	0	0	33	445	386	59
PCT7335	MV	788	390	0	0	34	356	296	60
PCT7335	ED	146	217	0	0	24	193	178	15
PCT7335	TO	934	607	0	0	58	549	474	75
PCT7336	MV	779	405	0	1	24	380	298	82
PCT7336	ED	175	189	0	0	24	165	140	25
PCT7336	TO	954	594	0	1	48	545	438	107
PCT7337	MV	772	387	0	0	31	356	291	65
PCT7337	ED	125	143	0	0	11	132	115	17
PCT7337	TO	897	530	0	0	42	488	406	82
PCT7338	MV	770	360	0	0	28	332	274	58
PCT7338	ED	125	104	0	0	11	93	82	11
PCT7338	TO	895	464	0	0	39	425	356	69
PCT7339	MV	605	270	0	0	19	251	212	39
PCT7339	ED	150	149	0	0	10	139	121	18
PCT7339	TO	755	419	0	0	29	390	333	57
PCT7341	MV	675	292	0	0	29	263	219	44
PCT7341	ED	178	183	0	0	15	168	151	17
PCT7341	TO	853	475	0	0	44	431	370	61
PCT7342	MV	674	326	0	0	20	306	261	45
PCT7342	ED	230	269	0	1	20	248	220	28
PCT7342	TO	904	595	0	1	40	554	481	73
PCT7343	MV	554	253	0	0	19	234	214	20
PCT7343	ED	150	176	0	0	20	156	141	15
PCT7343	TO	704	429	0	0	39	390	355	35
PCT7344	MV	863	393	0	0	28	365	309	56
PCT7344	ED	201	238	0	0	25	213	186	27
PCT7344	TO	1064	631	0	0	53	578	495	83
PCT7345	MV	904	434	0	0	24	410	367	43
PCT7345	ED	210	253	0	0	21	232	209	23
PCT7345	TO	1114	687	0	0	45	642	576	66
PCT7346	MV	681	288	0	1	15	272	239	33
PCT7346	ED	208	209	0	0	25	184	167	17
PCT7346	TO	889	497	0	1	40	456	406	50
PCT7347	MV	833	371	0	1	34	336	313	23
PCT7347	ED	170	192	0	0	18	174	161	13
PCT7347	TO	1003	563	0	1	52	510	474	36
PCT7348	MV	650	279	0	0	20	259	225	34
PCT7348	ED	193	159	0	0	17	142	125	17
PCT7348	TO	843	438	0	0	37	401	350	51
PCT7349	MV	710	319	0	0	23	296	256	40
PCT7349	ED	202	178	0	0	17	161	149	12
PCT7349	TO	912	497	0	0	40	457	405	52
PCT7501	MV	456	248	0	0	24	224	175	49
PCT7501	ED	95	127	0	0	14	113	90	23
PCT7501	TO	551	375	0	0	38	337	265	72
PCT7502	MV	669	318	0	0	24	294	232	62
PCT7502	ED	120	167	0	0	22	145	128	17
PCT7502	TO	789	485	0	0	46	439	360	79
PCT7503	MV	614	286	0	0	24	262	227	35
PCT7503	ED	148	163	0	0	23	140	114	26
PCT7503	TO	762	449	0	0	47	402	341	61
PCT7504	MV	404	175	0	0	15	160	138	22
PCT7504	ED	84	92	0	0	12	80	72	8
PCT7504	TO	488	267	0	0	27	240	210	30
PCT7505	MV	729	406	0	0	33	373	347	26
PCT7505	ED	133	143	0	0	6	137	125	12
PCT7505	TO	862	549	0	0	39	510	472	38
PCT7506	MV	842	365	0	0	35	330	285	45
PCT7506	ED	158	206	0	0	23	183	176	7
PCT7506	TO	1000	571	0	0	58	513	461	52
PCT7507	MV	694	291	0	0	18	273	237	36
PCT7507	ED	262	156	0	0	11	145	128	17
PCT7507	TO	956	447	0	0	29	418	365	53
PCT7508	MV	618	375	0	0	29	346	301	45
PCT7508	ED	126	131	0	0	13	118	103	15
PCT7508	TO	744	506	0	0	42	464	404	60
PCT7509	MV	756	399	0	0	28	371	318	53
PCT7509	ED	173	184	0	0	12	172	151	21
PCT7509	TO	929	583	0	0	40	543	469	74
PCT7512	MV	476	248	0	0	19	229	193	36
PCT7512	ED	124	120	0	0	13	107	96	11
PCT7512	TO	600	368	0	0	32	336	289	47
PCT7513	MV	575	248	0	0	23	225	207	18
PCT7513	ED	231	159	0	0	26	133	122	11
PCT7513	TO	806	407	0	0	49	358	329	29
PCT7514	MV	709	242	0	0	24	218	177	41
PCT7514	ED	207	100	0	0	16	84	74	10
PCT7514	TO	916	342	0	0	40	302	251	51
PCT7515	MV	664	323	0	0	16	307	255	52
PCT7515	ED	200	131	0	0	18	113	102	11
PCT7515	TO	864	454	0	0	34	420	357	63
PCT7516	MV	773	424	0	0	27	397	339	58
PCT7516	ED	147	152	0	0	13	139	114	25
PCT7516	TO	920	576	0	0	40	536	453	83
PCT7517	MV	645	362	0	0	28	334	296	38
PCT7517	ED	223	266	0	0	25	241	217	24
PCT7517	TO	868	628	0	0	53	575	513	62
PCT7518	MV	708	396	0	0	31	365	316	49
PCT7518	ED	218	273	0	0	25	248	231	17
PCT7518	TO	926	669	0	0	56	613	547	66
PCT7519	MV	543	261	0	0	26	235	214	21
PCT7519	ED	172	194	0	0	16	178	160	18
PCT7519	TO	715	455	0	0	42	413	374	39
PCT7521	MV	597	323	0	1	18	304	275	29
PCT7521	ED	182	222	0	0	13	209	189	20
PCT7521	TO	779	545	0	1	31	513	464	49
PCT7522	MV	588	302	0	0	18	284	255	29
PCT7522	ED	171	221	0	0	28	193	175	18
PCT7522	TO	759	523	0	0	46	477	430	47
PCT7523	MV	564	285	0	0	21	264	244	20
PCT7523	ED	180	247	0	0	17	230	210	20
PCT7523	TO	744	532	0	0	38	494	454	40
PCT7524	MV	481	228	0	0	22	206	192	14
PCT7524	ED	143	154	0	0	15	139	129	10
PCT7524	TO	624	382	0	0	37	345	321	24
PCT7525	MV	594	247	0	1	25	221	203	18
PCT7525	ED	170	159	0	0	20	139	134	5
PCT7525	TO	764	406	0	1	45	360	337	23
PCT7526	MV	825	397	0	0	39	358	333	25
PCT7526	ED	163	258	0	0	28	230	212	18
PCT7526	TO	988	655	0	0	67	588	545	43
PCT7527	MV	538	296	0	0	22	274	244	30
PCT7527	ED	172	157	0	0	12	145	134	11
PCT7527	TO	710	453	0	0	34	419	378	41
PCT7529	MV	749	367	0	0	22	345	322	23
PCT7529	ED	154	261	0	0	17	244	225	19
PCT7529	TO	903	628	0	0	39	589	547	42
PCT7531	MV	714	336	0	0	22	314	293	21
PCT7531	ED	159	211	0	0	13	198	177	21
PCT7531	TO	873	547	0	0	35	512	470	42
PCT7532	MV	668	330	0	0	23	307	282	25
PCT7532	ED	167	225	0	0	22	203	172	31
PCT7532	TO	835	555	0	0	45	510	454	56
PCT7533	MV	777	405	0	0	33	372	336	36
PCT7533	ED	193	286	0	0	24	262	240	22
PCT7533	TO	970	691	0	0	57	634	576	58
PCT7534	MV	670	377	0	0	35	342	299	43
PCT7534	ED	233	259	0	0	28	231	213	18
PCT7534	TO	903	636	0	0	63	573	512	61
PCT7535	MV	606	303	0	0	21	282	252	30
PCT7535	ED	139	218	0	0	23	195	180	15
PCT7535	TO	745	521	0	0	44	477	432	45
PCT7536	MV	670	347	0	0	13	334	295	39
PCT7536	ED	163	231	0	1	24	206	179	27
PCT7536	TO	833	578	0	1	37	540	474	66
PCT7537	MV	619	302	0	0	22	280	257	23
PCT7537	ED	126	221	0	0	20	201	187	14
PCT7537	TO	745	523	0	0	42	481	444	37
PCT7538	MV	562	324	0	0	19	305	285	20
PCT7538	ED	189	233	0	0	20	213	189	24
PCT7538	TO	751	557	0	0	39	518	474	44
PCT7539	MV	696	376	0	0	19	357	334	23
PCT7539	ED	225	277	0	0	23	254	233	21
PCT7539	TO	921	653	0	0	42	611	567	44
PCT7541	MV	601	296	0	0	24	272	245	27
PCT7541	ED	169	236	0	0	26	210	188	22
PCT7541	TO	770	532	0	0	50	482	433	49
PCT7542	MV	632	325	0	0	14	311	277	34
PCT7542	ED	192	222	0	0	14	208	188	20
PCT7542	TO	824	547	0	0	28	519	465	54
PCT7543	MV	694	373	0	0	14	359	321	38
PCT7543	ED	230	191	0	0	22	169	150	19
PCT7543	TO	924	564	0	0	36	528	471	57
PCT7544	MV	731	389	0	0	36	353	320	33
PCT7544	ED	168	232	0	0	20	212	194	18
PCT7544	TO	899	621	0	0	56	565	514	51
PCT7545	MV	723	386	0	0	24	362	326	36
PCT7545	ED	172	211	0	2	21	188	174	14
PCT7545	TO	895	597	0	2	45	550	500	50
PCT7546	MV	770	419	0	0	22	397	367	30
PCT7546	ED	183	277	0	0	27	250	221	29
PCT7546	TO	953	696	0	0	49	647	588	59
PCT7547	MV	799	428	0	0	31	397	372	25
PCT7547	ED	182	270	0	0	20	250	241	9
PCT7547	TO	981	698	0	0	51	647	613	34
PCT7548	MV	803	450	0	0	28	422	380	42
PCT7548	ED	248	281	0	0	25	256	234	22
PCT7548	TO	1051	731	0	0	53	678	614	64
PCT7549	MV	660	359	0	0	27	332	296	36
PCT7549	ED	146	200	0	0	21	179	166	13
PCT7549	TO	806	559	0	0	48	511	462	49
PCT7551	MV	587	304	0	0	15	289	265	24
PCT7551	ED	136	233	0	0	15	218	200	18
PCT7551	TO	723	537	0	0	30	507	465	42
PCT7552	MV	561	289	0	0	24	265	244	21
PCT7552	ED	124	185	0	0	25	160	139	21
PCT7552	TO	685	474	0	0	49	425	383	42
PCT7553	MV	191	96	0	1	5	90	79	11
PCT7553	ED	0	19	0	0	3	16	14	2
PCT7553	TO	191	115	0	1	8	106	93	13
PCT7554	MV	653	382	0	0	26	356	318	38
PCT7554	ED	168	226	0	0	21	205	185	20
PCT7554	TO	821	608	0	0	47	561	503	58
PCT7555	MV	662	418	0	0	30	388	343	45
PCT7555	ED	210	258	0	0	23	235	212	23
PCT7555	TO	872	676	0	0	53	623	555	68
PCT7556	MV	812	514	0	0	30	484	434	50
PCT7556	ED	154	236	0	0	26	210	180	30
PCT7556	TO	966	750	0	0	56	694	614	80
PCT7601	MV	485	207	0	0	14	193	177	16
PCT7601	ED	192	125	0	2	15	108	95	13
PCT7601	TO	677	332	0	2	29	301	272	29
PCT7602	MV	654	277	0	0	13	264	239	25
PCT7602	ED	232	150	0	0	14	136	123	13
PCT7602	TO	886	427	0	0	27	400	362	38
PCT7603	MV	615	296	0	0	23	273	241	32
PCT7603	ED	200	208	0	0	17	191	168	23
PCT7603	TO	815	504	0	0	40	464	409	55
PCT7604	MV	685	270	0	0	11	259	235	24
PCT7604	ED	259	187	0	0	25	162	140	22
PCT7604	TO	944	457	0	0	36	421	375	46
PCT7605	MV	469	192	0	1	15	176	150	26
PCT7605	ED	192	98	0	0	11	87	80	7
PCT7605	TO	661	290	0	1	26	263	230	33
PCT7606	MV	673	267	0	0	27	240	209	31
PCT7606	ED	210	123	0	0	15	108	97	11
PCT7606	TO	883	390	0	0	42	348	306	42
PCT7607	MV	712	288	0	0	21	267	231	36
PCT7607	ED	207	143	0	0	12	131	118	13
PCT7607	TO	919	431	0	0	33	398	349	49
PCT7608	MV	279	96	0	0	6	90	74	16
PCT7608	ED	101	28	0	1	0	27	24	3
PCT7608	TO	380	124	0	1	6	117	98	19
PCT7609	MV	699	287	0	0	21	266	239	27
PCT7609	ED	185	76	0	1	9	66	57	9
PCT7609	TO	884	363	0	1	30	332	296	36
PCT7611	MV	586	236	0	0	18	218	194	24
PCT7611	ED	202	70	0	0	7	63	58	5
PCT7611	TO	788	306	0	0	25	281	252	29
PCT7612	MV	452	216	0	0	11	205	174	31
PCT7612	ED	105	61	0	0	6	55	42	13
PCT7612	TO	557	277	0	0	17	260	216	44
PCT7613	MV	634	244	0	0	19	225	202	23
PCT7613	ED	249	123	0	0	11	112	104	8
PCT7613	TO	883	367	0	0	30	337	306	31
PCT7614	MV	713	255	0	0	24	231	204	27
PCT7614	ED	203	133	0	0	11	122	102	20
PCT7614	TO	916	388	0	0	35	353	306	47
PCT7615	MV	510	165	0	0	7	158	134	24
PCT7615	ED	240	91	0	0	9	82	73	9
PCT7615	TO	750	256	0	0	16	240	207	33
PCT7616	MV	754	332	0	0	37	295	266	29
PCT7616	ED	82	191	0	0	24	167	149	18
PCT7616	TO	836	523	0	0	61	462	415	47
PCT7617	MV	583	222	0	0	21	201	178	23
PCT7617	ED	169	78	0	0	11	67	56	11
PCT7617	TO	752	300	0	0	32	268	234	34
PCT7618	MV	763	365	0	0	20	345	283	62
PCT7618	ED	151	141	0	0	18	123	110	13
PCT7618	TO	914	506	0	0	38	468	393	75
PCT7619	MV	938	439	0	0	28	411	361	50
PCT7619	ED	169	207	0	0	25	182	159	23
PCT7619	TO	1107	646	0	0	53	593	520	73
PCT7621	MV	1006	443	0	0	29	414	374	40
PCT7621	ED	149	185	0	0	26	159	137	22
PCT7621	TO	1155	628	0	0	55	573	511	62
PCT7622	MV	697	216	0	0	9	207	181	26
PCT7622	ED	263	127	0	0	17	110	102	8
PCT7622	TO	960	343	0	0	26	317	283	34
PCT7623	MV	767	256	0	2	17	237	216	21
PCT7623	ED	237	167	0	0	19	148	135	13
PCT7623	TO	1004	423	0	2	36	385	351	34
PCT7624	MV	652	210	0	0	12	198	179	19
PCT7624	ED	223	114	0	0	19	95	93	2
PCT7624	TO	875	324	0	0	31	293	272	21
PCT7625	MV	749	396	0	2	40	354	301	53
PCT7625	ED	73	51	0	0	2	49	47	2
PCT7625	TO	822	447	0	2	42	403	348	55
PCT7626	MV	945	404	0	0	43	361	311	50
PCT7626	ED	128	164	0	0	16	148	137	11
PCT7626	TO	1073	568	0	0	59	509	448	61
PCT7627	MV	457	196	0	0	18	178	140	38
PCT7627	ED	67	80	0	0	12	68	54	14
PCT7627	TO	524	276	0	0	30	246	194	52
PCT7628	MV	718	333	0	0	16	317	280	37
PCT7628	ED	220	185	0	0	13	172	147	25
PCT7628	TO	938	518	0	0	29	489	427	62
PCT7629	MV	691	277	0	0	22	255	228	27
PCT7629	ED	162	159	0	0	16	143	128	15
PCT7629	TO	853	436	0	0	38	398	356	42
PCT7631	MV	1009	442	0	0	32	410	360	50
PCT7631	ED	210	213	0	0	25	188	163	25
PCT7631	TO	1219	655	0	0	57	598	523	75
PCT7632	MV	1002	414	0	0	20	394	346	48
PCT7632	ED	169	237	0	0	21	216	193	23
PCT7632	TO	1171	651	0	0	41	610	539	71
PCT7633	MV	609	278	0	0	19	259	222	37
PCT7633	ED	126	124	0	0	12	112	102	10
PCT7633	TO	735	402	0	0	31	371	324	47
PCT7634	MV	704	344	0	0	36	308	267	41
PCT7634	ED	186	155	0	0	21	134	115	19
PCT7634	TO	890	499	0	0	57	442	382	60
PCT7635	MV	665	274	0	0	14	260	218	42
PCT7635	ED	188	145	0	0	13	132	118	14
PCT7635	TO	853	419	0	0	27	392	336	56
PCT7636	MV	798	331	0	0	24	307	261	46
PCT7636	ED	161	188	0	0	21	167	136	31
PCT7636	TO	959	519	0	0	45	474	397	77
PCT7637	MV	747	344	0	0	30	314	244	70
PCT7637	ED	121	169	0	0	25	144	125	19
PCT7637	TO	868	513	0	0	55	458	369	89
PCT7638	MV	806	374	0	0	25	349	276	73
PCT7638	ED	83	148	0	0	16	132	95	37
PCT7638	TO	889	522	0	0	41	481	371	110
PCT7639	MV	889	397	0	0	33	364	289	75
PCT7639	ED	133	175	0	0	35	140	121	19
PCT7639	TO	1022	572	0	0	68	504	410	94
PCT7641	MV	817	401	0	0	17	384	305	79
PCT7641	ED	134	158	0	0	13	145	123	22
PCT7641	TO	951	559	0	0	30	529	428	101
PCT7642	MV	647	314	0	0	35	279	251	28
PCT7642	ED	118	157	0	0	25	132	117	15
PCT7642	TO	765	471	0	0	60	411	368	43
PCT7643	MV	810	434	0	1	27	406	332	74
PCT7643	ED	131	135	0	0	18	117	102	15
PCT7643	TO	941	569	0	1	45	523	434	89
PCT7644	MV	1014	404	0	0	35	369	312	57
PCT7644	ED	162	234	0	0	26	208	190	18
PCT7644	TO	1176	638	0	0	61	577	502	75
PCT7645	MV	595	286	0	1	20	265	213	52
PCT7645	ED	61	112	0	0	14	98	80	18
PCT7645	TO	656	398	0	1	34	363	293	70
PCT7646	MV	1032	485	0	0	36	449	382	67
PCT7646	ED	121	251	0	0	44	207	186	21
PCT7646	TO	1153	736	0	0	80	656	568	88
PCT7647	MV	724	212	0	0	10	202	172	30
PCT7647	ED	263	148	0	0	15	133	119	14
PCT7647	TO	987	360	0	0	25	335	291	44
PCT7648	MV	2	1	0	0	0	1	1	0
PCT7648	ED	0	0	0	0	0	0	0	0
PCT7648	TO	2	1	0	0	0	1	1	0
PCT7649	MV	724	286	0	0	12	274	233	41
PCT7649	ED	176	152	0	0	14	138	117	21
PCT7649	TO	900	438	0	0	26	412	350	62
PCT7651	MV	834	334	0	0	23	311	263	48
PCT7651	ED	113	169	0	0	22	147	128	19
PCT7651	TO	947	503	0	0	45	458	391	67
PCT7652	MV	535	209	0	0	15	194	162	32
PCT7652	ED	100	122	0	0	10	112	97	15
PCT7652	TO	635	331	0	0	25	306	259	47
PCT7653	MV	750	337	0	0	34	303	269	34
PCT7653	ED	89	146	0	0	19	127	107	20
PCT7653	TO	839	483	0	0	53	430	376	54
PCT7654	MV	413	191	0	0	11	180	150	30
PCT7654	ED	53	106	0	0	11	95	83	12
PCT7654	TO	466	297	0	0	22	275	233	42
PCT7655	MV	583	216	0	0	8	208	180	28
PCT7655	ED	96	127	0	0	17	110	97	13
PCT7655	TO	679	343	0	0	25	318	277	41
PCT7656	MV	603	309	0	0	23	286	242	44
PCT7656	ED	35	81	0	0	14	67	46	21
PCT7656	TO	638	390	0	0	37	353	288	65
PCT7657	MV	561	270	0	0	22	248	209	39
PCT7657	ED	37	109	0	0	15	94	82	12
PCT7657	TO	598	379	0	0	37	342	291	51
PCT7701	MV	869	482	0	0	37	445	383	62
PCT7701	ED	195	251	0	0	22	229	206	23
PCT7701	TO	1064	733	0	0	59	674	589	85
PCT7702	MV	623	378	0	0	18	360	279	81
PCT7702	ED	133	146	0	0	19	127	101	26
PCT7702	TO	756	524	0	0	37	487	380	107
PCT7703	MV	174	71	0	0	2	69	65	4
PCT7703	ED	0	1	0	0	1	0	0	0
PCT7703	TO	174	72	0	0	3	69	65	4
PCT7704	MV	798	491	0	0	37	454	340	114
PCT7704	ED	204	221	0	0	12	209	152	57
PCT7704	TO	1002	712	0	0	49	663	492	171
PCT7705	MV	470	286	0	0	15	271	204	67
PCT7705	ED	125	148	0	0	11	137	108	29
PCT7705	TO	595	434	0	0	26	408	312	96
PCT7706	MV	687	451	0	0	25	426	327	99
PCT7706	ED	179	198	0	0	10	188	144	44
PCT7706	TO	866	649	0	0	35	614	471	143
PCT7707	MV	683	432	0	0	23	409	333	76
PCT7707	ED	189	226	0	0	10	216	167	49
PCT7707	TO	872	658	0	0	33	625	500	125
PCT7708	MV	710	462	0	0	34	428	334	94
PCT7708	ED	165	192	0	0	19	173	143	30
PCT7708	TO	875	654	0	0	53	601	477	124
PCT7709	MV	324	194	0	0	9	185	154	31
PCT7709	ED	82	107	0	0	12	95	81	14
PCT7709	TO	406	301	0	0	21	280	235	45
PCT7711	MV	658	382	0	0	22	360	292	68
PCT7711	ED	153	163	0	0	10	153	136	17
PCT7711	TO	811	545	0	0	32	513	428	85
PCT7712	MV	425	259	0	0	11	248	203	45
PCT7712	ED	107	135	0	0	13	122	104	18
PCT7712	TO	532	394	0	0	24	370	307	63
PCT7801	MV	824	487	0	0	24	463	386	77
PCT7801	ED	150	249	0	0	18	231	187	44
PCT7801	TO	974	736	0	0	42	694	573	121
PCT7802	MV	647	402	0	0	27	375	331	44
PCT7802	ED	151	212	0	1	14	197	177	20
PCT7802	TO	798	614	0	1	41	572	508	64
PCT7803	MV	718	477	0	0	28	449	385	64
PCT7803	ED	113	160	0	0	15	145	125	20
PCT7803	TO	831	637	0	0	43	594	510	84
PCT7804	MV	734	463	0	0	46	417	376	41
PCT7804	ED	151	246	0	0	26	220	194	26
PCT7804	TO	885	709	0	0	72	637	570	67
PCT7805	MV	644	402	0	0	38	364	315	49
PCT7805	ED	156	216	0	0	16	200	185	15
PCT7805	TO	800	618	0	0	54	564	500	64
PCT7806	MV	602	362	0	0	24	338	307	31
PCT7806	ED	153	208	0	0	21	187	166	21
PCT7806	TO	755	570	0	0	45	525	473	52
PCT7807	MV	642	363	0	1	17	345	321	24
PCT7807	ED	185	247	0	0	22	225	210	15
PCT7807	TO	827	610	0	1	39	570	531	39
PCT7808	MV	525	297	0	0	21	276	244	32
PCT7808	ED	129	170	0	0	19	151	139	12
PCT7808	TO	654	467	0	0	40	427	383	44
PCT7809	MV	624	352	0	0	22	330	303	27
PCT7809	ED	140	184	0	0	21	163	156	7
PCT7809	TO	764	536	0	0	43	493	459	34
PCT7811	MV	582	311	0	0	23	288	266	22
PCT7811	ED	176	218	0	0	20	198	179	19
PCT7811	TO	758	529	0	0	43	486	445	41
PCT7812	MV	680	371	0	0	24	347	316	31
PCT7812	ED	217	232	0	0	19	213	190	23
PCT7812	TO	897	603	0	0	43	560	506	54
PCT7813	MV	843	486	0	0	22	464	419	45
PCT7813	ED	225	300	0	0	21	279	254	25
PCT7813	TO	1068	786	0	0	43	743	673	70
PCT7814	MV	660	281	0	0	15	266	234	32
PCT7814	ED	241	191	0	0	17	174	162	12
PCT7814	TO	901	472	0	0	32	440	396	44
PCT7815	MV	749	465	0	0	48	417	369	48
PCT7815	ED	168	231	0	0	21	210	189	21
PCT7815	TO	917	696	0	0	69	627	558	69
PCT7816	MV	724	475	0	0	36	439	384	55
PCT7816	ED	148	213	0	0	15	198	169	29
PCT7816	TO	872	688	0	0	51	637	553	84
PCT7817	MV	652	396	0	0	10	386	353	33
PCT7817	ED	186	237	0	1	13	223	200	23
PCT7817	TO	838	633	0	1	23	609	553	56
PCT7818	MV	668	393	0	0	25	368	328	40
PCT7818	ED	171	205	0	0	16	189	175	14
PCT7818	TO	839	598	0	0	41	557	503	54
PCT7819	MV	635	353	0	0	22	331	281	50
PCT7819	ED	139	183	0	0	22	161	139	22
PCT7819	TO	774	536	0	0	44	492	420	72
PCT7821	MV	806	520	0	0	26	494	433	61
PCT7821	ED	170	249	0	0	17	232	204	28
PCT7821	TO	976	769	0	0	43	726	637	89
PCT7822	MV	673	396	0	1	26	369	324	45
PCT7822	ED	219	258	0	0	25	233	192	41
PCT7822	TO	892	654	0	1	51	602	516	86
PCT7823	MV	706	411	0	0	26	385	340	45
PCT7823	ED	177	275	0	0	19	256	232	24
PCT7823	TO	883	686	0	0	45	641	572	69
PCT7824	MV	615	338	0	0	25	313	279	34
PCT7824	ED	153	219	0	0	20	199	178	21
PCT7824	TO	768	557	0	0	45	512	457	55
PCT7825	MV	457	252	0	0	13	239	228	11
PCT7825	ED	151	186	0	0	5	181	159	22
PCT7825	TO	608	438	0	0	18	420	387	33
PCT7826	MV	486	263	0	1	17	245	222	23
PCT7826	ED	204	227	0	0	21	206	191	15
PCT7826	TO	690	490	0	1	38	451	413	38
PCT7827	MV	609	320	0	0	20	300	265	35
PCT7827	ED	217	222	0	0	29	193	180	13
PCT7827	TO	826	542	0	0	49	493	445	48
PCT7828	MV	857	479	0	0	35	444	370	74
PCT7828	ED	171	251	0	0	29	222	192	30
PCT7828	TO	1028	730	0	0	64	666	562	104
PCT7829	MV	742	468	0	0	24	444	373	71
PCT7829	ED	149	204	0	0	11	193	170	23
PCT7829	TO	891	672	0	0	35	637	543	94
PCT7831	MV	763	486	0	0	41	445	385	60
PCT7831	ED	139	205	0	0	12	193	163	30
PCT7831	TO	902	691	0	0	53	638	548	90
PCT7832	MV	663	415	0	0	27	388	345	43
PCT7832	ED	118	170	0	0	15	155	139	16
PCT7832	TO	781	585	0	0	42	543	484	59
PCT7833	MV	587	345	0	0	18	327	295	32
PCT7833	ED	146	191	0	0	18	173	157	16
PCT7833	TO	733	536	0	0	36	500	452	48
PCT7834	MV	700	377	0	0	29	348	323	25
PCT7834	ED	194	258	0	0	25	233	214	19
PCT7834	TO	894	635	0	0	54	581	537	44
PCT7835	MV	721	430	0	0	27	403	329	74
PCT7835	ED	142	202	0	0	16	186	158	28
PCT7835	TO	863	632	0	0	43	589	487	102
PCT7836	MV	850	507	0	0	25	482	414	68
PCT7836	ED	193	232	0	0	10	222	182	40
PCT7836	TO	1043	739	0	0	35	704	596	108
PCT7837	MV	718	425	0	0	41	384	322	62
PCT7837	ED	205	264	0	0	18	246	220	26
PCT7837	TO	923	689	0	0	59	630	542	88
PCT7838	MV	752	494	0	0	34	460	384	76
PCT7838	ED	143	210	0	0	19	191	167	24
PCT7838	TO	895	704	0	0	53	651	551	100
PCT7839	MV	731	459	0	0	32	427	362	65
PCT7839	ED	130	201	0	0	18	183	161	22
PCT7839	TO	861	660	0	0	50	610	523	87
PCT7841	MV	752	459	0	0	31	428	373	55
PCT7841	ED	198	264	0	0	14	250	223	27
PCT7841	TO	950	723	0	0	45	678	596	82
PCT7842	MV	702	396	0	0	24	372	331	41
PCT7842	ED	177	243	0	0	18	225	204	21
PCT7842	TO	879	639	0	0	42	597	535	62
PCT7843	MV	546	296	0	0	13	283	250	33
PCT7843	ED	183	220	0	0	17	203	182	21
PCT7843	TO	729	516	0	0	30	486	432	54
PCT7844	MV	499	282	0	0	25	257	238	19
PCT7844	ED	152	187	0	0	15	172	152	20
PCT7844	TO	651	469	0	0	40	429	390	39
PCT7845	MV	676	405	0	0	24	381	348	33
PCT7845	ED	204	225	0	0	17	208	179	29
PCT7845	TO	880	630	0	0	41	589	527	62
PCT7846	MV	736	467	0	0	38	429	369	60
PCT7846	ED	172	234	0	0	27	207	181	26
PCT7846	TO	908	701	0	0	65	636	550	86
PCT7847	MV	698	432	0	0	31	401	351	50
PCT7847	ED	193	231	0	0	11	220	188	32
PCT7847	TO	891	663	0	0	42	621	539	82
PCT7848	MV	665	438	0	0	23	415	354	61
PCT7848	ED	182	226	0	0	24	202	174	28
PCT7848	TO	847	664	0	0	47	617	528	89
PCT7849	MV	729	443	0	0	32	411	356	55
PCT7849	ED	172	260	0	0	26	234	211	23
PCT7849	TO	901	703	0	0	58	645	567	78
PCT7851	MV	414	272	0	0	21	251	195	56
PCT7851	ED	112	118	0	0	9	109	83	26
PCT7851	TO	526	390	0	0	30	360	278	82
PCT7852	MV	533	351	0	0	25	326	265	61
PCT7852	ED	111	133	0	0	10	123	103	20
PCT7852	TO	644	484	0	0	35	449	368	81
PCT7853	MV	694	395	0	0	27	368	306	62
PCT7853	ED	161	196	0	0	20	176	147	29
PCT7853	TO	855	591	0	0	47	544	453	91
PCT7854	MV	703	430	0	0	26	404	348	56
PCT7854	ED	175	221	0	0	19	202	176	26
PCT7854	TO	878	651	0	0	45	606	524	82
PCT7855	MV	763	451	0	0	35	416	364	52
PCT7855	ED	211	264	0	0	26	238	207	31
PCT7855	TO	974	715	0	0	61	654	571	83
PCT7856	MV	643	378	0	0	22	356	312	44
PCT7856	ED	204	250	0	0	20	230	199	31
PCT7856	TO	847	628	0	0	42	586	511	75
PCT7857	MV	748	438	0	0	33	405	351	54
PCT7857	ED	158	220	0	0	22	198	179	19
PCT7857	TO	906	658	0	0	55	603	530	73
PCT7858	MV	622	351	0	0	21	330	296	34
PCT7858	ED	157	206	0	0	16	190	168	22
PCT7858	TO	779	557	0	0	37	520	464	56
PCT7859	MV	747	465	0	0	32	433	356	77
PCT7859	ED	152	224	0	0	27	197	160	37
PCT7859	TO	899	689	0	0	59	630	516	114
PCT7861	MV	699	435	0	0	24	411	341	70
PCT7861	ED	164	217	0	0	10	207	183	24
PCT7861	TO	863	652	0	0	34	618	524	94
PCT7862	MV	669	404	0	0	23	381	338	43
PCT7862	ED	195	241	0	0	14	227	206	21
PCT7862	TO	864	645	0	0	37	608	544	64
PCT7863	MV	693	376	0	0	26	350	306	44
PCT7863	ED	208	273	0	0	20	253	213	40
PCT7863	TO	901	649	0	0	46	603	519	84
PCT7864	MV	661	376	0	0	30	346	286	60
PCT7864	ED	153	208	0	0	19	189	161	28
PCT7864	TO	814	584	0	0	49	535	447	88
PCT7865	MV	677	410	0	0	32	378	319	59
PCT7865	ED	163	201	0	0	17	184	152	32
PCT7865	TO	840	611	0	0	49	562	471	91
PCT7866	MV	690	447	0	0	16	431	329	102
PCT7866	ED	158	192	0	0	12	180	137	43
PCT7866	TO	848	639	0	0	28	611	466	145
PCT7867	MV	766	475	0	0	21	454	390	64
PCT7867	ED	212	235	0	0	22	213	182	31
PCT7867	TO	978	710	0	0	43	667	572	95
PCT7868	MV	659	376	0	0	17	359	307	52
PCT7868	ED	217	219	0	0	15	204	174	30
PCT7868	TO	876	595	0	0	32	563	481	82
PCT7869	MV	683	445	0	0	27	418	365	53
PCT7869	ED	178	225	0	0	18	207	181	26
PCT7869	TO	861	670	0	0	45	625	546	79
PCT7871	MV	702	466	0	0	38	428	375	53
PCT7871	ED	200	199	0	1	16	182	144	38
PCT7871	TO	902	665	0	1	54	610	519	91
PCT7872	MV	675	423	0	0	26	397	340	57
PCT7872	ED	199	232	0	0	16	216	185	31
PCT7872	TO	874	655	0	0	42	613	525	88
PCT7873	MV	689	445	0	0	29	416	367	49
PCT7873	ED	202	256	0	0	21	235	198	37
PCT7873	TO	891	701	0	0	50	651	565	86
PCT7874	MV	370	191	0	0	8	183	151	32
PCT7874	ED	119	131	0	0	9	122	99	23
PCT7874	TO	489	322	0	0	17	305	250	55
PCT7875	MV	500	253	0	0	16	237	194	43
PCT7875	ED	147	158	0	0	12	146	126	20
PCT7875	TO	647	411	0	0	28	383	320	63
PCT7876	MV	462	258	0	0	18	240	221	19
PCT7876	ED	106	129	0	0	12	117	108	9
PCT7876	TO	568	387	0	0	30	357	329	28
PCT7901	MV	399	192	0	0	9	183	168	15
PCT7901	ED	150	104	0	0	7	97	86	11
PCT7901	TO	549	296	0	0	16	280	254	26
PCT7902	MV	680	291	0	0	14	277	244	33
PCT7902	ED	232	208	0	0	17	191	170	21
PCT7902	TO	912	499	0	0	31	468	414	54
PCT7903	MV	623	286	0	0	21	265	245	20
PCT7903	ED	229	196	0	0	21	175	165	10
PCT7903	TO	852	482	0	0	42	440	410	30
PCT7904	MV	680	299	0	0	20	279	244	35
PCT7904	ED	157	187	0	0	17	170	156	14
PCT7904	TO	837	486	0	0	37	449	400	49
PCT7905	MV	684	356	0	0	19	337	301	36
PCT7905	ED	191	226	0	0	15	211	196	15
PCT7905	TO	875	582	0	0	34	548	497	51
PCT7906	MV	599	283	0	0	17	266	239	27
PCT7906	ED	187	206	0	0	26	180	163	17
PCT7906	TO	786	489	0	0	43	446	402	44
PCT7907	MV	704	345	0	0	18	327	296	31
PCT7907	ED	238	251	0	0	24	227	205	22
PCT7907	TO	942	596	0	0	42	554	501	53
PCT7908	MV	752	366	0	1	21	344	319	25
PCT7908	ED	240	250	0	0	22	228	217	11
PCT7908	TO	992	616	0	1	43	572	536	36
PCT7909	MV	558	311	0	0	18	293	267	26
PCT7909	ED	185	179	0	0	11	168	155	13
PCT7909	TO	743	490	0	0	29	461	422	39
PCT7911	MV	666	323	0	0	22	301	261	40
PCT7911	ED	205	207	0	0	17	190	170	20
PCT7911	TO	871	530	0	0	39	491	431	60
PCT7912	MV	800	370	0	0	22	348	331	17
PCT7912	ED	259	263	0	0	32	231	222	9
PCT7912	TO	1059	633	0	0	54	579	553	26
PCT7913	MV	661	352	0	0	11	341	290	51
PCT7913	ED	262	303	0	0	13	290	257	33
PCT7913	TO	923	655	0	0	24	631	547	84
PCT7914	MV	716	391	0	0	26	365	320	45
PCT7914	ED	186	217	0	0	23	194	167	27
PCT7914	TO	902	608	0	0	49	559	487	72
PCT7915	MV	605	290	0	0	22	268	236	32
PCT7915	ED	238	249	0	0	15	234	212	22
PCT7915	TO	843	539	0	0	37	502	448	54
PCT7916	MV	639	338	0	0	19	319	286	33
PCT7916	ED	219	231	0	0	17	214	200	14
PCT7916	TO	858	569	0	0	36	533	486	47
PCT7917	MV	716	358	0	0	21	337	305	32
PCT7917	ED	271	262	0	0	13	249	231	18
PCT7917	TO	987	620	0	0	34	586	536	50
PCT7918	MV	597	297	0	0	14	283	268	15
PCT7918	ED	227	202	0	1	15	186	167	19
PCT7918	TO	824	499	0	1	29	469	435	34
PCT7919	MV	609	309	0	0	16	293	268	25
PCT7919	ED	257	251	0	0	19	232	217	15
PCT7919	TO	866	560	0	0	35	525	485	40
PCT7921	MV	682	310	0	0	16	294	261	33
PCT7921	ED	229	181	0	0	18	163	145	18
PCT7921	TO	911	491	0	0	34	457	406	51
PCT7922	MV	648	314	0	0	10	304	273	31
PCT7922	ED	210	247	0	0	18	229	212	17
PCT7922	TO	858	561	0	0	28	533	485	48
PCT7923	MV	666	338	0	0	15	323	267	56
PCT7923	ED	214	261	0	0	26	235	211	24
PCT7923	TO	880	599	0	0	41	558	478	80
PCT7924	MV	650	305	0	0	11	294	259	35
PCT7924	ED	201	191	0	0	18	173	155	18
PCT7924	TO	851	496	0	0	29	467	414	53
PCT7925	MV	434	227	0	0	15	212	183	29
PCT7925	ED	110	127	0	0	9	118	107	11
PCT7925	TO	544	354	0	0	24	330	290	40
PCT7926	MV	610	341	0	0	23	318	281	37
PCT7926	ED	178	199	0	0	12	187	157	30
PCT7926	TO	788	540	0	0	35	505	438	67
PCT7927	MV	580	337	0	0	28	309	275	34
PCT7927	ED	162	217	0	0	14	203	184	19
PCT7927	TO	742	554	0	0	42	512	459	53
PCT7928	MV	700	397	0	0	22	375	333	42
PCT7928	ED	217	276	0	0	17	259	232	27
PCT7928	TO	917	673	0	0	39	634	565	69
PCT7929	MV	678	424	0	0	23	401	352	49
PCT7929	ED	169	225	0	0	13	212	188	24
PCT7929	TO	847	649	0	0	36	613	540	73
PCT7931	MV	610	378	0	0	30	348	300	48
PCT7931	ED	141	187	0	0	17	170	144	26
PCT7931	TO	751	565	0	0	47	518	444	74
PCT7932	MV	443	277	0	0	16	261	216	45
PCT7932	ED	118	117	0	0	11	106	95	11
PCT7932	TO	561	394	0	0	27	367	311	56
PCT7933	MV	8	6	0	0	0	6	4	2
PCT7933	ED	0	0	0	0	0	0	0	0
PCT7933	TO	8	6	0	0	0	6	4	2
PCT7934	MV	702	413	0	0	28	385	353	32
PCT7934	ED	182	202	0	0	23	179	160	19
PCT7934	TO	884	615	0	0	51	564	513	51
PCT7935	MV	716	441	0	0	29	412	363	49
PCT7935	ED	227	277	0	0	22	255	230	25
PCT7935	TO	943	718	0	0	51	667	593	74
PCT7936	MV	620	374	0	0	24	350	309	41
PCT7936	ED	236	271	0	1	22	248	219	29
PCT7936	TO	856	645	0	1	46	598	528	70
PCT7937	MV	698	406	0	0	25	381	341	40
PCT7937	ED	202	218	0	0	14	204	179	25
PCT7937	TO	900	624	0	0	39	585	520	65
PCT7938	MV	536	301	0	0	13	288	253	35
PCT7938	ED	215	153	0	0	14	139	121	18
PCT7938	TO	751	454	0	0	27	427	374	53
PCT7939	MV	481	292	0	0	15	277	250	27
PCT7939	ED	205	239	0	0	18	221	200	21
PCT7939	TO	686	531	0	0	33	498	450	48
PCT7941	MV	576	305	0	0	25	280	243	37
PCT7941	ED	196	202	0	0	12	190	164	26
PCT7941	TO	772	507	0	0	37	470	407	63
PCT7942	MV	658	333	0	0	16	317	273	44
PCT7942	ED	274	191	0	0	10	181	160	21
PCT7942	TO	932	524	0	0	26	498	433	65
PCT7943	MV	686	370	0	0	16	354	290	64
PCT7943	ED	214	241	0	0	22	219	185	34
PCT7943	TO	900	611	0	0	38	573	475	98
PCT7944	MV	584	343	0	0	23	320	280	40
PCT7944	ED	230	241	0	0	19	222	190	32
PCT7944	TO	814	584	0	0	42	542	470	72
PCT7945	MV	726	339	0	0	25	314	273	41
PCT7945	ED	228	139	0	0	14	125	110	15
PCT7945	TO	954	478	0	0	39	439	383	56
PCT7946	MV	779	369	0	0	18	351	239	112
PCT7946	ED	206	145	0	0	10	135	106	29
PCT7946	TO	985	514	0	0	28	486	345	141
PCT7947	MV	792	333	0	0	26	307	197	110
PCT7947	ED	194	150	0	0	11	139	109	30
PCT7947	TO	986	483	0	0	37	446	306	140
PCT7948	MV	730	375	0	0	26	349	233	116
PCT7948	ED	200	161	0	0	11	150	119	31
PCT7948	TO	930	536	0	0	37	499	352	147
PCT7949	MV	484	234	0	0	12	222	138	84
PCT7949	ED	106	84	0	0	9	75	60	15
PCT7949	TO	590	318	0	0	21	297	198	99
PCT7951	MV	731	366	0	0	27	339	218	121
PCT7951	ED	156	116	0	0	11	105	78	27
PCT7951	TO	887	482	0	0	38	444	296	148
PCT7952	MV	730	294	0	0	20	274	170	104
PCT7952	ED	182	132	0	0	12	120	91	29
PCT7952	TO	912	426	0	0	32	394	261	133
PCT7953	MV	669	331	0	0	18	313	218	95
PCT7953	ED	161	140	0	0	6	134	86	48
PCT7953	TO	830	471	0	0	24	447	304	143
PCT7954	MV	0	0	0	0	0	0	0	0
PCT7954	ED	0	0	0	0	0	0	0	0
PCT7954	TO	0	0	0	0	0	0	0	0
PCT7955	MV	774	351	0	0	15	336	228	108
PCT7955	ED	173	142	0	0	18	124	89	35
PCT7955	TO	947	493	0	0	33	460	317	143
PCT7956	MV	699	267	0	0	11	256	170	86
PCT7956	ED	170	84	0	0	4	80	68	12
PCT7956	TO	869	351	0	0	15	336	238	98
PCT7957	MV	538	261	0	0	13	248	191	57
PCT7957	ED	135	120	0	0	8	112	96	16
PCT7957	TO	673	381	0	0	21	360	287	73
PCT7958	MV	297	108	0	0	6	102	78	24
PCT7958	ED	0	14	0	0	3	11	9	2
PCT7958	TO	297	122	0	0	9	113	87	26
PCT7959	MV	541	230	0	0	18	212	195	17
PCT7959	ED	145	162	0	0	17	145	133	12
PCT7959	TO	686	392	0	0	35	357	328	29
PCT9001	MV	284	101	0	0	3	98	86	12
PCT9001	ED	0	7	0	0	1	6	4	2
PCT9001	TO	284	108	0	0	4	104	90	14
PCT9101	MV	712	380	0	0	23	357	277	80
PCT9101	ED	201	210	0	0	16	194	163	31
PCT9101	TO	913	590	0	0	39	551	440	111
PCT9102	MV	788	395	0	0	25	370	304	66
PCT9102	ED	204	201	0	1	11	189	156	33
PCT9102	TO	992	596	0	1	36	559	460	99
PCT9103	MV	719	382	0	0	25	357	287	70
PCT9103	ED	238	226	0	0	18	208	160	48
PCT9103	TO	957	608	0	0	43	565	447	118
PCT9104	MV	810	383	0	0	32	351	280	71
PCT9104	ED	220	205	0	0	16	189	157	32
PCT9104	TO	1030	588	0	0	48	540	437	103
PCT9105	MV	719	413	0	0	20	393	318	75
PCT9105	ED	199	241	0	0	18	223	186	37
PCT9105	TO	918	654	0	0	38	616	504	112
PCT9106	MV	748	399	0	0	24	375	305	70
PCT9106	ED	198	268	0	0	26	242	212	30
PCT9106	TO	946	667	0	0	50	617	517	100
PCT9107	MV	636	306	0	0	24	282	238	44
PCT9107	ED	208	187	0	0	20	167	153	14
PCT9107	TO	844	493	0	0	44	449	391	58
PCT9108	MV	610	338	0	0	31	307	258	49
PCT9108	ED	200	197	0	0	14	183	161	22
PCT9108	TO	810	535	0	0	45	490	419	71
PCT9109	MV	672	300	0	0	25	275	227	48
PCT9109	ED	211	213	0	0	11	202	164	38
PCT9109	TO	883	513	0	0	36	477	391	86
PCT9111	MV	639	318	0	0	23	295	251	44
PCT9111	ED	195	196	0	0	18	178	157	21
PCT9111	TO	834	514	0	0	41	473	408	65
PCT9112	MV	742	352	0	0	23	329	268	61
PCT9112	ED	219	218	0	0	16	202	181	21
PCT9112	TO	961	570	0	0	39	531	449	82
PCT9113	MV	797	373	0	0	24	349	275	74
PCT9113	ED	207	264	0	0	24	240	198	42
PCT9113	TO	1004	637	0	0	48	589	473	116
PCT9114	MV	659	294	0	0	18	276	237	39
PCT9114	ED	231	202	0	0	21	181	167	14
PCT9114	TO	890	496	0	0	39	457	404	53
PCT9115	MV	699	326	0	0	27	299	254	45
PCT9115	ED	182	198	0	0	18	180	157	23
PCT9115	TO	881	524	0	0	45	479	411	68
PCT9116	MV	782	347	0	0	18	329	265	64
PCT9116	ED	179	225	0	0	18	207	170	37
PCT9116	TO	961	572	0	0	36	536	435	101
PCT9117	MV	629	328	0	0	16	312	242	70
PCT9117	ED	171	207	0	0	18	189	152	37
PCT9117	TO	800	535	0	0	34	501	394	107
PCT9118	MV	742	341	0	0	26	315	237	78
PCT9118	ED	242	256	0	0	27	229	190	39
PCT9118	TO	984	597	0	0	53	544	427	117
PCT9119	MV	703	389	0	0	22	367	280	87
PCT9119	ED	197	171	0	0	19	152	128	24
PCT9119	TO	900	560	0	0	41	519	408	111
PCT9121	MV	735	337	0	0	18	319	251	68
PCT9121	ED	218	207	0	0	12	195	155	40
PCT9121	TO	953	544	0	0	30	514	406	108
PCT9122	MV	775	365	0	0	24	341	244	97
PCT9122	ED	192	184	0	0	26	158	129	29
PCT9122	TO	967	549	0	0	50	499	373	126
PCT9123	MV	661	319	0	0	20	299	223	76
PCT9123	ED	191	206	0	0	20	186	167	19
PCT9123	TO	852	525	0	0	40	485	390	95
PCT9124	MV	736	354	0	0	14	340	257	83
PCT9124	ED	167	175	0	0	11	164	134	30
PCT9124	TO	903	529	0	0	25	504	391	113
PCT9125	MV	681	360	0	0	17	343	273	70
PCT9125	ED	188	188	0	0	22	166	144	22
PCT9125	TO	869	548	0	0	39	509	417	92
PCT9126	MV	819	386	0	0	21	365	268	97
PCT9126	ED	194	224	0	0	14	210	173	37
PCT9126	TO	1013	610	0	0	35	575	441	134
PCT9127	MV	748	384	0	0	29	355	293	62
PCT9127	ED	223	241	0	0	15	226	185	41
PCT9127	TO	971	625	0	0	44	581	478	103
PCT9128	MV	628	336	0	0	23	313	241	72
PCT9128	ED	190	211	0	0	19	192	166	26
PCT9128	TO	818	547	0	0	42	505	407	98
PCT9129	MV	587	273	0	0	12	261	208	53
PCT9129	ED	151	170	0	0	14	156	138	18
PCT9129	TO	738	443	0	0	26	417	346	71
PCT9131	MV	596	288	0	0	11	277	212	65
PCT9131	ED	138	176	0	0	13	163	136	27
PCT9131	TO	734	464	0	0	24	440	348	92
PCT9132	MV	627	263	0	0	14	249	220	29
PCT9132	ED	194	197	0	0	14	183	158	25
PCT9132	TO	821	460	0	0	28	432	378	54
PCT9133	MV	808	383	0	0	22	361	302	59
PCT9133	ED	209	250	0	0	20	230	194	36
PCT9133	TO	1017	633	0	0	42	591	496	95
PCT9134	MV	736	328	0	0	18	310	228	82
PCT9134	ED	155	187	0	0	15	172	145	27
PCT9134	TO	891	515	0	0	33	482	373	109
PCT9135	MV	640	305	0	0	19	286	232	54
PCT9135	ED	182	173	0	0	13	160	124	36
PCT9135	TO	822	478	0	0	32	446	356	90
PCT9136	MV	706	368	0	0	26	342	270	72
PCT9136	ED	212	206	0	0	24	182	151	31
PCT9136	TO	918	574	0	0	50	524	421	103
PCT9137	MV	806	389	0	0	27	362	281	81
PCT9137	ED	209	210	0	0	16	194	166	28
PCT9137	TO	1015	599	0	0	43	556	447	109
PCT9138	MV	770	401	0	0	23	378	289	89
PCT9138	ED	175	171	0	0	16	155	139	16
PCT9138	TO	945	572	0	0	39	533	428	105
PCT9139	MV	828	424	0	0	26	398	293	105
PCT9139	ED	190	207	0	0	19	188	156	32
PCT9139	TO	1018	631	0	0	45	586	449	137
PCT9141	MV	789	419	0	0	31	388	292	96
PCT9141	ED	184	189	0	0	15	174	144	30
PCT9141	TO	973	608	0	0	46	562	436	126
PCT9142	MV	747	366	0	0	21	345	285	60
PCT9142	ED	239	236	0	0	21	215	180	35
PCT9142	TO	986	602	0	0	42	560	465	95
PCT9143	MV	706	362	0	0	21	341	265	76
PCT9143	ED	208	202	0	0	12	190	150	40
PCT9143	TO	914	564	0	0	33	531	415	116
PCT9144	MV	767	376	0	0	22	354	271	83
PCT9144	ED	203	238	0	0	15	223	199	24
PCT9144	TO	970	614	0	0	37	577	470	107
PCT9145	MV	681	335	0	0	18	317	256	61
PCT9145	ED	194	216	0	0	16	200	161	39
PCT9145	TO	875	551	0	0	34	517	417	100
PCT9146	MV	725	354	0	0	26	328	282	46
PCT9146	ED	160	215	0	0	26	189	155	34
PCT9146	TO	885	569	0	0	52	517	437	80
PCT9147	MV	765	373	0	0	20	353	292	61
PCT9147	ED	225	227	0	0	16	211	180	31
PCT9147	TO	990	600	0	0	36	564	472	92
PCT9148	MV	779	398	0	0	19	379	323	56
PCT9148	ED	235	256	0	0	26	230	199	31
PCT9148	TO	1014	654	0	0	45	609	522	87
PCT9149	MV	813	388	0	0	22	366	300	66
PCT9149	ED	178	292	0	0	21	271	236	35
PCT9149	TO	991	680	0	0	43	637	536	101
PCT9151	MV	693	352	0	0	25	327	282	45
PCT9151	ED	168	228	0	0	25	203	170	33
PCT9151	TO	861	580	0	0	50	530	452	78
PCT9152	MV	550	198	0	0	10	188	163	25
PCT9152	ED	187	356	0	0	30	326	294	32
PCT9152	TO	737	554	0	0	40	514	457	57
PCT9201	MV	785	358	0	0	25	333	308	25
PCT9201	ED	186	252	0	0	10	242	211	31
PCT9201	TO	971	610	0	0	35	575	519	56
PCT9202	MV	819	368	0	0	33	335	292	43
PCT9202	ED	177	253	0	0	22	231	195	36
PCT9202	TO	996	621	0	0	55	566	487	79
PCT9203	MV	847	374	0	0	52	322	247	75
PCT9203	ED	155	208	0	0	27	181	124	57
PCT9203	TO	1002	582	0	0	79	503	371	132
PCT9204	MV	686	309	0	0	30	279	211	68
PCT9204	ED	176	219	0	0	25	194	155	39
PCT9204	TO	862	528	0	0	55	473	366	107
PCT9205	MV	622	289	0	0	37	252	219	33
PCT9205	ED	114	171	0	0	24	147	116	31
PCT9205	TO	736	460	0	0	61	399	335	64
PCT9206	MV	741	355	0	0	22	333	247	86
PCT9206	ED	188	208	0	0	39	169	132	37
PCT9206	TO	929	563	0	0	61	502	379	123
PCT9207	MV	824	370	0	0	29	341	265	76
PCT9207	ED	165	208	0	0	24	184	147	37
PCT9207	TO	989	578	0	0	53	525	412	113
PCT9208	MV	808	359	0	0	26	333	273	60
PCT9208	ED	179	199	0	0	19	180	152	28
PCT9208	TO	987	558	0	0	45	513	425	88
PCT9209	MV	615	276	0	0	24	252	196	56
PCT9209	ED	156	190	0	0	33	157	126	31
PCT9209	TO	771	466	0	0	57	409	322	87
PCT9211	MV	730	314	0	0	31	283	223	60
PCT9211	ED	161	191	0	0	28	163	129	34
PCT9211	TO	891	505	0	0	59	446	352	94
PCT9212	MV	671	285	0	1	24	260	206	54
PCT9212	ED	137	192	0	0	36	156	132	24
PCT9212	TO	808	477	0	1	60	416	338	78
PCT9213	MV	776	350	0	0	35	315	248	67
PCT9213	ED	161	212	0	0	28	184	157	27
PCT9213	TO	937	562	0	0	63	499	405	94
PCT9214	MV	517	236	0	0	16	220	179	41
PCT9214	ED	110	157	0	0	22	135	109	26
PCT9214	TO	627	393	0	0	38	355	288	67
PCT9215	MV	524	246	0	0	15	231	184	47
PCT9215	ED	120	152	0	0	19	133	103	30
PCT9215	TO	644	398	0	0	34	364	287	77
PCT9216	MV	669	266	0	0	31	235	172	63
PCT9216	ED	155	223	0	0	23	200	159	41
PCT9216	TO	824	489	0	0	54	435	331	104
PCT9217	MV	588	269	0	0	11	258	208	50
PCT9217	ED	117	160	0	0	11	149	120	29
PCT9217	TO	705	429	0	0	22	407	328	79
PCT9218	MV	652	278	0	0	26	252	191	61
PCT9218	ED	164	188	0	0	21	167	138	29
PCT9218	TO	816	466	0	0	47	419	329	90
PCT9219	MV	646	292	0	0	30	262	230	32
PCT9219	ED	144	204	0	0	26	178	148	30
PCT9219	TO	790	496	0	0	56	440	378	62
PCT9221	MV	562	325	0	0	19	306	222	84
PCT9221	ED	89	145	0	0	17	128	102	26
PCT9221	TO	651	470	0	0	36	434	324	110
PCT9222	MV	773	374	0	0	29	345	278	67
PCT9222	ED	137	210	0	0	28	182	147	35
PCT9222	TO	910	584	0	0	57	527	425	102
PCT9223	MV	558	268	0	0	17	251	198	53
PCT9223	ED	109	127	0	0	14	113	84	29
PCT9223	TO	667	395	0	0	31	364	282	82
PCT9224	MV	768	380	0	0	25	355	286	69
PCT9224	ED	181	220	0	0	31	189	147	42
PCT9224	TO	949	600	0	0	56	544	433	111
PCT9225	MV	757	304	0	0	20	284	234	50
PCT9225	ED	169	234	0	0	27	207	176	31
PCT9225	TO	926	538	0	0	47	491	410	81
PCT9226	MV	741	357	0	0	36	321	277	44
PCT9226	ED	155	239	0	0	27	212	184	28
PCT9226	TO	896	596	0	0	63	533	461	72
PCT9227	MV	605	373	0	0	27	346	264	82
PCT9227	ED	124	156	0	0	8	148	119	29
PCT9227	TO	729	529	0	0	35	494	383	111
PCT9228	MV	578	314	0	3	19	292	219	73
PCT9228	ED	160	188	0	0	15	173	147	26
PCT9228	TO	738	502	0	3	34	465	366	99
PCT9229	MV	460	257	0	0	21	236	205	31
PCT9229	ED	119	147	0	0	13	134	115	19
PCT9229	TO	579	404	0	0	34	370	320	50
PCT9231	MV	726	354	0	0	21	333	268	65
PCT9231	ED	236	282	0	0	23	259	224	35
PCT9231	TO	962	636	0	0	44	592	492	100
PCT9232	MV	608	295	0	0	26	269	208	61
PCT9232	ED	126	183	0	0	19	164	129	35
PCT9232	TO	734	478	0	0	45	433	337	96
PCT9233	MV	668	332	0	0	28	304	232	72
PCT9233	ED	150	201	0	0	28	173	146	27
PCT9233	TO	818	533	0	0	56	477	378	99
PCT9234	MV	643	322	0	0	21	301	237	64
PCT9234	ED	91	155	0	0	23	132	104	28
PCT9234	TO	734	477	0	0	44	433	341	92
PCT9235	MV	703	368	0	0	27	341	245	96
PCT9235	ED	160	212	0	0	21	191	153	38
PCT9235	TO	863	580	0	0	48	532	398	134
PCT9236	MV	537	283	0	0	20	263	221	42
PCT9236	ED	136	148	0	0	19	129	106	23
PCT9236	TO	673	431	0	0	39	392	327	65
PCT9237	MV	779	396	0	0	27	369	294	75
PCT9237	ED	118	206	0	0	22	184	156	28
PCT9237	TO	897	602	0	0	49	553	450	103
PCT9238	MV	687	330	0	0	35	295	246	49
PCT9238	ED	118	192	0	0	27	165	140	25
PCT9238	TO	805	522	0	0	62	460	386	74
PCT9239	MV	740	391	0	0	41	350	292	58
PCT9239	ED	124	174	0	0	21	153	132	21
PCT9239	TO	864	565	0	0	62	503	424	79
PCT9241	MV	819	404	0	0	31	373	306	67
PCT9241	ED	141	211	0	0	21	190	167	23
PCT9241	TO	960	615	0	0	52	563	473	90
PCT9242	MV	771	350	0	0	36	314	264	50
PCT9242	ED	172	238	0	0	36	202	172	30
PCT9242	TO	943	588	0	0	72	516	436	80
PCT9243	MV	480	242	0	0	23	219	183	36
PCT9243	ED	123	154	0	0	21	133	115	18
PCT9243	TO	603	396	0	0	44	352	298	54
PCT9244	MV	756	399	0	0	44	355	302	53
PCT9244	ED	154	206	0	0	18	188	163	25
PCT9244	TO	910	605	0	0	62	543	465	78
PCT9245	MV	616	301	0	0	29	272	224	48
PCT9245	ED	98	145	0	0	19	126	102	24
PCT9245	TO	714	446	0	0	48	398	326	72
PCT9246	MV	815	434	0	0	33	401	321	80
PCT9246	ED	155	214	0	0	25	189	165	24
PCT9246	TO	970	648	0	0	58	590	486	104
PCT9247	MV	764	381	0	0	23	358	296	62
PCT9247	ED	148	225	0	0	27	198	165	33
PCT9247	TO	912	606	0	0	50	556	461	95
PCT9248	MV	757	360	0	0	29	331	289	42
PCT9248	ED	150	211	0	0	21	190	170	20
PCT9248	TO	907	571	0	0	50	521	459	62
PCT9249	MV	724	380	0	0	29	351	303	48
PCT9249	ED	191	235	0	0	21	214	176	38
PCT9249	TO	915	615	0	0	50	565	479	86
PCT9251	MV	792	393	0	0	29	364	304	60
PCT9251	ED	174	248	0	0	17	231	187	44
PCT9251	TO	966	641	0	0	46	595	491	104
PCT9252	MV	811	384	0	0	27	357	285	72
PCT9252	ED	142	211	0	0	22	189	160	29
PCT9252	TO	953	595	0	0	49	546	445	101
PCT9253	MV	599	300	0	0	16	284	239	45
PCT9253	ED	162	170	0	0	13	157	136	21
PCT9253	TO	761	470	0	0	29	441	375	66
PCT9254	MV	758	415	0	0	24	391	326	65
PCT9254	ED	163	229	0	0	31	198	172	26
PCT9254	TO	921	644	0	0	55	589	498	91
PCT9255	MV	437	196	0	0	20	176	153	23
PCT9255	ED	113	155	0	0	19	136	115	21
PCT9255	TO	550	351	0	0	39	312	268	44
PCT9256	MV	367	169	0	0	9	160	135	25
PCT9256	ED	95	134	0	0	12	122	108	14
PCT9256	TO	462	303	0	0	21	282	243	39
PCT9257	MV	320	165	0	0	15	150	132	18
PCT9257	ED	0	23	0	0	4	19	18	1
PCT9257	TO	320	188	0	0	19	169	150	19
PCT9258	MV	583	307	0	0	29	278	230	48
PCT9258	ED	120	162	0	0	14	148	138	10
PCT9258	TO	703	469	0	0	43	426	368	58
PCT9401	MV	796	359	0	0	21	338	290	48
PCT9401	ED	242	259	0	0	25	234	209	25
PCT9401	TO	1038	618	0	0	46	572	499	73
PCT9402	MV	775	378	0	0	15	363	296	67
PCT9402	ED	242	226	0	0	17	209	182	27
PCT9402	TO	1017	604	0	0	32	572	478	94
PCT9403	MV	731	349	0	0	13	336	257	79
PCT9403	ED	190	183	0	0	13	170	155	15
PCT9403	TO	921	532	0	0	26	506	412	94
PCT9404	MV	753	345	0	0	20	325	247	78
PCT9404	ED	191	209	0	0	17	192	156	36
PCT9404	TO	944	554	0	0	37	517	403	114
PCT9405	MV	629	278	0	0	19	259	193	66
PCT9405	ED	151	145	0	0	7	138	108	30
PCT9405	TO	780	423	0	0	26	397	301	96
PCT9406	MV	695	332	0	0	21	311	236	75
PCT9406	ED	188	198	0	0	13	185	145	40
PCT9406	TO	883	530	0	0	34	496	381	115
PCT9407	MV	712	369	0	0	16	353	295	58
PCT9407	ED	201	195	0	0	21	174	143	31
PCT9407	TO	913	564	0	0	37	527	438	89
PCT9408	MV	711	324	0	0	24	300	266	34
PCT9408	ED	152	195	0	0	15	180	161	19
PCT9408	TO	863	519	0	0	39	480	427	53
PCT9409	MV	443	227	0	0	19	208	179	29
PCT9409	ED	158	172	0	0	11	161	145	16
PCT9409	TO	601	399	0	0	30	369	324	45
PCT9411	MV	816	378	0	0	24	354	302	52
PCT9411	ED	191	239	0	0	17	222	197	25
PCT9411	TO	1007	617	0	0	41	576	499	77
PCT9412	MV	668	340	0	0	16	324	241	83
PCT9412	ED	202	199	0	0	13	186	148	38
PCT9412	TO	870	539	0	0	29	510	389	121
PCT9413	MV	757	379	0	0	26	353	262	91
PCT9413	ED	179	185	0	0	15	170	139	31
PCT9413	TO	936	564	0	0	41	523	401	122
PCT9414	MV	734	361	0	1	24	336	248	88
PCT9414	ED	186	162	0	0	10	152	128	24
PCT9414	TO	920	523	0	1	34	488	376	112
PCT9415	MV	634	315	0	0	16	299	233	66
PCT9415	ED	154	138	0	0	7	131	112	19
PCT9415	TO	788	453	0	0	23	430	345	85
PCT9416	MV	769	391	0	0	31	360	273	87
PCT9416	ED	230	206	0	0	10	196	158	38
PCT9416	TO	999	597	0	0	41	556	431	125
PCT9417	MV	629	322	0	0	15	307	223	84
PCT9417	ED	145	153	0	0	7	146	113	33
PCT9417	TO	774	475	0	0	22	453	336	117
PCT9418	MV	631	310	0	0	25	285	201	84
PCT9418	ED	188	161	0	0	10	151	111	40
PCT9418	TO	819	471	0	0	35	436	312	124
PCT9419	MV	736	371	0	0	19	352	253	99
PCT9419	ED	173	148	0	0	10	138	99	39
PCT9419	TO	909	519	0	0	29	490	352	138
PCT9421	MV	752	342	0	0	21	321	216	105
PCT9421	ED	173	172	0	0	10	162	121	41
PCT9421	TO	925	514	0	0	31	483	337	146
PCT9422	MV	831	413	0	0	25	388	284	104
PCT9422	ED	270	222	0	0	21	201	169	32
PCT9422	TO	1101	635	0	0	46	589	453	136
PCT9423	MV	714	318	0	0	22	296	212	84
PCT9423	ED	190	187	0	0	19	168	134	34
PCT9423	TO	904	505	0	0	41	464	346	118
PCT9424	MV	799	386	0	0	18	368	260	108
PCT9424	ED	210	171	0	0	16	155	120	35
PCT9424	TO	1009	557	0	0	34	523	380	143
PCT9425	MV	789	348	0	0	23	325	238	87
PCT9425	ED	187	183	0	0	14	169	128	41
PCT9425	TO	976	531	0	0	37	494	366	128
PCT9426	MV	697	326	0	0	21	305	216	89
PCT9426	ED	156	159	0	0	19	140	102	38
PCT9426	TO	853	485	0	0	40	445	318	127
PCT9427	MV	799	386	0	0	18	368	232	136
PCT9427	ED	188	171	0	0	24	147	113	34
PCT9427	TO	987	557	0	0	42	515	345	170
PCT9428	MV	811	353	0	0	25	328	242	86
PCT9428	ED	179	163	0	0	17	146	120	26
PCT9428	TO	990	516	0	0	42	474	362	112
PCT9429	MV	709	344	0	1	21	322	220	102
PCT9429	ED	197	175	0	0	18	157	118	39
PCT9429	TO	906	519	0	1	39	479	338	141
PCT9431	MV	832	413	0	0	35	378	247	131
PCT9431	ED	204	189	0	0	10	179	137	42
PCT9431	TO	1036	602	0	0	45	557	384	173
PCT9432	MV	743	361	0	0	31	330	245	85
PCT9432	ED	215	156	0	0	12	144	117	27
PCT9432	TO	958	517	0	0	43	474	362	112
PCT9433	MV	794	374	0	0	28	346	226	120
PCT9433	ED	164	137	0	0	5	132	94	38
PCT9433	TO	958	511	0	0	33	478	320	158
PCT9434	MV	785	387	0	0	27	360	268	92
PCT9434	ED	227	240	0	0	26	214	174	40
PCT9434	TO	1012	627	0	0	53	574	442	132
PCT9435	MV	779	366	0	0	15	351	246	105
PCT9435	ED	225	218	0	0	16	202	148	54
PCT9435	TO	1004	584	0	0	31	553	394	159
PCT9436	MV	842	387	0	0	15	372	264	108
PCT9436	ED	226	176	0	0	16	160	123	37
PCT9436	TO	1068	563	0	0	31	532	387	145
PCT9437	MV	736	376	0	0	20	356	243	113
PCT9437	ED	191	173	0	0	10	163	126	37
PCT9437	TO	927	549	0	0	30	519	369	150
PCT9438	MV	837	421	0	0	23	398	275	123
PCT9438	ED	152	129	0	0	10	119	89	30
PCT9438	TO	989	550	0	0	33	517	364	153
PCT9439	MV	718	344	0	0	19	325	234	91
PCT9439	ED	199	150	0	0	18	132	103	29
PCT9439	TO	917	494	0	0	37	457	337	120
PCT9441	MV	778	396	0	0	25	371	265	106
PCT9441	ED	193	188	0	0	18	170	141	29
PCT9441	TO	971	584	0	0	43	541	406	135
PCT9442	MV	830	382	0	0	34	348	227	121
PCT9442	ED	210	232	0	0	16	216	173	43
PCT9442	TO	1040	614	0	0	50	564	400	164
PCT9443	MV	760	363	0	1	18	344	263	81
PCT9443	ED	195	173	0	0	15	158	119	39
PCT9443	TO	955	536	0	1	33	502	382	120
PCT9444	MV	768	343	0	0	15	328	222	106
PCT9444	ED	197	154	0	0	13	141	114	27
PCT9444	TO	965	497	0	0	28	469	336	133
PCT9445	MV	830	407	0	0	26	381	278	103
PCT9445	ED	166	181	0	0	17	164	127	37
PCT9445	TO	996	588	0	0	43	545	405	140
PCT9446	MV	900	467	0	0	29	438	289	149
PCT9446	ED	216	185	0	0	17	168	134	34
PCT9446	TO	1116	652	0	0	46	606	423	183
PCT9447	MV	729	395	0	0	19	376	264	112
PCT9447	ED	192	203	0	0	20	183	154	29
PCT9447	TO	921	598	0	0	39	559	418	141
PCT9448	MV	742	347	0	0	18	329	226	103
PCT9448	ED	198	185	0	0	15	170	145	25
PCT9448	TO	940	532	0	0	33	499	371	128
PCT9449	MV	719	342	0	0	19	323	206	117
PCT9449	ED	162	129	0	0	9	120	89	31
PCT9449	TO	881	471	0	0	28	443	295	148
PCT9451	MV	353	178	0	0	7	171	111	60
PCT9451	ED	88	71	0	0	4	67	49	18
PCT9451	TO	441	249	0	0	11	238	160	78
PCT9452	MV	647	336	0	0	18	318	227	91
PCT9452	ED	195	199	0	0	15	184	134	50
PCT9452	TO	842	535	0	0	33	502	361	141
PCT9453	MV	409	220	0	0	10	210	140	70
PCT9453	ED	115	88	0	0	9	79	57	22
PCT9453	TO	524	308	0	0	19	289	197	92
PCT9501	MV	150	92	0	2	7	83	67	16
PCT9501	ED	0	5	0	0	2	3	2	1
PCT9501	TO	150	97	0	2	9	86	69	17
PCT9502	MV	251	136	0	0	9	127	110	17
PCT9502	ED	0	12	0	0	1	11	11	0
PCT9502	TO	251	148	0	0	10	138	121	17
PCT9503	MV	550	263	0	0	28	235	216	19
PCT9503	ED	150	139	0	0	17	122	113	9
PCT9503	TO	700	402	0	0	45	357	329	28
PCT9505	MV	589	296	0	0	25	271	234	37
PCT9505	ED	176	147	0	0	14	133	120	13
PCT9505	TO	765	443	0	0	39	404	354	50
PCT9506	MV	547	233	0	0	15	218	197	21
PCT9506	ED	207	147	0	0	12	135	121	14
PCT9506	TO	754	380	0	0	27	353	318	35
PCT9507	MV	556	306	0	0	21	285	259	26
PCT9507	ED	160	206	0	0	18	188	165	23
PCT9507	TO	716	512	0	0	39	473	424	49
PCT9508	MV	632	320	0	0	20	300	279	21
PCT9508	ED	148	212	0	0	29	183	169	14
PCT9508	TO	780	532	0	0	49	483	448	35
PCT9509	MV	585	297	0	0	22	275	248	27
PCT9509	ED	142	196	0	0	21	175	164	11
PCT9509	TO	727	493	0	0	43	450	412	38
PCT9511	MV	458	242	0	0	16	226	200	26
PCT9511	ED	176	179	0	0	17	162	138	24
PCT9511	TO	634	421	0	0	33	388	338	50
PCT9512	MV	617	328	0	1	18	309	274	35
PCT9512	ED	160	209	0	0	18	191	175	16
PCT9512	TO	777	537	0	1	36	500	449	51
PCT9513	MV	686	335	0	0	23	312	296	16
PCT9513	ED	191	202	0	0	15	187	170	17
PCT9513	TO	877	537	0	0	38	499	466	33
PCT9514	MV	713	353	0	0	31	322	288	34
PCT9514	ED	183	247	0	0	17	230	213	17
PCT9514	TO	896	600	0	0	48	552	501	51
PCT9515	MV	543	306	0	0	21	285	245	40
PCT9515	ED	169	192	0	0	22	170	148	22
PCT9515	TO	712	498	0	0	43	455	393	62
PCT9516	MV	705	367	0	0	23	344	299	45
PCT9516	ED	184	221	0	0	20	201	163	38
PCT9516	TO	889	588	0	0	43	545	462	83
PCT9517	MV	626	335	0	0	25	310	281	29
PCT9517	ED	162	200	0	0	21	179	158	21
PCT9517	TO	788	535	0	0	46	489	439	50
PCT9518	MV	642	319	0	0	26	293	268	25
PCT9518	ED	146	218	0	0	16	202	183	19
PCT9518	TO	788	537	0	0	42	495	451	44
PCT9519	MV	693	370	0	0	17	353	315	38
PCT9519	ED	198	260	0	0	33	227	201	26
PCT9519	TO	891	630	0	0	50	580	516	64
PCT9521	MV	687	352	0	0	25	327	293	34
PCT9521	ED	214	256	0	0	25	231	211	20
PCT9521	TO	901	608	0	0	50	558	504	54
PCT9701	MV	498	271	0	0	19	252	203	49
PCT9701	ED	156	163	0	0	6	157	141	16
PCT9701	TO	654	434	0	0	25	409	344	65
PCT9702	MV	554	309	0	0	14	295	248	47
PCT9702	ED	166	196	0	0	7	189	163	26
PCT9702	TO	720	505	0	0	21	484	411	73
PCT9703	MV	809	403	0	0	30	373	261	112
PCT9703	ED	182	200	0	0	14	186	149	37
PCT9703	TO	991	603	0	0	44	559	410	149
PCT9704	MV	760	426	0	0	31	395	310	85
PCT9704	ED	199	244	0	0	21	223	190	33
PCT9704	TO	959	670	0	0	52	618	500	118
PCT9705	MV	754	421	0	0	29	392	319	73
PCT9705	ED	175	203	0	0	15	188	168	20
PCT9705	TO	929	624	0	0	44	580	487	93
PCT9706	MV	49	35	0	0	1	34	34	0
PCT9706	ED	0	1	0	0	0	1	1	0
PCT9706	TO	49	36	0	0	1	35	35	0
PCT9707	MV	687	359	0	0	19	340	234	106
PCT9707	ED	139	146	0	0	14	132	102	30
PCT9707	TO	826	505	0	0	33	472	336	136
PCT9708	MV	786	432	0	0	41	391	317	74
PCT9708	ED	175	216	0	0	13	203	172	31
PCT9708	TO	961	648	0	0	54	594	489	105
PCT9709	MV	831	429	0	1	36	392	279	113
PCT9709	ED	209	230	0	0	12	218	166	52
PCT9709	TO	1040	659	0	1	48	610	445	165
PCT9711	MV	502	307	0	0	16	291	224	67
PCT9711	ED	144	168	0	0	12	156	113	43
PCT9711	TO	646	475	0	0	28	447	337	110
PCT9712	MV	534	337	0	0	23	314	231	83
PCT9712	ED	127	138	0	0	2	136	105	31
PCT9712	TO	661	475	0	0	25	450	336	114
PCT9713	MV	747	391	0	0	21	370	256	114
PCT9713	ED	203	182	0	0	13	169	120	49
PCT9713	TO	950	573	0	0	34	539	376	163
PCT9714	MV	795	447	0	0	31	416	292	124
PCT9714	ED	156	178	0	0	7	171	125	46
PCT9714	TO	951	625	0	0	38	587	417	170
PCT9715	MV	449	242	0	0	11	231	166	65
PCT9715	ED	130	157	0	0	7	150	116	34
PCT9715	TO	579	399	0	0	18	381	282	99
PCT9716	MV	745	401	0	0	21	380	285	95
PCT9716	ED	221	217	0	0	19	198	151	47
PCT9716	TO	966	618	0	0	40	578	436	142
PCT9717	MV	753	439	0	0	20	419	323	96
PCT9717	ED	224	194	0	0	15	179	134	45
PCT9717	TO	977	633	0	0	35	598	457	141
PCT9718	MV	749	451	0	0	24	427	336	91
PCT9718	ED	152	185	0	0	8	177	134	43
PCT9718	TO	901	636	0	0	32	604	470	134
PCT9719	MV	747	465	0	1	25	439	330	109
PCT9719	ED	173	191	0	0	13	178	138	40
PCT9719	TO	920	656	0	1	38	617	468	149
PCT9721	MV	498	291	0	0	18	273	203	70
PCT9721	ED	164	174	0	1	9	164	126	38
PCT9721	TO	662	465	0	1	27	437	329	108
PCT9722	MV	513	315	0	0	19	296	224	72
PCT9722	ED	84	101	0	0	11	90	73	17
PCT9722	TO	597	416	0	0	30	386	297	89
PCT9723	MV	436	225	0	0	9	216	113	103
PCT9723	ED	72	66	0	0	7	59	39	20
PCT9723	TO	508	291	0	0	16	275	152	123
PCT9724	MV	851	458	0	0	24	434	250	184
PCT9724	ED	169	145	0	1	10	134	93	41
PCT9724	TO	1020	603	0	1	34	568	343	225
PCT9725	MV	814	439	0	0	24	415	262	153
PCT9725	ED	157	166	0	0	14	152	99	53
PCT9725	TO	971	605	0	0	38	567	361	206
PCT9726	MV	630	218	0	0	18	200	170	30
PCT9726	ED	-14	280	0	0	24	256	240	16
PCT9726	TO	616	498	0	0	42	456	410	46
PCT9727	MV	404	227	0	2	12	213	151	62
PCT9727	ED	56	64	0	0	6	58	44	14
PCT9727	TO	460	291	0	2	18	271	195	76
PCT9728	MV	751	448	0	0	21	427	290	137
PCT9728	ED	212	184	0	0	10	174	121	53
PCT9728	TO	963	632	0	0	31	601	411	190
PCT9729	MV	654	338	0	0	19	319	216	103
PCT9729	ED	164	174	0	0	10	164	126	38
PCT9729	TO	818	512	0	0	29	483	342	141
PCT9731	MV	436	246	0	0	12	234	162	72
PCT9731	ED	143	145	0	0	8	137	106	31
PCT9731	TO	579	391	0	0	20	371	268	103
PCT9732	MV	73	47	0	0	5	42	29	13
PCT9732	ED	0	3	0	0	1	2	2	0
PCT9732	TO	73	50	0	0	6	44	31	13
PCT9733	MV	240	162	0	0	3	159	138	21
PCT9733	ED	0	12	0	0	3	9	9	0
PCT9733	TO	240	174	0	0	6	168	147	21
PCT9734	MV	473	290	0	0	16	274	199	75
PCT9734	ED	131	131	0	0	3	128	92	36
PCT9734	TO	604	421	0	0	19	402	291	111
PCT9735	MV	650	390	0	2	23	365	270	95
PCT9735	ED	170	187	0	0	29	158	125	33
PCT9735	TO	820	577	0	2	52	523	395	128
PCT9736	MV	586	329	0	0	19	310	232	78
PCT9736	ED	150	187	0	0	16	171	136	35
PCT9736	TO	736	516	0	0	35	481	368	113
PCT9737	MV	637	390	0	0	20	370	267	103
PCT9737	ED	154	164	0	0	10	154	131	23
PCT9737	TO	791	554	0	0	30	524	398	126
PCT9738	MV	688	320	0	0	23	297	244	53
PCT9738	ED	150	118	0	0	10	108	90	18
PCT9738	TO	838	438	0	0	33	405	334	71
PCT9739	MV	674	273	0	0	10	263	237	26
PCT9739	ED	115	249	0	0	20	229	217	12
PCT9739	TO	789	522	0	0	30	492	454	38
PCT9741	MV	843	174	0	0	15	159	150	9
PCT9741	ED	-402	454	0	0	58	396	364	32
PCT9741	TO	441	628	0	0	73	555	514	41
PCT9742	MV	530	229	0	0	6	223	148	75
PCT9742	ED	165	163	0	0	10	153	125	28
PCT9742	TO	695	392	0	0	16	376	273	103
PCT9743	MV	913	405	0	0	21	384	319	65
PCT9743	ED	227	261	0	0	24	237	204	33
PCT9743	TO	1140	666	0	0	45	621	523	98
PCT9744	MV	783	334	0	0	24	310	265	45
PCT9744	ED	160	262	0	0	41	221	193	28
PCT9744	TO	943	596	0	0	65	531	458	73
PCT9745	MV	791	321	0	0	22	299	267	32
PCT9745	ED	201	237	0	0	21	216	198	18
PCT9745	TO	992	558	0	0	43	515	465	50
PCT9746	MV	714	374	0	0	10	364	267	97
PCT9746	ED	189	154	0	0	9	145	116	29
PCT9746	TO	903	528	0	0	19	509	383	126
PCT9747	MV	772	401	0	0	18	383	280	103
PCT9747	ED	204	193	0	0	15	178	142	36
PCT9747	TO	976	594	0	0	33	561	422	139
PCT9748	MV	746	425	0	0	25	400	318	82
PCT9748	ED	167	164	0	0	10	154	118	36
PCT9748	TO	913	589	0	0	35	554	436	118
PCT9749	MV	750	289	0	0	11	278	218	60
PCT9749	ED	188	170	0	0	8	162	135	27
PCT9749	TO	938	459	0	0	19	440	353	87
PCT9751	MV	857	475	0	0	31	444	332	112
PCT9751	ED	214	205	0	0	25	180	146	34
PCT9751	TO	1071	680	0	0	56	624	478	146
PCT9752	MV	563	330	0	0	19	311	224	87
PCT9752	ED	134	156	0	0	11	145	113	32
PCT9752	TO	697	486	0	0	30	456	337	119
PCT9753	MV	617	300	0	0	13	287	230	57
PCT9753	ED	145	168	0	0	4	164	136	28
PCT9753	TO	762	468	0	0	17	451	366	85
PCT9754	MV	545	317	0	2	17	298	253	45
PCT9754	ED	162	149	0	0	12	137	117	20
PCT9754	TO	707	466	0	2	29	435	370	65
PCT9755	MV	441	240	0	0	16	224	176	48
PCT9755	ED	139	134	0	0	6	128	102	26
PCT9755	TO	580	374	0	0	22	352	278	74
PCT9756	MV	805	365	0	0	27	338	221	117
PCT9756	ED	162	153	0	0	11	142	113	29
PCT9756	TO	967	518	0	0	38	480	334	146
PCT9801	MV	320	163	0	0	12	151	119	32
PCT9801	ED	88	68	0	0	7	61	52	9
PCT9801	TO	408	231	0	0	19	212	171	41
PCT9900	MV	0	0	0	0	0	0	0	0
PCT9900	ED	0	0	0	0	0	0	0	0
PCT9900	TO	0	0	0	0	0	0	0	0
PCT9901	MV	0	0	0	0	0	0	0	0
PCT9901	ED	0	0	0	0	0	0	0	0
PCT9901	TO	0	0	0	0	0	0	0	0
PCT9902	MV	0	0	0	0	0	0	0	0
PCT9902	ED	0	0	0	0	0	0	0	0
PCT9902	TO	0	0	0	0	0	0	0	0
CONG12	MV	355626	175466	0	31	11841	163594	134998	28596
CONG12	ED	90222	96086	0	16	8922	87148	74811	12337
CONG12	TO	445848	271552	0	47	20763	250742	209809	40933
CONG14	MV	47259	22470	0	9	1209	21252	15643	5609
CONG14	ED	10792	10918	0	3	866	10049	8204	1845
CONG14	TO	58051	33388	0	12	2075	31301	23847	7454
ASSM17	MV	232813	115072	0	20	7740	107312	90650	16662
ASSM17	ED	59609	61731	0	15	5748	55968	48857	7111
ASSM17	TO	292422	176803	0	35	13488	163280	139507	23773
ASSM19	MV	170072	82864	0	20	5310	77534	59991	17543
ASSM19	ED	41405	45273	0	4	4040	41229	34158	7071
ASSM19	TO	211477	128137	0	24	9350	118763	94149	24614
SUPV1	MV	33870	16647	0	0	1031	15616	12487	3129
SUPV1	ED	9246	10132	0	1	857	9274	7847	1427
SUPV1	TO	43116	26779	0	1	1888	24890	20334	4556
SUPV2	MV	41438	20055	0	4	1640	18411	14985	3426
SUPV2	ED	8608	11685	0	0	1324	10361	8637	1724
SUPV2	TO	50046	31740	0	4	2964	28772	23622	5150
SUPV3	MV	31945	14475	0	3	1103	13369	11066	2303
SUPV3	ED	7432	7841	0	2	841	6998	6095	903
SUPV3	TO	39377	22316	0	5	1944	20367	17161	3206
SUPV4	MV	35051	16949	0	3	1009	15937	11581	4356
SUPV4	ED	9043	8532	0	0	687	7845	6281	1564
SUPV4	TO	44094	25481	0	3	1696	23782	17862	5920
SUPV5	MV	41974	21590	0	6	1540	20044	17914	2130
SUPV5	ED	10926	13129	0	3	1262	11864	10692	1172
SUPV5	TO	52900	34719	0	9	2802	31908	28606	3302
SUPV6	MV	35759	15272	0	7	1103	14162	12160	2002
SUPV6	ED	7936	7226	0	4	846	6376	5577	799
SUPV6	TO	43695	22498	0	11	1949	20538	17737	2801
SUPV7	MV	38895	20838	0	8	1215	19615	14887	4728
SUPV7	ED	8548	10570	0	2	803	9765	7921	1844
SUPV7	TO	47443	31408	0	10	2018	29380	22808	6572
SUPV8	MV	46374	27613	0	3	1804	25806	22422	3384
SUPV8	ED	11803	15032	0	3	1241	13788	12072	1716
SUPV8	TO	58177	42645	0	6	3045	39594	34494	5100
SUPV9	MV	33168	16847	0	1	988	15858	13395	2463
SUPV9	ED	10095	10044	0	2	807	9235	8148	1087
SUPV9	TO	43263	26891	0	3	1795	25093	21543	3550
SUPV10	MV	33768	14158	0	2	911	13245	10471	2774
SUPV10	ED	9345	6711	0	1	632	6078	5154	924
SUPV10	TO	43113	20869	0	3	1543	19323	15625	3698
SUPV11	MV	30643	13492	0	3	706	12783	9273	3510
SUPV11	ED	8032	6102	0	1	488	5613	4591	1022
SUPV11	TO	38675	19594	0	4	1194	18396	13864	4532
NEIG1	MV	15466	5992	0	2	398	5592	4308	1284
NEIG1	ED	5019	2611	0	0	229	2382	1995	387
NEIG1	TO	20485	8603	0	2	627	7974	6303	1671
NEIG2	MV	14029	6299	0	0	528	5771	4699	1072
NEIG2	ED	3238	3340	0	1	384	2955	2543	412
NEIG2	TO	17267	9639	0	1	912	8726	7242	1484
NEIG3	MV	22051	9529	0	4	710	8815	7646	1169
NEIG3	ED	5968	4993	0	5	517	4471	3954	517
NEIG3	TO	28019	14522	0	9	1227	13286	11600	1686
NEIG4	MV	5630	3506	0	0	208	3298	2726	572
NEIG4	ED	1430	1651	0	1	144	1506	1234	272
NEIG4	TO	7060	5157	0	1	352	4804	3960	844
NEIG5	MV	22699	10158	0	1	554	9603	6949	2654
NEIG5	ED	5894	4404	0	0	348	4056	3286	770
NEIG5	TO	28593	14562	0	1	902	13659	10235	3424
NEIG6	MV	11529	5997	0	1	413	5583	5033	550
NEIG6	ED	2333	3919	0	1	361	3557	3230	327
NEIG6	TO	13862	9916	0	2	774	9140	8263	877
NEIG7	MV	9819	4151	0	2	202	3947	2882	1065
NEIG7	ED	2576	2089	0	1	166	1922	1605	317
NEIG7	TO	12395	6240	0	3	368	5869	4487	1382
NEIG8	MV	7629	4046	0	1	278	3767	3312	455
NEIG8	ED	2029	2570	0	0	223	2347	2091	256
NEIG8	TO	9658	6616	0	1	501	6114	5403	711
NEIG9	MV	7423	3167	0	0	190	2977	2277	700
NEIG9	ED	835	2238	0	1	229	2008	1737	271
NEIG9	TO	8258	5405	0	1	419	4985	4014	971
NEIG10	MV	8173	3965	0	0	277	3688	3104	584
NEIG10	ED	1849	2658	0	0	237	2421	2097	324
NEIG10	TO	10022	6623	0	0	514	6109	5201	908
NEIG11	MV	33512	15583	0	1	1324	14258	11634	2624
NEIG11	ED	5928	9051	0	0	1080	7971	6622	1349
NEIG11	TO	39440	24634	0	1	2404	22229	18256	3973
NEIG12	MV	23578	11896	0	2	692	11202	10014	1188
NEIG12	ED	7427	7902	0	1	688	7213	6562	651
NEIG12	TO	31005	19798	0	3	1380	18415	16576	1839
NEIG14	MV	6791	4015	0	0	263	3752	3306	446
NEIG14	ED	1942	2316	0	1	174	2141	1895	246
NEIG14	TO	8733	6331	0	1	437	5893	5201	692
NEIG15	MV	5781	2688	0	0	164	2524	2018	506
NEIG15	ED	1307	1499	0	0	148	1351	1167	184
NEIG15	TO	7088	4187	0	0	312	3875	3185	690
NEIG13	MV	13553	8198	0	0	557	7641	6565	1076
NEIG13	ED	3435	4443	0	0	349	4094	3559	535
NEIG13	TO	16988	12641	0	0	906	11735	10124	1611
NEIG26	MV	7830	3542	0	0	205	3337	2266	1071
NEIG26	ED	1802	1386	0	0	108	1278	986	292
NEIG26	TO	9632	4928	0	0	313	4615	3252	1363
NEIG16	MV	14624	6991	0	1	495	6495	5573	922
NEIG16	ED	2732	3781	0	1	418	3362	2943	419
NEIG16	TO	17356	10772	0	2	913	9857	8516	1341
NEIG17	MV	29449	14470	0	0	906	13564	10803	2761
NEIG17	ED	8176	8551	0	1	720	7830	6597	1233
NEIG17	TO	37625	23021	0	1	1626	21394	17400	3994
NEIG19	MV	7164	4040	0	0	239	3801	3279	522
NEIG19	ED	2407	2408	0	0	185	2223	1919	304
NEIG19	TO	9571	6448	0	0	424	6024	5198	826
NEIG18	MV	6458	3427	0	3	234	3190	2501	689
NEIG18	ED	1563	2033	0	0	194	1839	1535	304
NEIG18	TO	8021	5460	0	3	428	5029	4036	993
NEIG20	MV	20913	8936	0	5	630	8301	7076	1225
NEIG20	ED	4164	4219	0	0	498	3721	3231	490
NEIG20	TO	25077	13155	0	5	1128	12022	10307	1715
NEIG21	MV	34608	16722	0	3	990	15729	11402	4327
NEIG21	ED	8885	8360	0	0	676	7684	6136	1548
NEIG21	TO	43493	25082	0	3	1666	23413	17538	5875
NEIG22	MV	15383	9330	0	2	617	8711	7650	1061
NEIG22	ED	3510	4904	0	2	387	4515	3994	521
NEIG22	TO	18893	14234	0	4	1004	13226	11644	1582
NEIG23	MV	6638	2527	0	0	138	2389	1641	748
NEIG23	ED	1850	947	0	0	90	857	686	171
NEIG23	TO	8488	3474	0	0	228	3246	2327	919
NEIG24	MV	28440	16178	0	8	943	15227	11517	3710
NEIG24	ED	6934	7515	0	1	529	6985	5528	1457
NEIG24	TO	35374	23693	0	9	1472	22212	17045	5167
NEIG25	MV	23715	12583	0	4	895	11684	10460	1224
NEIG25	ED	7781	7216	0	2	706	6508	5883	625
NEIG25	TO	31496	19799	0	6	1601	18192	16343	1849
