area_id	subtotal_type	RSReg	RSCst	RSRej	RSOvr	RSUnd	RSTot	3:YES	4:NO
ALLPCTS	TO	503899	281773	0	50	21114	260609	187029	73580
ALLPCTS	ED	101053	84584	0	11	6853	77720	59349	18371
ALLPCTS	MV	402846	197189	0	39	14261	182889	127680	55209
PCT1101	MV	448	215	0	0	15	200	128	72
PCT1101	ED	114	61	0	0	3	58	46	12
PCT1101	TO	562	276	0	0	18	258	174	84
PCT1102	MV	774	369	0	0	19	350	229	121
PCT1102	ED	230	162	0	0	11	151	109	42
PCT1102	TO	1004	531	0	0	30	501	338	163
PCT1103	MV	749	371	0	0	19	352	238	114
PCT1103	ED	222	144	0	0	6	138	105	33
PCT1103	TO	971	515	0	0	25	490	343	147
PCT1104	MV	751	343	0	0	13	330	237	93
PCT1104	ED	267	122	0	0	6	116	85	31
PCT1104	TO	1018	465	0	0	19	446	322	124
PCT1106	MV	598	255	0	0	12	243	134	109
PCT1106	ED	173	97	0	0	5	92	68	24
PCT1106	TO	771	352	0	0	17	335	202	133
PCT1107	MV	612	287	0	0	17	270	171	99
PCT1107	ED	139	76	0	0	5	71	53	18
PCT1107	TO	751	363	0	0	22	341	224	117
PCT1108	MV	725	360	0	0	21	339	234	105
PCT1108	ED	198	116	0	0	12	104	73	31
PCT1108	TO	923	476	0	0	33	443	307	136
PCT1109	MV	653	284	0	0	14	270	158	112
PCT1109	ED	169	99	0	0	4	95	73	22
PCT1109	TO	822	383	0	0	18	365	231	134
PCT1111	MV	849	354	0	0	18	336	201	135
PCT1111	ED	197	118	0	0	4	114	91	23
PCT1111	TO	1046	472	0	0	22	450	292	158
PCT1112	MV	643	278	0	0	15	263	178	85
PCT1112	ED	159	79	0	0	4	75	60	15
PCT1112	TO	802	357	0	0	19	338	238	100
PCT1113	MV	675	286	0	0	13	273	174	99
PCT1113	ED	120	65	0	0	6	59	44	15
PCT1113	TO	795	351	0	0	19	332	218	114
PCT1114	MV	769	328	0	0	22	306	224	82
PCT1114	ED	222	98	0	0	10	88	73	15
PCT1114	TO	991	426	0	0	32	394	297	97
PCT1115	MV	743	295	0	0	15	280	177	103
PCT1115	ED	193	89	0	0	3	86	71	15
PCT1115	TO	936	384	0	0	18	366	248	118
PCT1116	MV	715	308	0	0	17	291	185	106
PCT1116	ED	216	119	0	0	6	113	96	17
PCT1116	TO	931	427	0	0	23	404	281	123
PCT1117	MV	665	258	0	0	14	244	164	80
PCT1117	ED	181	72	0	0	3	69	53	16
PCT1117	TO	846	330	0	0	17	313	217	96
PCT1118	MV	846	357	0	1	11	345	219	126
PCT1118	ED	219	106	0	0	10	96	68	28
PCT1118	TO	1065	463	0	1	21	441	287	154
PCT1119	MV	659	303	0	0	11	292	203	89
PCT1119	ED	138	75	0	0	5	70	59	11
PCT1119	TO	797	378	0	0	16	362	262	100
PCT1121	MV	556	268	0	0	21	247	139	108
PCT1121	ED	149	87	0	0	6	81	53	28
PCT1121	TO	705	355	0	0	27	328	192	136
PCT1122	MV	519	245	0	0	18	227	117	110
PCT1122	ED	118	71	0	0	4	67	51	16
PCT1122	TO	637	316	0	0	22	294	168	126
PCT1123	MV	730	257	0	1	10	246	169	77
PCT1123	ED	208	89	0	0	6	83	66	17
PCT1123	TO	938	346	0	1	16	329	235	94
PCT1124	MV	630	246	0	2	7	237	146	91
PCT1124	ED	199	76	0	0	3	73	61	12
PCT1124	TO	829	322	0	2	10	310	207	103
PCT1125	MV	919	364	0	1	27	336	193	143
PCT1125	ED	178	68	0	0	7	61	50	11
PCT1125	TO	1097	432	0	1	34	397	243	154
PCT1126	MV	812	308	0	0	15	293	210	83
PCT1126	ED	200	68	0	0	3	65	49	16
PCT1126	TO	1012	376	0	0	18	358	259	99
PCT1127	MV	743	293	0	0	10	283	153	130
PCT1127	ED	222	101	0	0	3	98	70	28
PCT1127	TO	965	394	0	0	13	381	223	158
PCT1128	MV	734	287	0	0	12	275	153	122
PCT1128	ED	145	59	0	0	4	55	41	14
PCT1128	TO	879	346	0	0	16	330	194	136
PCT1129	MV	790	314	0	0	21	293	173	120
PCT1129	ED	246	109	0	0	13	96	69	27
PCT1129	TO	1036	423	0	0	34	389	242	147
PCT1131	MV	694	280	0	0	25	255	142	113
PCT1131	ED	166	61	0	0	4	57	46	11
PCT1131	TO	860	341	0	0	29	312	188	124
PCT1132	MV	839	370	0	0	27	343	214	129
PCT1132	ED	193	60	0	0	0	60	30	30
PCT1132	TO	1032	430	0	0	27	403	244	159
PCT1133	MV	716	334	0	0	9	325	208	117
PCT1133	ED	159	74	0	0	3	71	48	23
PCT1133	TO	875	408	0	0	12	396	256	140
PCT1134	MV	585	293	0	0	9	284	153	131
PCT1134	ED	182	80	0	0	8	72	61	11
PCT1134	TO	767	373	0	0	17	356	214	142
PCT1135	MV	465	218	0	0	6	212	129	83
PCT1135	ED	91	51	0	0	1	50	33	17
PCT1135	TO	556	269	0	0	7	262	162	100
PCT1136	MV	710	340	0	0	15	325	199	126
PCT1136	ED	157	79	0	0	9	70	53	17
PCT1136	TO	867	419	0	0	24	395	252	143
PCT1141	MV	836	393	0	0	21	372	238	134
PCT1141	ED	220	124	0	0	3	121	88	33
PCT1141	TO	1056	517	0	0	24	493	326	167
PCT1142	MV	721	324	0	0	27	297	201	96
PCT1142	ED	175	87	0	0	3	84	72	12
PCT1142	TO	896	411	0	0	30	381	273	108
PCT1143	MV	824	360	0	0	26	334	226	108
PCT1143	ED	225	116	0	0	6	110	91	19
PCT1143	TO	1049	476	0	0	32	444	317	127
PCT1144	MV	727	326	0	0	12	314	201	113
PCT1144	ED	220	121	0	0	10	111	80	31
PCT1144	TO	947	447	0	0	22	425	281	144
PCT1145	MV	753	411	0	0	25	386	251	135
PCT1145	ED	152	114	0	0	5	109	79	30
PCT1145	TO	905	525	0	0	30	495	330	165
PCT1146	MV	839	364	0	0	17	347	243	104
PCT1146	ED	215	110	0	0	6	104	80	24
PCT1146	TO	1054	474	0	0	23	451	323	128
PCT1147	MV	673	309	0	0	13	296	198	98
PCT1147	ED	212	108	0	0	5	103	77	26
PCT1147	TO	885	417	0	0	18	399	275	124
PCT1148	MV	804	368	0	0	18	350	211	139
PCT1148	ED	224	119	0	0	6	113	83	30
PCT1148	TO	1028	487	0	0	24	463	294	169
PCT1149	MV	710	319	0	0	23	296	191	105
PCT1149	ED	229	119	0	0	9	110	80	30
PCT1149	TO	939	438	0	0	32	406	271	135
PCT1152	MV	710	313	0	0	19	294	209	85
PCT1152	ED	180	87	0	0	6	81	60	21
PCT1152	TO	890	400	0	0	25	375	269	106
PCT1153	MV	730	285	0	0	18	267	185	82
PCT1153	ED	210	117	0	0	7	110	64	46
PCT1153	TO	940	402	0	0	25	377	249	128
PCT7001	MV	632	329	0	0	21	308	230	78
PCT7001	ED	141	105	0	0	7	98	84	14
PCT7001	TO	773	434	0	0	28	406	314	92
PCT7002	MV	598	267	0	1	23	243	177	66
PCT7002	ED	116	90	0	0	5	85	69	16
PCT7002	TO	714	357	0	1	28	328	246	82
PCT7003	MV	759	432	0	0	29	403	300	103
PCT7003	ED	147	144	0	0	12	132	99	33
PCT7003	TO	906	576	0	0	41	535	399	136
PCT7004	MV	764	416	0	0	30	386	288	98
PCT7004	ED	149	146	0	0	13	133	106	27
PCT7004	TO	913	562	0	0	43	519	394	125
PCT7005	MV	698	350	0	0	26	324	252	72
PCT7005	ED	161	163	0	0	20	143	117	26
PCT7005	TO	859	513	0	0	46	467	369	98
PCT7006	MV	729	360	0	0	27	333	259	74
PCT7006	ED	203	153	0	0	8	145	115	30
PCT7006	TO	932	513	0	0	35	478	374	104
PCT7007	MV	777	437	0	0	36	401	285	116
PCT7007	ED	180	174	0	0	15	159	130	29
PCT7007	TO	957	611	0	0	51	560	415	145
PCT7008	MV	732	367	0	0	42	325	235	90
PCT7008	ED	177	194	0	0	12	182	140	42
PCT7008	TO	909	561	0	0	54	507	375	132
PCT7009	MV	752	390	0	0	23	367	267	100
PCT7009	ED	119	95	0	0	5	90	59	31
PCT7009	TO	871	485	0	0	28	457	326	131
PCT7011	MV	704	231	0	0	16	215	160	55
PCT7011	ED	269	88	0	0	5	83	67	16
PCT7011	TO	973	319	0	0	21	298	227	71
PCT7012	MV	999	487	0	0	35	452	339	113
PCT7012	ED	227	209	0	0	17	192	155	37
PCT7012	TO	1226	696	0	0	52	644	494	150
PCT7013	MV	984	427	0	0	33	394	307	87
PCT7013	ED	155	157	0	0	16	141	119	22
PCT7013	TO	1139	584	0	0	49	535	426	109
PCT7014	MV	610	303	0	0	30	273	215	58
PCT7014	ED	109	115	0	0	17	98	82	16
PCT7014	TO	719	418	0	0	47	371	297	74
PCT7015	MV	128	40	0	0	4	36	32	4
PCT7015	ED	-18	0	0	0	0	0	0	0
PCT7015	TO	110	40	0	0	4	36	32	4
PCT7016	MV	655	239	0	0	16	223	147	76
PCT7016	ED	277	79	0	0	7	72	58	14
PCT7016	TO	932	318	0	0	23	295	205	90
PCT7017	MV	543	180	0	0	15	165	128	37
PCT7017	ED	238	53	0	0	6	47	42	5
PCT7017	TO	781	233	0	0	21	212	170	42
PCT7018	MV	847	357	0	0	23	334	207	127
PCT7018	ED	200	56	0	0	4	52	47	5
PCT7018	TO	1047	413	0	0	27	386	254	132
PCT7019	MV	734	355	0	0	23	332	212	120
PCT7019	ED	166	74	0	0	8	66	55	11
PCT7019	TO	900	429	0	0	31	398	267	131
PCT7021	MV	679	271	0	0	15	256	198	58
PCT7021	ED	288	108	0	0	7	101	88	13
PCT7021	TO	967	379	0	0	22	357	286	71
PCT7022	MV	770	312	0	1	22	289	224	65
PCT7022	ED	193	55	0	0	1	54	45	9
PCT7022	TO	963	367	0	1	23	343	269	74
PCT7023	MV	687	331	0	0	18	313	235	78
PCT7023	ED	233	72	0	0	6	66	54	12
PCT7023	TO	920	403	0	0	24	379	289	90
PCT7024	MV	251	50	0	0	2	48	43	5
PCT7024	ED	190	20	0	0	3	17	17	0
PCT7024	TO	441	70	0	0	5	65	60	5
PCT7025	MV	316	95	0	0	4	91	76	15
PCT7025	ED	167	39	0	0	1	38	32	6
PCT7025	TO	483	134	0	0	5	129	108	21
PCT7026	MV	819	336	0	0	14	322	169	153
PCT7026	ED	191	72	0	0	3	69	54	15
PCT7026	TO	1010	408	0	0	17	391	223	168
PCT7027	MV	677	270	0	0	14	256	163	93
PCT7027	ED	219	99	0	0	4	95	76	19
PCT7027	TO	896	369	0	0	18	351	239	112
PCT7028	MV	585	220	0	0	17	203	157	46
PCT7028	ED	271	100	0	0	5	95	78	17
PCT7028	TO	856	320	0	0	22	298	235	63
PCT7029	MV	642	209	0	0	15	194	150	44
PCT7029	ED	267	40	0	0	1	39	32	7
PCT7029	TO	909	249	0	0	16	233	182	51
PCT7030	MV	654	274	0	0	11	263	146	117
PCT7030	ED	141	59	0	0	3	56	31	25
PCT7030	TO	795	333	0	0	14	319	177	142
PCT7031	MV	622	263	0	0	24	239	155	84
PCT7031	ED	72	49	0	0	4	45	33	12
PCT7031	TO	694	312	0	0	28	284	188	96
PCT7032	MV	643	266	0	0	18	248	176	72
PCT7032	ED	238	54	0	0	3	51	42	9
PCT7032	TO	881	320	0	0	21	299	218	81
PCT7033	MV	549	214	0	0	17	197	138	59
PCT7033	ED	229	86	0	0	5	81	63	18
PCT7033	TO	778	300	0	0	22	278	201	77
PCT7034	MV	620	142	0	0	15	127	113	14
PCT7034	ED	318	60	0	0	3	57	50	7
PCT7034	TO	938	202	0	0	18	184	163	21
PCT7035	MV	567	237	0	0	20	217	151	66
PCT7035	ED	152	54	0	0	5	49	40	9
PCT7035	TO	719	291	0	0	25	266	191	75
PCT7036	MV	781	263	0	0	16	247	161	86
PCT7036	ED	193	39	0	0	1	38	28	10
PCT7036	TO	974	302	0	0	17	285	189	96
PCT7037	MV	434	63	0	0	0	63	50	13
PCT7037	ED	312	38	0	0	5	33	32	1
PCT7037	TO	746	101	0	0	5	96	82	14
PCT7038	MV	758	308	0	0	16	292	175	117
PCT7038	ED	203	60	0	0	8	52	40	12
PCT7038	TO	961	368	0	0	24	344	215	129
PCT7039	MV	636	243	0	0	16	227	127	100
PCT7039	ED	201	104	0	0	5	99	63	36
PCT7039	TO	837	347	0	0	21	326	190	136
PCT7041	MV	70	29	0	0	3	26	16	10
PCT7041	ED	-4	0	0	0	0	0	0	0
PCT7041	TO	66	29	0	0	3	26	16	10
PCT7042	MV	514	222	0	0	11	211	144	67
PCT7042	ED	146	62	0	0	2	60	44	16
PCT7042	TO	660	284	0	0	13	271	188	83
PCT7043	MV	754	295	0	0	22	273	178	95
PCT7043	ED	224	79	0	0	1	78	54	24
PCT7043	TO	978	374	0	0	23	351	232	119
PCT7044	MV	586	149	0	0	4	145	106	39
PCT7044	ED	266	36	0	0	2	34	27	7
PCT7044	TO	852	185	0	0	6	179	133	46
PCT7045	MV	632	267	0	0	16	251	147	104
PCT7045	ED	154	53	0	0	3	50	36	14
PCT7045	TO	786	320	0	0	19	301	183	118
PCT7046	MV	334	132	0	0	9	123	74	49
PCT7046	ED	96	48	0	0	3	45	34	11
PCT7046	TO	430	180	0	0	12	168	108	60
PCT7047	MV	733	315	0	0	12	303	178	125
PCT7047	ED	150	62	0	0	3	59	46	13
PCT7047	TO	883	377	0	0	15	362	224	138
PCT7048	MV	685	267	0	0	15	252	177	75
PCT7048	ED	196	59	0	0	4	55	43	12
PCT7048	TO	881	326	0	0	19	307	220	87
PCT7049	MV	616	247	0	0	14	233	132	101
PCT7049	ED	210	71	0	0	10	61	40	21
PCT7049	TO	826	318	0	0	24	294	172	122
PCT7051	MV	715	306	0	0	22	284	154	130
PCT7051	ED	165	70	0	0	6	64	45	19
PCT7051	TO	880	376	0	0	28	348	199	149
PCT7052	MV	722	296	0	0	12	284	155	129
PCT7052	ED	184	88	0	0	4	84	67	17
PCT7052	TO	906	384	0	0	16	368	222	146
PCT7053	MV	542	227	0	0	31	196	101	95
PCT7053	ED	43	42	0	0	4	38	29	9
PCT7053	TO	585	269	0	0	35	234	130	104
PCT7054	MV	863	310	0	0	21	289	220	69
PCT7054	ED	273	109	0	0	3	106	75	31
PCT7054	TO	1136	419	0	0	24	395	295	100
PCT7055	MV	732	292	0	0	21	271	182	89
PCT7055	ED	94	78	0	0	8	70	53	17
PCT7055	TO	826	370	0	0	29	341	235	106
PCT7056	MV	618	275	0	0	23	252	182	70
PCT7056	ED	87	122	0	0	14	108	84	24
PCT7056	TO	705	397	0	0	37	360	266	94
PCT7101	MV	162	99	0	0	6	93	84	9
PCT7101	ED	-15	4	0	0	1	3	3	0
PCT7101	TO	147	103	0	0	7	96	87	9
PCT7201	MV	788	383	0	0	32	351	225	126
PCT7201	ED	147	170	0	0	23	147	111	36
PCT7201	TO	935	553	0	0	55	498	336	162
PCT7202	MV	708	308	0	0	30	278	181	97
PCT7202	ED	143	158	0	0	17	141	104	37
PCT7202	TO	851	466	0	0	47	419	285	134
PCT7203	MV	693	321	0	0	37	284	185	99
PCT7203	ED	186	187	0	0	22	165	116	49
PCT7203	TO	879	508	0	0	59	449	301	148
PCT7204	MV	773	422	0	0	48	374	264	110
PCT7204	ED	126	157	0	0	28	129	90	39
PCT7204	TO	899	579	0	0	76	503	354	149
PCT7205	MV	724	360	0	1	26	333	224	109
PCT7205	ED	147	177	0	0	17	160	115	45
PCT7205	TO	871	537	0	1	43	493	339	154
PCT7206	MV	299	129	0	0	8	121	83	38
PCT7206	ED	78	106	0	0	12	94	65	29
PCT7206	TO	377	235	0	0	20	215	148	67
PCT7207	MV	744	333	0	0	28	305	197	108
PCT7207	ED	123	154	0	0	14	140	106	34
PCT7207	TO	867	487	0	0	42	445	303	142
PCT7208	MV	492	253	0	0	28	225	155	70
PCT7208	ED	78	97	0	0	12	85	76	9
PCT7208	TO	570	350	0	0	40	310	231	79
PCT7209	MV	595	341	0	0	27	314	218	96
PCT7209	ED	52	75	0	0	7	68	54	14
PCT7209	TO	647	416	0	0	34	382	272	110
PCT7301	MV	813	319	0	0	21	298	209	89
PCT7301	ED	201	143	0	0	13	130	94	36
PCT7301	TO	1014	462	0	0	34	428	303	125
PCT7302	MV	713	352	0	0	28	324	219	105
PCT7302	ED	136	140	0	0	13	127	92	35
PCT7302	TO	849	492	0	0	41	451	311	140
PCT7303	MV	869	376	0	0	24	352	240	112
PCT7303	ED	199	172	0	0	17	155	125	30
PCT7303	TO	1068	548	0	0	41	507	365	142
PCT7304	MV	802	366	0	0	29	337	223	114
PCT7304	ED	199	185	0	0	14	171	130	41
PCT7304	TO	1001	551	0	0	43	508	353	155
PCT7305	MV	713	386	0	0	28	358	216	142
PCT7305	ED	154	155	0	0	10	145	105	40
PCT7305	TO	867	541	0	0	38	503	321	182
PCT7306	MV	801	374	0	0	47	327	197	130
PCT7306	ED	243	194	0	0	25	169	129	40
PCT7306	TO	1044	568	0	0	72	496	326	170
PCT7307	MV	605	272	0	0	15	257	172	85
PCT7307	ED	169	130	0	1	17	112	88	24
PCT7307	TO	774	402	0	1	32	369	260	109
PCT7308	MV	520	257	0	0	12	245	166	79
PCT7308	ED	105	158	0	1	12	145	113	32
PCT7308	TO	625	415	0	1	24	390	279	111
PCT7309	MV	691	324	0	0	33	291	200	91
PCT7309	ED	167	191	0	0	15	176	136	40
PCT7309	TO	858	515	0	0	48	467	336	131
PCT7311	MV	698	333	0	0	28	305	217	88
PCT7311	ED	208	218	0	0	21	197	152	45
PCT7311	TO	906	551	0	0	49	502	369	133
PCT7312	MV	700	395	0	0	30	365	234	131
PCT7312	ED	110	162	0	0	18	144	100	44
PCT7312	TO	810	557	0	0	48	509	334	175
PCT7313	MV	819	373	0	0	24	349	228	121
PCT7313	ED	184	163	0	0	24	139	101	38
PCT7313	TO	1003	536	0	0	48	488	329	159
PCT7314	MV	612	226	0	0	25	201	139	62
PCT7314	ED	147	85	0	0	11	74	59	15
PCT7314	TO	759	311	0	0	36	275	198	77
PCT7315	MV	570	206	0	0	14	192	129	63
PCT7315	ED	195	135	0	0	8	127	100	27
PCT7315	TO	765	341	0	0	22	319	229	90
PCT7316	MV	654	261	0	0	29	232	159	73
PCT7316	ED	178	131	0	0	18	113	89	24
PCT7316	TO	832	392	0	0	47	345	248	97
PCT7317	MV	744	350	0	1	23	326	211	115
PCT7317	ED	146	114	0	0	16	98	83	15
PCT7317	TO	890	464	0	1	39	424	294	130
PCT7318	MV	605	293	0	0	35	258	170	88
PCT7318	ED	118	108	0	0	19	89	55	34
PCT7318	TO	723	401	0	0	54	347	225	122
PCT7319	MV	861	345	0	0	25	320	216	104
PCT7319	ED	188	185	0	1	26	158	112	46
PCT7319	TO	1049	530	0	1	51	478	328	150
PCT7321	MV	557	202	0	0	19	183	113	70
PCT7321	ED	102	85	0	0	9	76	58	18
PCT7321	TO	659	287	0	0	28	259	171	88
PCT7322	MV	742	294	0	0	34	260	181	79
PCT7322	ED	146	50	0	0	8	42	38	4
PCT7322	TO	888	344	0	0	42	302	219	83
PCT7323	MV	790	368	0	0	43	325	221	104
PCT7323	ED	166	160	0	0	19	141	110	31
PCT7323	TO	956	528	0	0	62	466	331	135
PCT7324	MV	587	260	0	0	29	231	157	74
PCT7324	ED	150	89	0	0	10	79	50	29
PCT7324	TO	737	349	0	0	39	310	207	103
PCT7325	MV	714	327	0	0	36	291	200	91
PCT7325	ED	172	124	0	0	11	113	82	31
PCT7325	TO	886	451	0	0	47	404	282	122
PCT7326	MV	685	304	0	0	28	276	190	86
PCT7326	ED	174	159	0	1	27	131	95	36
PCT7326	TO	859	463	0	1	55	407	285	122
PCT7327	MV	561	230	0	0	27	203	132	71
PCT7327	ED	126	49	0	0	2	47	39	8
PCT7327	TO	687	279	0	0	29	250	171	79
PCT7328	MV	829	333	0	0	54	279	180	99
PCT7328	ED	173	67	0	0	12	55	43	12
PCT7328	TO	1002	400	0	0	66	334	223	111
PCT7329	MV	556	227	0	0	24	203	141	62
PCT7329	ED	95	78	0	0	6	72	53	19
PCT7329	TO	651	305	0	0	30	275	194	81
PCT7331	MV	710	361	0	0	34	327	223	104
PCT7331	ED	160	162	0	0	21	141	102	39
PCT7331	TO	870	523	0	0	55	468	325	143
PCT7332	MV	654	264	0	0	22	242	184	58
PCT7332	ED	136	149	0	0	11	138	116	22
PCT7332	TO	790	413	0	0	33	380	300	80
PCT7333	MV	822	390	0	0	39	351	245	106
PCT7333	ED	193	224	0	0	19	205	159	46
PCT7333	TO	1015	614	0	0	58	556	404	152
PCT7334	MV	688	307	0	0	18	289	224	65
PCT7334	ED	131	135	0	0	11	124	101	23
PCT7334	TO	819	442	0	0	29	413	325	88
PCT7335	MV	788	389	0	0	39	350	226	124
PCT7335	ED	146	191	0	0	18	173	139	34
PCT7335	TO	934	580	0	0	57	523	365	158
PCT7336	MV	779	405	0	1	27	377	228	149
PCT7336	ED	175	178	0	0	23	155	112	43
PCT7336	TO	954	583	0	1	50	532	340	192
PCT7337	MV	772	386	0	0	41	345	230	115
PCT7337	ED	125	112	0	0	6	106	79	27
PCT7337	TO	897	498	0	0	47	451	309	142
PCT7338	MV	770	360	0	0	40	320	205	115
PCT7338	ED	125	91	0	0	9	82	67	15
PCT7338	TO	895	451	0	0	49	402	272	130
PCT7339	MV	605	270	0	0	24	246	187	59
PCT7339	ED	150	122	0	0	5	117	88	29
PCT7339	TO	755	392	0	0	29	363	275	88
PCT7341	MV	675	291	0	1	32	258	188	70
PCT7341	ED	178	160	0	0	10	150	122	28
PCT7341	TO	853	451	0	1	42	408	310	98
PCT7342	MV	674	324	0	0	19	305	233	72
PCT7342	ED	230	245	0	0	22	223	171	52
PCT7342	TO	904	569	0	0	41	528	404	124
PCT7343	MV	554	252	0	0	21	231	198	33
PCT7343	ED	150	150	0	0	18	132	112	20
PCT7343	TO	704	402	0	0	39	363	310	53
PCT7344	MV	863	392	0	0	28	364	265	99
PCT7344	ED	201	211	0	0	19	192	141	51
PCT7344	TO	1064	603	0	0	47	556	406	150
PCT7345	MV	904	434	0	0	36	398	304	94
PCT7345	ED	210	217	0	0	19	198	159	39
PCT7345	TO	1114	651	0	0	55	596	463	133
PCT7346	MV	681	288	0	0	20	268	208	60
PCT7346	ED	208	174	0	0	19	155	128	27
PCT7346	TO	889	462	0	0	39	423	336	87
PCT7347	MV	833	371	0	1	36	334	294	40
PCT7347	ED	170	123	0	0	9	114	99	15
PCT7347	TO	1003	494	0	1	45	448	393	55
PCT7348	MV	650	279	0	0	22	257	199	58
PCT7348	ED	193	116	0	0	9	107	86	21
PCT7348	TO	843	395	0	0	31	364	285	79
PCT7349	MV	710	316	0	0	23	293	204	89
PCT7349	ED	202	145	0	0	15	130	106	24
PCT7349	TO	912	461	0	0	38	423	310	113
PCT7501	MV	456	248	0	0	28	220	140	80
PCT7501	ED	95	116	0	0	13	103	70	33
PCT7501	TO	551	364	0	0	41	323	210	113
PCT7502	MV	668	315	0	0	28	287	206	81
PCT7502	ED	121	143	0	0	18	125	94	31
PCT7502	TO	789	458	0	0	46	412	300	112
PCT7503	MV	614	286	0	0	24	262	203	59
PCT7503	ED	148	138	0	0	20	118	94	24
PCT7503	TO	762	424	0	0	44	380	297	83
PCT7504	MV	404	175	0	0	15	160	127	33
PCT7504	ED	84	84	0	0	8	76	61	15
PCT7504	TO	488	259	0	0	23	236	188	48
PCT7505	MV	729	405	0	0	35	370	293	77
PCT7505	ED	133	130	0	0	8	122	100	22
PCT7505	TO	862	535	0	0	43	492	393	99
PCT7506	MV	842	364	0	0	41	323	241	82
PCT7506	ED	158	162	0	0	14	148	129	19
PCT7506	TO	1000	526	0	0	55	471	370	101
PCT7507	MV	694	289	0	0	20	269	223	46
PCT7507	ED	262	133	0	0	6	127	109	18
PCT7507	TO	956	422	0	0	26	396	332	64
PCT7508	MV	618	373	0	0	38	335	247	88
PCT7508	ED	126	118	0	0	7	111	92	19
PCT7508	TO	744	491	0	0	45	446	339	107
PCT7509	MV	756	399	0	0	28	371	278	93
PCT7509	ED	173	169	0	0	13	156	122	34
PCT7509	TO	929	568	0	0	41	527	400	127
PCT7512	MV	475	248	0	0	21	227	163	64
PCT7512	ED	125	89	0	0	10	79	65	14
PCT7512	TO	600	337	0	0	31	306	228	78
PCT7513	MV	575	248	0	0	25	223	185	38
PCT7513	ED	231	143	0	0	19	124	107	17
PCT7513	TO	806	391	0	0	44	347	292	55
PCT7514	MV	709	242	0	0	28	214	165	49
PCT7514	ED	207	76	0	0	13	63	56	7
PCT7514	TO	916	318	0	0	41	277	221	56
PCT7515	MV	663	322	0	0	21	301	217	84
PCT7515	ED	201	114	0	0	15	99	88	11
PCT7515	TO	864	436	0	0	36	400	305	95
PCT7516	MV	773	423	0	0	23	400	297	103
PCT7516	ED	147	131	0	0	4	127	93	34
PCT7516	TO	920	554	0	0	27	527	390	137
PCT7517	MV	645	362	0	0	34	328	261	67
PCT7517	ED	223	234	0	0	17	217	183	34
PCT7517	TO	868	596	0	0	51	545	444	101
PCT7518	MV	708	392	0	0	30	362	279	83
PCT7518	ED	218	247	0	0	21	226	197	29
PCT7518	TO	926	639	0	0	51	588	476	112
PCT7519	MV	543	260	0	0	28	232	189	43
PCT7519	ED	172	172	0	0	12	160	133	27
PCT7519	TO	715	432	0	0	40	392	322	70
PCT7521	MV	597	319	0	1	23	295	246	49
PCT7521	ED	182	205	0	0	10	195	159	36
PCT7521	TO	779	524	0	1	33	490	405	85
PCT7522	MV	588	301	0	0	23	278	230	48
PCT7522	ED	171	192	0	0	18	174	150	24
PCT7522	TO	759	493	0	0	41	452	380	72
PCT7523	MV	564	285	0	0	28	257	212	45
PCT7523	ED	180	221	0	0	14	207	170	37
PCT7523	TO	744	506	0	0	42	464	382	82
PCT7524	MV	480	228	0	0	26	202	173	29
PCT7524	ED	144	130	0	0	13	117	100	17
PCT7524	TO	624	358	0	0	39	319	273	46
PCT7525	MV	594	246	0	0	23	223	177	46
PCT7525	ED	170	130	0	0	14	116	106	10
PCT7525	TO	764	376	0	0	37	339	283	56
PCT7526	MV	826	395	0	0	45	350	287	63
PCT7526	ED	162	219	0	0	23	196	154	42
PCT7526	TO	988	614	0	0	68	546	441	105
PCT7527	MV	538	296	0	0	27	269	210	59
PCT7527	ED	172	126	0	0	5	121	99	22
PCT7527	TO	710	422	0	0	32	390	309	81
PCT7529	MV	749	366	0	0	20	346	295	51
PCT7529	ED	154	231	0	0	13	218	182	36
PCT7529	TO	903	597	0	0	33	564	477	87
PCT7531	MV	714	336	0	0	25	311	261	50
PCT7531	ED	159	179	0	0	8	171	140	31
PCT7531	TO	873	515	0	0	33	482	401	81
PCT7532	MV	668	329	0	0	29	300	232	68
PCT7532	ED	167	185	0	0	18	167	120	47
PCT7532	TO	835	514	0	0	47	467	352	115
PCT7533	MV	776	405	0	0	32	373	306	67
PCT7533	ED	194	252	0	0	26	226	195	31
PCT7533	TO	970	657	0	0	58	599	501	98
PCT7534	MV	670	376	0	0	34	342	267	75
PCT7534	ED	233	231	0	0	23	208	188	20
PCT7534	TO	903	607	0	0	57	550	455	95
PCT7535	MV	606	300	0	0	23	277	220	57
PCT7535	ED	139	199	0	0	24	175	155	20
PCT7535	TO	745	499	0	0	47	452	375	77
PCT7536	MV	670	346	0	0	21	325	267	58
PCT7536	ED	163	216	0	0	21	195	161	34
PCT7536	TO	833	562	0	0	42	520	428	92
PCT7537	MV	619	301	0	0	23	278	214	64
PCT7537	ED	126	197	0	1	14	182	150	32
PCT7537	TO	745	498	0	1	37	460	364	96
PCT7538	MV	562	322	0	0	20	302	244	58
PCT7538	ED	189	212	0	0	23	189	159	30
PCT7538	TO	751	534	0	0	43	491	403	88
PCT7539	MV	696	374	0	0	24	350	295	55
PCT7539	ED	225	215	0	0	16	199	174	25
PCT7539	TO	921	589	0	0	40	549	469	80
PCT7541	MV	600	295	0	0	29	266	209	57
PCT7541	ED	170	214	0	0	25	189	156	33
PCT7541	TO	770	509	0	0	54	455	365	90
PCT7542	MV	632	324	0	0	17	307	252	55
PCT7542	ED	192	200	0	0	10	190	161	29
PCT7542	TO	824	524	0	0	27	497	413	84
PCT7543	MV	694	371	0	0	16	355	290	65
PCT7543	ED	230	173	0	0	15	158	130	28
PCT7543	TO	924	544	0	0	31	513	420	93
PCT7544	MV	731	389	0	0	37	352	284	68
PCT7544	ED	168	207	0	0	24	183	147	36
PCT7544	TO	899	596	0	0	61	535	431	104
PCT7545	MV	723	385	0	0	26	359	289	70
PCT7545	ED	172	192	0	0	17	175	152	23
PCT7545	TO	895	577	0	0	43	534	441	93
PCT7546	MV	770	418	0	0	21	397	334	63
PCT7546	ED	183	255	0	0	24	231	187	44
PCT7546	TO	953	673	0	0	45	628	521	107
PCT7547	MV	798	427	0	0	33	394	336	58
PCT7547	ED	183	227	0	0	14	213	195	18
PCT7547	TO	981	654	0	0	47	607	531	76
PCT7548	MV	802	450	0	0	25	425	354	71
PCT7548	ED	249	259	0	0	21	238	205	33
PCT7548	TO	1051	709	0	0	46	663	559	104
PCT7549	MV	660	358	0	0	32	326	256	70
PCT7549	ED	146	170	0	0	20	150	123	27
PCT7549	TO	806	528	0	0	52	476	379	97
PCT7551	MV	587	304	0	0	18	286	228	58
PCT7551	ED	136	178	0	0	12	166	130	36
PCT7551	TO	723	482	0	0	30	452	358	94
PCT7552	MV	561	285	0	0	24	261	216	45
PCT7552	ED	124	168	0	0	23	145	122	23
PCT7552	TO	685	453	0	0	47	406	338	68
PCT7553	MV	211	95	0	0	7	88	69	19
PCT7553	ED	-20	7	0	0	1	6	5	1
PCT7553	TO	191	102	0	0	8	94	74	20
PCT7554	MV	653	381	0	0	29	352	266	86
PCT7554	ED	168	216	0	0	19	197	144	53
PCT7554	TO	821	597	0	0	48	549	410	139
PCT7555	MV	662	416	0	0	34	382	303	79
PCT7555	ED	210	244	0	0	20	224	185	39
PCT7555	TO	872	660	0	0	54	606	488	118
PCT7556	MV	812	513	0	0	29	484	367	117
PCT7556	ED	154	214	0	0	22	192	149	43
PCT7556	TO	966	727	0	0	51	676	516	160
PCT7601	MV	485	207	0	0	14	193	159	34
PCT7601	ED	192	112	0	0	12	100	86	14
PCT7601	TO	677	319	0	0	26	293	245	48
PCT7602	MV	654	276	0	0	20	256	218	38
PCT7602	ED	232	128	0	0	11	117	105	12
PCT7602	TO	886	404	0	0	31	373	323	50
PCT7603	MV	615	295	0	0	28	267	227	40
PCT7603	ED	200	174	0	0	12	162	137	25
PCT7603	TO	815	469	0	0	40	429	364	65
PCT7604	MV	685	270	0	0	18	252	213	39
PCT7604	ED	259	164	0	0	21	143	113	30
PCT7604	TO	944	434	0	0	39	395	326	69
PCT7605	MV	468	192	0	1	17	174	142	32
PCT7605	ED	193	84	0	0	7	77	67	10
PCT7605	TO	661	276	0	1	24	251	209	42
PCT7606	MV	673	267	0	0	27	240	195	45
PCT7606	ED	210	99	0	0	8	91	81	10
PCT7606	TO	883	366	0	0	35	331	276	55
PCT7607	MV	712	288	0	0	23	265	208	57
PCT7607	ED	207	127	0	0	7	120	102	18
PCT7607	TO	919	415	0	0	30	385	310	75
PCT7608	MV	279	96	0	0	9	87	64	23
PCT7608	ED	101	26	0	0	1	25	22	3
PCT7608	TO	380	122	0	0	10	112	86	26
PCT7609	MV	699	286	0	0	31	255	204	51
PCT7609	ED	185	69	0	1	6	62	53	9
PCT7609	TO	884	355	0	1	37	317	257	60
PCT7611	MV	586	235	0	0	15	220	188	32
PCT7611	ED	202	47	0	0	3	44	38	6
PCT7611	TO	788	282	0	0	18	264	226	38
PCT7612	MV	452	216	0	0	10	206	157	49
PCT7612	ED	105	47	0	0	4	43	35	8
PCT7612	TO	557	263	0	0	14	249	192	57
PCT7613	MV	634	244	0	0	17	227	194	33
PCT7613	ED	249	107	0	0	8	99	90	9
PCT7613	TO	883	351	0	0	25	326	284	42
PCT7614	MV	713	254	0	0	22	232	194	38
PCT7614	ED	203	114	0	0	7	107	88	19
PCT7614	TO	916	368	0	0	29	339	282	57
PCT7615	MV	510	165	0	0	9	156	125	31
PCT7615	ED	240	81	0	0	7	74	61	13
PCT7615	TO	750	246	0	0	16	230	186	44
PCT7616	MV	754	330	0	0	35	295	209	86
PCT7616	ED	82	144	0	0	14	130	99	31
PCT7616	TO	836	474	0	0	49	425	308	117
PCT7617	MV	583	222	0	0	21	201	165	36
PCT7617	ED	169	67	0	0	13	54	44	10
PCT7617	TO	752	289	0	0	34	255	209	46
PCT7618	MV	763	365	0	0	23	342	252	90
PCT7618	ED	151	114	0	0	13	101	75	26
PCT7618	TO	914	479	0	0	36	443	327	116
PCT7619	MV	937	439	0	0	27	412	315	97
PCT7619	ED	170	169	0	0	19	150	121	29
PCT7619	TO	1107	608	0	0	46	562	436	126
PCT7621	MV	1006	443	0	0	35	408	305	103
PCT7621	ED	149	150	0	0	18	132	100	32
PCT7621	TO	1155	593	0	0	53	540	405	135
PCT7622	MV	697	215	0	0	13	202	169	33
PCT7622	ED	263	98	0	0	13	85	76	9
PCT7622	TO	960	313	0	0	26	287	245	42
PCT7623	MV	767	256	0	1	22	233	201	32
PCT7623	ED	237	143	0	0	13	130	118	12
PCT7623	TO	1004	399	0	1	35	363	319	44
PCT7624	MV	652	209	0	0	11	198	161	37
PCT7624	ED	223	97	0	0	16	81	70	11
PCT7624	TO	875	306	0	0	27	279	231	48
PCT7625	MV	749	394	0	0	52	342	261	81
PCT7625	ED	73	39	0	0	1	38	31	7
PCT7625	TO	822	433	0	0	53	380	292	88
PCT7626	MV	944	401	0	0	43	358	240	118
PCT7626	ED	129	134	0	0	7	127	96	31
PCT7626	TO	1073	535	0	0	50	485	336	149
PCT7627	MV	457	196	0	0	17	179	108	71
PCT7627	ED	67	65	0	0	8	57	34	23
PCT7627	TO	524	261	0	0	25	236	142	94
PCT7628	MV	718	332	0	0	14	318	253	65
PCT7628	ED	220	156	0	0	11	145	118	27
PCT7628	TO	938	488	0	0	25	463	371	92
PCT7629	MV	691	276	0	0	23	253	201	52
PCT7629	ED	162	131	0	0	10	121	103	18
PCT7629	TO	853	407	0	0	33	374	304	70
PCT7631	MV	1009	441	0	0	28	413	313	100
PCT7631	ED	210	159	0	0	14	145	116	29
PCT7631	TO	1219	600	0	0	42	558	429	129
PCT7632	MV	1002	414	0	0	26	388	291	97
PCT7632	ED	169	188	0	0	13	175	145	30
PCT7632	TO	1171	602	0	0	39	563	436	127
PCT7633	MV	609	278	0	0	23	255	187	68
PCT7633	ED	126	108	0	0	9	99	78	21
PCT7633	TO	735	386	0	0	32	354	265	89
PCT7634	MV	704	344	0	0	38	306	237	69
PCT7634	ED	186	143	0	0	19	124	95	29
PCT7634	TO	890	487	0	0	57	430	332	98
PCT7635	MV	665	274	0	0	16	258	178	80
PCT7635	ED	188	83	0	0	6	77	58	19
PCT7635	TO	853	357	0	0	22	335	236	99
PCT7636	MV	798	330	0	0	32	298	187	111
PCT7636	ED	161	155	0	0	16	139	103	36
PCT7636	TO	959	485	0	0	48	437	290	147
PCT7637	MV	747	344	0	0	31	313	190	123
PCT7637	ED	121	145	0	0	23	122	87	35
PCT7637	TO	868	489	0	0	54	435	277	158
PCT7638	MV	806	372	0	0	29	343	192	151
PCT7638	ED	83	132	0	0	14	118	64	54
PCT7638	TO	889	504	0	0	43	461	256	205
PCT7639	MV	889	396	0	0	41	355	227	128
PCT7639	ED	133	154	0	0	25	129	84	45
PCT7639	TO	1022	550	0	0	66	484	311	173
PCT7641	MV	817	400	0	0	27	373	235	138
PCT7641	ED	134	141	0	0	11	130	90	40
PCT7641	TO	951	541	0	0	38	503	325	178
PCT7642	MV	647	311	0	0	36	275	196	79
PCT7642	ED	118	129	0	0	20	109	82	27
PCT7642	TO	765	440	0	0	56	384	278	106
PCT7643	MV	810	433	0	0	31	402	264	138
PCT7643	ED	131	115	0	0	15	100	76	24
PCT7643	TO	941	548	0	0	46	502	340	162
PCT7644	MV	1014	404	0	0	43	361	239	122
PCT7644	ED	162	186	0	0	17	169	144	25
PCT7644	TO	1176	590	0	0	60	530	383	147
PCT7645	MV	595	286	0	0	22	264	179	85
PCT7645	ED	61	96	0	0	14	82	58	24
PCT7645	TO	656	382	0	0	36	346	237	109
PCT7646	MV	1032	485	0	0	44	441	296	145
PCT7646	ED	121	179	0	0	26	153	126	27
PCT7646	TO	1153	664	0	0	70	594	422	172
PCT7647	MV	724	211	0	0	4	207	164	43
PCT7647	ED	263	117	0	0	10	107	86	21
PCT7647	TO	987	328	0	0	14	314	250	64
PCT7648	MV	2	1	0	0	1	0	0	0
PCT7648	TO	2	1	0	0	1	0	0	0
PCT7649	MV	723	286	0	0	12	274	205	69
PCT7649	ED	177	108	0	0	10	98	78	20
PCT7649	TO	900	394	0	0	22	372	283	89
PCT7651	MV	834	332	0	0	30	302	209	93
PCT7651	ED	113	110	0	0	13	97	61	36
PCT7651	TO	947	442	0	0	43	399	270	129
PCT7652	MV	535	208	0	0	19	189	126	63
PCT7652	ED	100	98	0	0	11	87	69	18
PCT7652	TO	635	306	0	0	30	276	195	81
PCT7653	MV	750	335	0	0	37	298	217	81
PCT7653	ED	89	95	0	0	12	83	60	23
PCT7653	TO	839	430	0	0	49	381	277	104
PCT7654	MV	413	191	0	0	13	178	130	48
PCT7654	ED	53	91	0	0	9	82	66	16
PCT7654	TO	466	282	0	0	22	260	196	64
PCT7655	MV	583	215	0	0	10	205	146	59
PCT7655	ED	96	84	0	0	15	69	51	18
PCT7655	TO	679	299	0	0	25	274	197	77
PCT7656	MV	603	308	0	0	29	279	159	120
PCT7656	ED	35	67	0	0	11	56	29	27
PCT7656	TO	638	375	0	0	40	335	188	147
PCT7657	MV	561	269	0	0	31	238	145	93
PCT7657	ED	37	89	0	0	13	76	54	22
PCT7657	TO	598	358	0	0	44	314	199	115
PCT7701	MV	868	481	0	0	36	445	335	110
PCT7701	ED	196	175	0	0	10	165	126	39
PCT7701	TO	1064	656	0	0	46	610	461	149
PCT7702	MV	623	377	0	0	22	355	225	130
PCT7702	ED	133	107	0	0	8	99	69	30
PCT7702	TO	756	484	0	0	30	454	294	160
PCT7703	MV	187	71	0	0	4	67	58	9
PCT7703	ED	-13	0	0	0	0	0	0	0
PCT7703	TO	174	71	0	0	4	67	58	9
PCT7704	MV	798	490	0	0	37	453	267	186
PCT7704	ED	204	175	0	0	5	170	111	59
PCT7704	TO	1002	665	0	0	42	623	378	245
PCT7705	MV	470	285	0	0	17	268	154	114
PCT7705	ED	125	110	0	0	11	99	60	39
PCT7705	TO	595	395	0	0	28	367	214	153
PCT7706	MV	687	447	0	0	25	422	259	163
PCT7706	ED	179	163	0	0	7	156	104	52
PCT7706	TO	866	610	0	0	32	578	363	215
PCT7707	MV	683	432	0	0	24	408	278	130
PCT7707	ED	189	179	0	0	8	171	103	68
PCT7707	TO	872	611	0	0	32	579	381	198
PCT7708	MV	710	462	0	0	38	424	273	151
PCT7708	ED	165	154	0	0	11	143	99	44
PCT7708	TO	875	616	0	0	49	567	372	195
PCT7709	MV	324	194	0	0	10	184	119	65
PCT7709	ED	82	90	0	0	5	85	67	18
PCT7709	TO	406	284	0	0	15	269	186	83
PCT7711	MV	658	379	0	1	20	358	245	113
PCT7711	ED	153	126	0	0	6	120	93	27
PCT7711	TO	811	505	0	1	26	478	338	140
PCT7712	MV	425	258	0	0	14	244	183	61
PCT7712	ED	107	109	0	0	9	100	72	28
PCT7712	TO	532	367	0	0	23	344	255	89
PCT7801	MV	823	479	0	0	22	457	325	132
PCT7801	ED	151	196	0	0	10	186	137	49
PCT7801	TO	974	675	0	0	32	643	462	181
PCT7802	MV	646	402	0	0	25	377	287	90
PCT7802	ED	152	160	0	0	8	152	127	25
PCT7802	TO	798	562	0	0	33	529	414	115
PCT7803	MV	718	476	0	0	31	445	317	128
PCT7803	ED	113	129	0	0	12	117	89	28
PCT7803	TO	831	605	0	0	43	562	406	156
PCT7804	MV	734	463	0	0	47	416	301	115
PCT7804	ED	151	182	0	1	19	162	127	35
PCT7804	TO	885	645	0	1	66	578	428	150
PCT7805	MV	644	400	0	0	42	358	261	97
PCT7805	ED	156	157	0	0	13	144	123	21
PCT7805	TO	800	557	0	0	55	502	384	118
PCT7806	MV	602	361	0	0	28	333	263	70
PCT7806	ED	153	154	0	0	14	140	115	25
PCT7806	TO	755	515	0	0	42	473	378	95
PCT7807	MV	642	363	0	0	20	343	273	70
PCT7807	ED	185	176	0	0	17	159	138	21
PCT7807	TO	827	539	0	0	37	502	411	91
PCT7808	MV	525	296	0	0	25	271	221	50
PCT7808	ED	129	132	0	0	11	121	98	23
PCT7808	TO	654	428	0	0	36	392	319	73
PCT7809	MV	624	351	0	0	22	329	272	57
PCT7809	ED	140	137	0	0	13	124	113	11
PCT7809	TO	764	488	0	0	35	453	385	68
PCT7811	MV	582	311	0	0	22	289	240	49
PCT7811	ED	176	157	0	0	8	149	123	26
PCT7811	TO	758	468	0	0	30	438	363	75
PCT7812	MV	680	369	0	0	32	337	272	65
PCT7812	ED	217	168	0	0	10	158	130	28
PCT7812	TO	897	537	0	0	42	495	402	93
PCT7813	MV	843	483	0	0	25	458	360	98
PCT7813	ED	225	217	0	0	17	200	169	31
PCT7813	TO	1068	700	0	0	42	658	529	129
PCT7814	MV	660	281	0	0	19	262	206	56
PCT7814	ED	241	120	0	0	9	111	101	10
PCT7814	TO	901	401	0	0	28	373	307	66
PCT7815	MV	749	465	0	0	49	416	321	95
PCT7815	ED	168	181	0	0	10	171	139	32
PCT7815	TO	917	646	0	0	59	587	460	127
PCT7816	MV	724	472	0	0	37	435	331	104
PCT7816	ED	148	151	0	0	8	143	106	37
PCT7816	TO	872	623	0	0	45	578	437	141
PCT7817	MV	652	396	0	0	13	383	321	62
PCT7817	ED	186	185	0	0	10	175	152	23
PCT7817	TO	838	581	0	0	23	558	473	85
PCT7818	MV	668	393	0	0	26	367	290	77
PCT7818	ED	171	150	0	0	8	142	122	20
PCT7818	TO	839	543	0	0	34	509	412	97
PCT7819	MV	635	352	0	0	29	323	248	75
PCT7819	ED	139	91	0	0	6	85	77	8
PCT7819	TO	774	443	0	0	35	408	325	83
PCT7821	MV	806	519	0	0	32	487	380	107
PCT7821	ED	170	190	0	0	9	181	130	51
PCT7821	TO	976	709	0	0	41	668	510	158
PCT7822	MV	673	395	0	1	25	369	296	73
PCT7822	ED	219	224	0	0	21	203	155	48
PCT7822	TO	892	619	0	1	46	572	451	121
PCT7823	MV	706	410	0	0	26	384	306	78
PCT7823	ED	177	189	0	0	5	184	160	24
PCT7823	TO	883	599	0	0	31	568	466	102
PCT7824	MV	615	335	0	0	29	306	229	77
PCT7824	ED	153	158	0	0	12	146	123	23
PCT7824	TO	768	493	0	0	41	452	352	100
PCT7825	MV	457	252	0	0	17	235	208	27
PCT7825	ED	151	132	0	0	4	128	107	21
PCT7825	TO	608	384	0	0	21	363	315	48
PCT7826	MV	486	263	0	0	18	245	200	45
PCT7826	ED	204	163	0	0	6	157	143	14
PCT7826	TO	690	426	0	0	24	402	343	59
PCT7827	MV	607	318	0	0	20	298	239	59
PCT7827	ED	219	147	0	0	16	131	111	20
PCT7827	TO	826	465	0	0	36	429	350	79
PCT7828	MV	857	478	0	1	32	445	328	117
PCT7828	ED	171	183	0	1	20	162	129	33
PCT7828	TO	1028	661	0	2	52	607	457	150
PCT7829	MV	742	466	0	0	35	431	296	135
PCT7829	ED	149	151	0	0	5	146	118	28
PCT7829	TO	891	617	0	0	40	577	414	163
PCT7831	MV	763	485	0	0	41	444	333	111
PCT7831	ED	139	139	0	0	9	130	95	35
PCT7831	TO	902	624	0	0	50	574	428	146
PCT7832	MV	663	413	0	0	33	380	293	87
PCT7832	ED	118	128	0	0	9	119	100	19
PCT7832	TO	781	541	0	0	42	499	393	106
PCT7833	MV	587	343	0	0	24	319	253	66
PCT7833	ED	146	146	0	0	17	129	107	22
PCT7833	TO	733	489	0	0	41	448	360	88
PCT7834	MV	700	375	0	0	28	347	295	52
PCT7834	ED	194	179	0	0	13	166	141	25
PCT7834	TO	894	554	0	0	41	513	436	77
PCT7835	MV	721	428	0	0	26	402	275	127
PCT7835	ED	142	148	0	0	12	136	102	34
PCT7835	TO	863	576	0	0	38	538	377	161
PCT7836	MV	850	505	0	0	25	480	335	145
PCT7836	ED	193	171	0	0	6	165	117	48
PCT7836	TO	1043	676	0	0	31	645	452	193
PCT7837	MV	718	424	0	0	46	378	272	106
PCT7837	ED	205	202	0	0	10	192	158	34
PCT7837	TO	923	626	0	0	56	570	430	140
PCT7838	MV	752	493	0	0	39	454	323	131
PCT7838	ED	143	158	0	0	9	149	116	33
PCT7838	TO	895	651	0	0	48	603	439	164
PCT7839	MV	731	456	0	0	40	416	305	111
PCT7839	ED	130	140	0	1	10	129	100	29
PCT7839	TO	861	596	0	1	50	545	405	140
PCT7841	MV	752	458	0	0	33	425	323	102
PCT7841	ED	198	207	0	0	8	199	159	40
PCT7841	TO	950	665	0	0	41	624	482	142
PCT7842	MV	702	394	0	0	31	363	295	68
PCT7842	ED	177	155	0	0	6	149	123	26
PCT7842	TO	879	549	0	0	37	512	418	94
PCT7843	MV	546	295	0	0	13	282	234	48
PCT7843	ED	183	165	0	0	12	153	123	30
PCT7843	TO	729	460	0	0	25	435	357	78
PCT7844	MV	499	281	0	0	27	254	213	41
PCT7844	ED	152	137	0	0	13	124	101	23
PCT7844	TO	651	418	0	0	40	378	314	64
PCT7845	MV	676	405	0	0	27	378	301	77
PCT7845	ED	204	178	0	0	14	164	128	36
PCT7845	TO	880	583	0	0	41	542	429	113
PCT7846	MV	736	464	0	0	44	420	296	124
PCT7846	ED	172	171	0	0	18	153	122	31
PCT7846	TO	908	635	0	0	62	573	418	155
PCT7847	MV	698	429	0	0	40	389	306	83
PCT7847	ED	193	183	0	0	7	176	139	37
PCT7847	TO	891	612	0	0	47	565	445	120
PCT7848	MV	665	437	0	0	29	408	311	97
PCT7848	ED	182	169	0	0	18	151	118	33
PCT7848	TO	847	606	0	0	47	559	429	130
PCT7849	MV	729	443	0	1	36	406	310	96
PCT7849	ED	172	188	0	0	15	173	142	31
PCT7849	TO	901	631	0	1	51	579	452	127
PCT7851	MV	414	272	0	0	23	249	152	97
PCT7851	ED	112	85	0	0	8	77	49	28
PCT7851	TO	526	357	0	0	31	326	201	125
PCT7852	MV	533	350	0	0	24	326	205	121
PCT7852	ED	111	103	0	0	5	98	68	30
PCT7852	TO	644	453	0	0	29	424	273	151
PCT7853	MV	694	394	0	0	32	362	251	111
PCT7853	ED	161	139	0	0	10	129	93	36
PCT7853	TO	855	533	0	0	42	491	344	147
PCT7854	MV	703	430	0	0	35	395	284	111
PCT7854	ED	175	173	0	0	11	162	128	34
PCT7854	TO	878	603	0	0	46	557	412	145
PCT7855	MV	763	451	0	0	36	415	307	108
PCT7855	ED	211	204	0	0	17	187	151	36
PCT7855	TO	974	655	0	0	53	602	458	144
PCT7856	MV	643	376	0	0	25	351	268	83
PCT7856	ED	204	193	0	0	10	183	145	38
PCT7856	TO	847	569	0	0	35	534	413	121
PCT7857	MV	748	437	0	1	36	400	304	96
PCT7857	ED	158	156	0	0	9	147	121	26
PCT7857	TO	906	593	0	1	45	547	425	122
PCT7858	MV	622	349	0	0	30	319	261	58
PCT7858	ED	157	151	0	0	11	140	122	18
PCT7858	TO	779	500	0	0	41	459	383	76
PCT7859	MV	747	464	0	0	34	430	310	120
PCT7859	ED	152	167	0	0	17	150	107	43
PCT7859	TO	899	631	0	0	51	580	417	163
PCT7861	MV	699	432	0	0	25	407	292	115
PCT7861	ED	164	171	0	0	9	162	123	39
PCT7861	TO	863	603	0	0	34	569	415	154
PCT7862	MV	669	401	0	0	26	375	272	103
PCT7862	ED	195	198	0	0	12	186	150	36
PCT7862	TO	864	599	0	0	38	561	422	139
PCT7863	MV	693	373	0	0	24	349	270	79
PCT7863	ED	208	208	0	0	8	200	147	53
PCT7863	TO	901	581	0	0	32	549	417	132
PCT7864	MV	661	374	0	0	30	344	253	91
PCT7864	ED	153	157	0	0	12	145	114	31
PCT7864	TO	814	531	0	0	42	489	367	122
PCT7865	MV	677	408	0	0	39	369	280	89
PCT7865	ED	163	160	0	0	11	149	114	35
PCT7865	TO	840	568	0	0	50	518	394	124
PCT7866	MV	690	446	0	0	21	425	263	162
PCT7866	ED	158	143	0	0	6	137	91	46
PCT7866	TO	848	589	0	0	27	562	354	208
PCT7867	MV	766	470	0	0	29	441	333	108
PCT7867	ED	212	184	0	0	14	170	133	37
PCT7867	TO	978	654	0	0	43	611	466	145
PCT7868	MV	659	376	0	0	21	355	262	93
PCT7868	ED	217	162	0	1	9	152	117	35
PCT7868	TO	876	538	0	1	30	507	379	128
PCT7869	MV	683	441	0	0	30	411	306	105
PCT7869	ED	178	191	0	0	11	180	146	34
PCT7869	TO	861	632	0	0	41	591	452	139
PCT7871	MV	702	464	0	0	34	430	329	101
PCT7871	ED	200	157	0	0	9	148	108	40
PCT7871	TO	902	621	0	0	43	578	437	141
PCT7872	MV	675	420	0	0	25	395	299	96
PCT7872	ED	199	186	0	0	9	177	132	45
PCT7872	TO	874	606	0	0	34	572	431	141
PCT7873	MV	689	444	0	1	28	415	316	99
PCT7873	ED	202	214	0	0	15	199	165	34
PCT7873	TO	891	658	0	1	43	614	481	133
PCT7874	MV	370	191	0	0	8	183	136	47
PCT7874	ED	119	108	0	0	6	102	84	18
PCT7874	TO	489	299	0	0	14	285	220	65
PCT7875	MV	500	253	0	0	16	237	177	60
PCT7875	ED	147	115	0	0	5	110	93	17
PCT7875	TO	647	368	0	0	21	347	270	77
PCT7876	MV	462	257	0	0	27	230	187	43
PCT7876	ED	106	93	0	0	12	81	68	13
PCT7876	TO	568	350	0	0	39	311	255	56
PCT7901	MV	399	191	0	0	14	177	148	29
PCT7901	ED	150	67	0	0	3	64	55	9
PCT7901	TO	549	258	0	0	17	241	203	38
PCT7902	MV	680	290	0	0	14	276	234	42
PCT7902	ED	232	145	0	0	8	137	117	20
PCT7902	TO	912	435	0	0	22	413	351	62
PCT7903	MV	623	286	0	0	23	263	221	42
PCT7903	ED	229	125	0	0	7	118	111	7
PCT7903	TO	852	411	0	0	30	381	332	49
PCT7904	MV	680	299	0	0	25	274	221	53
PCT7904	ED	157	122	0	0	9	113	96	17
PCT7904	TO	837	421	0	0	34	387	317	70
PCT7905	MV	684	356	0	0	20	336	265	71
PCT7905	ED	191	183	0	0	8	175	151	24
PCT7905	TO	875	539	0	0	28	511	416	95
PCT7906	MV	599	283	0	0	20	263	223	40
PCT7906	ED	187	118	0	0	13	105	87	18
PCT7906	TO	786	401	0	0	33	368	310	58
PCT7907	MV	704	344	0	0	15	329	269	60
PCT7907	ED	238	165	0	0	15	150	129	21
PCT7907	TO	942	509	0	0	30	479	398	81
PCT7908	MV	752	366	0	0	24	342	290	52
PCT7908	ED	240	172	0	0	12	160	143	17
PCT7908	TO	992	538	0	0	36	502	433	69
PCT7909	MV	558	311	0	0	22	289	248	41
PCT7909	ED	185	141	0	0	8	133	117	16
PCT7909	TO	743	452	0	0	30	422	365	57
PCT7911	MV	666	322	0	0	26	296	234	62
PCT7911	ED	205	129	0	0	8	121	104	17
PCT7911	TO	871	451	0	0	34	417	338	79
PCT7912	MV	800	370	0	0	26	344	301	43
PCT7912	ED	259	182	0	0	20	162	147	15
PCT7912	TO	1059	552	0	0	46	506	448	58
PCT7913	MV	660	350	0	0	14	336	277	59
PCT7913	ED	263	216	0	0	5	211	175	36
PCT7913	TO	923	566	0	0	19	547	452	95
PCT7914	MV	715	390	0	0	29	361	301	60
PCT7914	ED	187	142	0	0	12	130	109	21
PCT7914	TO	902	532	0	0	41	491	410	81
PCT7915	MV	605	290	0	0	23	267	220	47
PCT7915	ED	238	183	0	0	5	178	149	29
PCT7915	TO	843	473	0	0	28	445	369	76
PCT7916	MV	639	335	0	0	21	314	264	50
PCT7916	ED	219	162	0	0	11	151	138	13
PCT7916	TO	858	497	0	0	32	465	402	63
PCT7917	MV	716	357	0	0	20	337	287	50
PCT7917	ED	271	187	0	0	8	179	157	22
PCT7917	TO	987	544	0	0	28	516	444	72
PCT7918	MV	597	297	0	0	13	284	242	42
PCT7918	ED	227	145	0	0	7	138	116	22
PCT7918	TO	824	442	0	0	20	422	358	64
PCT7919	MV	608	309	0	0	16	293	254	39
PCT7919	ED	258	177	0	0	9	168	149	19
PCT7919	TO	866	486	0	0	25	461	403	58
PCT7921	MV	682	310	0	0	18	292	245	47
PCT7921	ED	229	103	0	0	4	99	90	9
PCT7921	TO	911	413	0	0	22	391	335	56
PCT7922	MV	648	314	0	0	14	300	248	52
PCT7922	ED	210	157	0	0	14	143	119	24
PCT7922	TO	858	471	0	0	28	443	367	76
PCT7923	MV	666	337	0	0	15	322	245	77
PCT7923	ED	214	172	0	0	10	162	135	27
PCT7923	TO	880	509	0	0	25	484	380	104
PCT7924	MV	649	303	0	0	11	292	232	60
PCT7924	ED	202	126	0	0	10	116	93	23
PCT7924	TO	851	429	0	0	21	408	325	83
PCT7925	MV	434	225	0	0	16	209	164	45
PCT7925	ED	110	89	0	0	4	85	74	11
PCT7925	TO	544	314	0	0	20	294	238	56
PCT7926	MV	610	337	0	0	23	314	254	60
PCT7926	ED	178	150	0	0	6	144	115	29
PCT7926	TO	788	487	0	0	29	458	369	89
PCT7927	MV	580	335	0	0	26	309	254	55
PCT7927	ED	162	154	0	0	6	148	125	23
PCT7927	TO	742	489	0	0	32	457	379	78
PCT7928	MV	700	395	0	0	23	372	292	80
PCT7928	ED	217	208	0	0	4	204	164	40
PCT7928	TO	917	603	0	0	27	576	456	120
PCT7929	MV	678	424	0	0	22	402	328	74
PCT7929	ED	169	172	0	0	9	163	147	16
PCT7929	TO	847	596	0	0	31	565	475	90
PCT7931	MV	610	378	0	0	34	344	266	78
PCT7931	ED	141	150	0	0	6	144	119	25
PCT7931	TO	751	528	0	0	40	488	385	103
PCT7932	MV	443	277	0	0	21	256	179	77
PCT7932	ED	118	96	0	0	6	90	73	17
PCT7932	TO	561	373	0	0	27	346	252	94
PCT7933	MV	9	6	0	0	0	6	4	2
PCT7933	ED	-1	0	0	0	0	0	0	0
PCT7933	TO	8	6	0	0	0	6	4	2
PCT7934	MV	702	409	0	0	27	382	325	57
PCT7934	ED	182	156	0	0	10	146	120	26
PCT7934	TO	884	565	0	0	37	528	445	83
PCT7935	MV	716	436	0	0	26	410	325	85
PCT7935	ED	227	227	0	0	16	211	177	34
PCT7935	TO	943	663	0	0	42	621	502	119
PCT7936	MV	620	370	0	0	29	341	273	68
PCT7936	ED	236	221	0	0	10	211	171	40
PCT7936	TO	856	591	0	0	39	552	444	108
PCT7937	MV	698	406	0	0	23	383	300	83
PCT7937	ED	202	172	0	0	7	165	139	26
PCT7937	TO	900	578	0	0	30	548	439	109
PCT7938	MV	536	301	0	0	15	286	213	73
PCT7938	ED	215	121	0	0	8	113	97	16
PCT7938	TO	751	422	0	0	23	399	310	89
PCT7939	MV	481	289	0	0	16	273	227	46
PCT7939	ED	205	191	0	0	10	181	153	28
PCT7939	TO	686	480	0	0	26	454	380	74
PCT7941	MV	576	304	0	0	29	275	220	55
PCT7941	ED	196	173	0	0	10	163	124	39
PCT7941	TO	772	477	0	0	39	438	344	94
PCT7942	MV	658	333	0	0	20	313	248	65
PCT7942	ED	274	141	0	0	5	136	114	22
PCT7942	TO	932	474	0	0	25	449	362	87
PCT7943	MV	687	368	0	0	17	351	258	93
PCT7943	ED	213	158	0	0	11	147	106	41
PCT7943	TO	900	526	0	0	28	498	364	134
PCT7944	MV	584	342	0	0	25	317	247	70
PCT7944	ED	230	197	0	0	11	186	152	34
PCT7944	TO	814	539	0	0	36	503	399	104
PCT7945	MV	726	338	0	0	25	313	250	63
PCT7945	ED	228	85	0	0	7	78	71	7
PCT7945	TO	954	423	0	0	32	391	321	70
PCT7946	MV	779	366	0	1	20	345	196	149
PCT7946	ED	206	115	0	0	7	108	81	27
PCT7946	TO	985	481	0	1	27	453	277	176
PCT7947	MV	792	332	0	0	23	309	161	148
PCT7947	ED	194	95	0	0	2	93	70	23
PCT7947	TO	986	427	0	0	25	402	231	171
PCT7948	MV	730	373	0	0	25	348	194	154
PCT7948	ED	200	119	0	0	3	116	85	31
PCT7948	TO	930	492	0	0	28	464	279	185
PCT7949	MV	484	233	0	0	12	221	113	108
PCT7949	ED	106	57	0	0	7	50	36	14
PCT7949	TO	590	290	0	0	19	271	149	122
PCT7951	MV	731	366	0	0	26	340	180	160
PCT7951	ED	156	90	0	0	3	87	56	31
PCT7951	TO	887	456	0	0	29	427	236	191
PCT7952	MV	730	292	0	0	18	274	151	123
PCT7952	ED	182	86	0	0	6	80	51	29
PCT7952	TO	912	378	0	0	24	354	202	152
PCT7953	MV	669	331	0	0	17	314	177	137
PCT7953	ED	161	106	0	0	5	101	63	38
PCT7953	TO	830	437	0	0	22	415	240	175
PCT7955	MV	774	350	0	0	18	332	202	130
PCT7955	ED	173	101	0	0	8	93	58	35
PCT7955	TO	947	451	0	0	26	425	260	165
PCT7956	MV	699	267	0	0	12	255	151	104
PCT7956	ED	170	42	0	0	2	40	33	7
PCT7956	TO	869	309	0	0	14	295	184	111
PCT7957	MV	538	261	0	0	15	246	165	81
PCT7957	ED	135	85	0	0	6	79	60	19
PCT7957	TO	673	346	0	0	21	325	225	100
PCT7958	MV	320	104	0	0	6	98	71	27
PCT7958	ED	-23	0	0	0	0	0	0	0
PCT7958	TO	297	104	0	0	6	98	71	27
PCT7959	MV	541	230	0	0	23	207	172	35
PCT7959	ED	145	68	0	0	5	63	59	4
PCT7959	TO	686	298	0	0	28	270	231	39
PCT9001	MV	314	100	0	0	1	99	79	20
PCT9001	ED	-30	0	0	0	0	0	0	0
PCT9001	TO	284	100	0	0	1	99	79	20
PCT9101	MV	712	378	0	0	23	355	241	114
PCT9101	ED	201	195	0	0	12	183	124	59
PCT9101	TO	913	573	0	0	35	538	365	173
PCT9102	MV	788	393	0	0	26	367	246	121
PCT9102	ED	204	175	0	0	17	158	122	36
PCT9102	TO	992	568	0	0	43	525	368	157
PCT9103	MV	719	381	0	0	32	349	250	99
PCT9103	ED	238	194	0	0	15	179	117	62
PCT9103	TO	957	575	0	0	47	528	367	161
PCT9104	MV	810	382	0	0	36	346	244	102
PCT9104	ED	220	181	0	0	16	165	131	34
PCT9104	TO	1030	563	0	0	52	511	375	136
PCT9105	MV	719	413	0	0	23	390	254	136
PCT9105	ED	199	223	0	0	22	201	141	60
PCT9105	TO	918	636	0	0	45	591	395	196
PCT9106	MV	748	397	0	0	30	367	257	110
PCT9106	ED	198	225	0	0	20	205	158	47
PCT9106	TO	946	622	0	0	50	572	415	157
PCT9107	MV	636	305	0	1	24	280	207	73
PCT9107	ED	208	166	0	0	14	152	125	27
PCT9107	TO	844	471	0	1	38	432	332	100
PCT9108	MV	610	337	0	0	30	307	229	78
PCT9108	ED	200	143	0	0	8	135	108	27
PCT9108	TO	810	480	0	0	38	442	337	105
PCT9109	MV	672	300	0	0	29	271	198	73
PCT9109	ED	211	199	0	0	12	187	142	45
PCT9109	TO	883	499	0	0	41	458	340	118
PCT9111	MV	639	317	0	0	25	292	194	98
PCT9111	ED	195	170	0	0	15	155	125	30
PCT9111	TO	834	487	0	0	40	447	319	128
PCT9112	MV	742	351	0	0	22	329	237	92
PCT9112	ED	219	207	0	0	15	192	150	42
PCT9112	TO	961	558	0	0	37	521	387	134
PCT9113	MV	796	371	0	0	31	340	250	90
PCT9113	ED	208	245	0	0	24	221	159	62
PCT9113	TO	1004	616	0	0	55	561	409	152
PCT9114	MV	659	291	0	0	20	271	198	73
PCT9114	ED	231	184	0	0	15	169	137	32
PCT9114	TO	890	475	0	0	35	440	335	105
PCT9115	MV	699	322	0	0	28	294	216	78
PCT9115	ED	182	180	0	0	22	158	136	22
PCT9115	TO	881	502	0	0	50	452	352	100
PCT9116	MV	782	346	0	0	20	326	229	97
PCT9116	ED	179	181	0	0	12	169	124	45
PCT9116	TO	961	527	0	0	32	495	353	142
PCT9117	MV	629	328	0	0	16	312	200	112
PCT9117	ED	171	195	0	0	13	182	122	60
PCT9117	TO	800	523	0	0	29	494	322	172
PCT9118	MV	742	340	0	0	24	316	198	118
PCT9118	ED	242	228	0	0	23	205	146	59
PCT9118	TO	984	568	0	0	47	521	344	177
PCT9119	MV	703	387	0	0	22	365	222	143
PCT9119	ED	197	160	0	0	14	146	116	30
PCT9119	TO	900	547	0	0	36	511	338	173
PCT9121	MV	735	335	0	0	19	316	209	107
PCT9121	ED	218	185	0	0	11	174	113	61
PCT9121	TO	953	520	0	0	30	490	322	168
PCT9122	MV	775	364	0	0	29	335	204	131
PCT9122	ED	192	161	0	0	18	143	103	40
PCT9122	TO	967	525	0	0	47	478	307	171
PCT9123	MV	661	319	0	0	18	301	204	97
PCT9123	ED	191	190	0	0	15	175	136	39
PCT9123	TO	852	509	0	0	33	476	340	136
PCT9124	MV	736	351	0	0	13	338	205	133
PCT9124	ED	167	161	0	0	10	151	113	38
PCT9124	TO	903	512	0	0	23	489	318	171
PCT9125	MV	681	358	0	0	19	339	231	108
PCT9125	ED	188	154	0	0	12	142	109	33
PCT9125	TO	869	512	0	0	31	481	340	141
PCT9126	MV	819	385	0	1	28	356	208	148
PCT9126	ED	194	200	0	0	15	185	140	45
PCT9126	TO	1013	585	0	1	43	541	348	193
PCT9127	MV	748	382	0	0	33	349	246	103
PCT9127	ED	223	221	0	0	12	209	153	56
PCT9127	TO	971	603	0	0	45	558	399	159
PCT9128	MV	628	333	0	0	25	308	200	108
PCT9128	ED	190	196	0	0	13	183	134	49
PCT9128	TO	818	529	0	0	38	491	334	157
PCT9129	MV	587	272	0	0	16	256	170	86
PCT9129	ED	151	154	0	0	9	145	115	30
PCT9129	TO	738	426	0	0	25	401	285	116
PCT9131	MV	596	285	0	0	13	272	181	91
PCT9131	ED	138	154	0	0	11	143	105	38
PCT9131	TO	734	439	0	0	24	415	286	129
PCT9132	MV	627	262	0	0	21	241	189	52
PCT9132	ED	194	172	0	0	16	156	126	30
PCT9132	TO	821	434	0	0	37	397	315	82
PCT9133	MV	808	382	0	0	23	359	264	95
PCT9133	ED	209	214	0	0	15	199	148	51
PCT9133	TO	1017	596	0	0	38	558	412	146
PCT9134	MV	736	327	0	0	22	305	196	109
PCT9134	ED	155	106	0	0	10	96	74	22
PCT9134	TO	891	433	0	0	32	401	270	131
PCT9135	MV	640	305	0	0	20	285	187	98
PCT9135	ED	182	159	0	0	12	147	93	54
PCT9135	TO	822	464	0	0	32	432	280	152
PCT9136	MV	706	368	0	0	36	332	224	108
PCT9136	ED	212	165	0	0	16	149	117	32
PCT9136	TO	918	533	0	0	52	481	341	140
PCT9137	MV	806	389	0	0	26	363	245	118
PCT9137	ED	209	176	0	0	9	167	127	40
PCT9137	TO	1015	565	0	0	35	530	372	158
PCT9138	MV	770	398	0	0	21	377	249	128
PCT9138	ED	175	150	0	0	8	142	107	35
PCT9138	TO	945	548	0	0	29	519	356	163
PCT9139	MV	828	423	0	0	29	394	253	141
PCT9139	ED	190	178	0	0	17	161	113	48
PCT9139	TO	1018	601	0	0	46	555	366	189
PCT9141	MV	789	418	0	0	33	385	239	146
PCT9141	ED	184	173	0	0	15	158	114	44
PCT9141	TO	973	591	0	0	48	543	353	190
PCT9142	MV	747	364	0	0	18	346	242	104
PCT9142	ED	239	210	0	0	20	190	148	42
PCT9142	TO	986	574	0	0	38	536	390	146
PCT9143	MV	705	360	0	0	23	337	205	132
PCT9143	ED	209	172	0	0	8	164	114	50
PCT9143	TO	914	532	0	0	31	501	319	182
PCT9144	MV	767	376	0	0	27	349	230	119
PCT9144	ED	203	215	0	0	11	204	161	43
PCT9144	TO	970	591	0	0	38	553	391	162
PCT9145	MV	681	334	0	0	15	319	239	80
PCT9145	ED	194	178	0	0	9	169	124	45
PCT9145	TO	875	512	0	0	24	488	363	125
PCT9146	MV	725	353	0	0	28	325	241	84
PCT9146	ED	160	194	0	0	18	176	139	37
PCT9146	TO	885	547	0	0	46	501	380	121
PCT9147	MV	765	373	0	0	32	341	248	93
PCT9147	ED	225	211	0	0	17	194	145	49
PCT9147	TO	990	584	0	0	49	535	393	142
PCT9148	MV	779	397	0	0	26	371	280	91
PCT9148	ED	235	230	0	0	22	208	169	39
PCT9148	TO	1014	627	0	0	48	579	449	130
PCT9149	MV	813	385	0	0	23	362	265	97
PCT9149	ED	178	252	0	0	12	240	185	55
PCT9149	TO	991	637	0	0	35	602	450	152
PCT9151	MV	693	351	0	0	30	321	239	82
PCT9151	ED	168	116	0	0	5	111	81	30
PCT9151	TO	861	467	0	0	35	432	320	112
PCT9152	MV	550	196	0	0	11	185	152	33
PCT9152	ED	187	143	0	0	11	132	112	20
PCT9152	TO	737	339	0	0	22	317	264	53
PCT9201	MV	785	358	0	0	30	328	278	50
PCT9201	ED	186	228	0	0	17	211	173	38
PCT9201	TO	971	586	0	0	47	539	451	88
PCT9202	MV	819	368	0	1	38	329	252	77
PCT9202	ED	177	228	0	0	18	210	156	54
PCT9202	TO	996	596	0	1	56	539	408	131
PCT9203	MV	847	373	0	0	54	319	189	130
PCT9203	ED	155	191	0	0	29	162	95	67
PCT9203	TO	1002	564	0	0	83	481	284	197
PCT9204	MV	686	309	0	0	35	274	154	120
PCT9204	ED	176	198	0	0	27	171	103	68
PCT9204	TO	862	507	0	0	62	445	257	188
PCT9205	MV	621	288	0	0	36	252	168	84
PCT9205	ED	115	154	0	0	21	133	83	50
PCT9205	TO	736	442	0	0	57	385	251	134
PCT9206	MV	741	351	0	0	30	321	179	142
PCT9206	ED	188	194	0	0	38	156	92	64
PCT9206	TO	929	545	0	0	68	477	271	206
PCT9207	MV	824	370	0	0	33	337	188	149
PCT9207	ED	165	194	0	0	17	177	114	63
PCT9207	TO	989	564	0	0	50	514	302	212
PCT9208	MV	808	357	0	0	32	325	196	129
PCT9208	ED	179	179	0	0	16	163	107	56
PCT9208	TO	987	536	0	0	48	488	303	185
PCT9209	MV	615	276	0	0	25	251	156	95
PCT9209	ED	156	172	0	0	29	143	86	57
PCT9209	TO	771	448	0	0	54	394	242	152
PCT9211	MV	730	314	0	1	35	278	162	116
PCT9211	ED	161	155	0	0	25	130	78	52
PCT9211	TO	891	469	0	1	60	408	240	168
PCT9212	MV	671	284	0	1	27	256	160	96
PCT9212	ED	137	175	0	0	31	144	95	49
PCT9212	TO	808	459	0	1	58	400	255	145
PCT9213	MV	776	350	0	0	36	314	193	121
PCT9213	ED	161	200	0	0	28	172	107	65
PCT9213	TO	937	550	0	0	64	486	300	186
PCT9214	MV	517	236	0	0	19	217	137	80
PCT9214	ED	110	136	0	0	24	112	69	43
PCT9214	TO	627	372	0	0	43	329	206	123
PCT9215	MV	524	246	0	1	15	230	133	97
PCT9215	ED	120	131	0	0	14	117	71	46
PCT9215	TO	644	377	0	1	29	347	204	143
PCT9216	MV	669	264	0	0	33	231	133	98
PCT9216	ED	155	173	0	0	20	153	107	46
PCT9216	TO	824	437	0	0	53	384	240	144
PCT9217	MV	588	268	0	0	13	255	154	101
PCT9217	ED	117	134	0	0	9	125	79	46
PCT9217	TO	705	402	0	0	22	380	233	147
PCT9218	MV	652	278	0	0	26	252	142	110
PCT9218	ED	164	160	0	0	17	143	102	41
PCT9218	TO	816	438	0	0	43	395	244	151
PCT9219	MV	646	288	0	0	34	254	175	79
PCT9219	ED	144	172	0	0	20	152	113	39
PCT9219	TO	790	460	0	0	54	406	288	118
PCT9221	MV	562	322	0	0	19	303	163	140
PCT9221	ED	89	140	0	0	16	124	88	36
PCT9221	TO	651	462	0	0	35	427	251	176
PCT9222	MV	773	373	0	0	32	341	203	138
PCT9222	ED	137	176	0	0	22	154	100	54
PCT9222	TO	910	549	0	0	54	495	303	192
PCT9223	MV	558	266	0	0	18	248	143	105
PCT9223	ED	109	115	0	0	12	103	59	44
PCT9223	TO	667	381	0	0	30	351	202	149
PCT9224	MV	768	380	0	0	32	348	227	121
PCT9224	ED	181	168	0	0	21	147	89	58
PCT9224	TO	949	548	0	0	53	495	316	179
PCT9225	MV	757	303	0	0	26	277	176	101
PCT9225	ED	169	219	0	0	28	191	131	60
PCT9225	TO	926	522	0	0	54	468	307	161
PCT9226	MV	741	355	0	0	43	312	208	104
PCT9226	ED	155	179	0	0	16	163	119	44
PCT9226	TO	896	534	0	0	59	475	327	148
PCT9227	MV	605	372	0	0	27	345	214	131
PCT9227	ED	124	149	0	0	7	142	98	44
PCT9227	TO	729	521	0	0	34	487	312	175
PCT9228	MV	578	314	0	0	21	293	170	123
PCT9228	ED	160	180	0	0	15	165	105	60
PCT9228	TO	738	494	0	0	36	458	275	183
PCT9229	MV	460	257	0	0	20	237	171	66
PCT9229	ED	119	122	0	0	8	114	74	40
PCT9229	TO	579	379	0	0	28	351	245	106
PCT9231	MV	726	352	0	0	24	328	235	93
PCT9231	ED	236	264	0	0	20	244	174	70
PCT9231	TO	962	616	0	0	44	572	409	163
PCT9232	MV	608	293	0	1	28	264	154	110
PCT9232	ED	126	157	0	0	14	143	85	58
PCT9232	TO	734	450	0	1	42	407	239	168
PCT9233	MV	668	332	0	1	31	300	177	123
PCT9233	ED	150	188	0	0	25	163	119	44
PCT9233	TO	818	520	0	1	56	463	296	167
PCT9234	MV	643	319	0	0	26	293	181	112
PCT9234	ED	91	145	0	0	21	124	80	44
PCT9234	TO	734	464	0	0	47	417	261	156
PCT9235	MV	703	365	0	0	29	336	190	146
PCT9235	ED	160	195	0	0	17	178	121	57
PCT9235	TO	863	560	0	0	46	514	311	203
PCT9236	MV	537	283	0	0	24	259	172	87
PCT9236	ED	136	137	0	0	18	119	83	36
PCT9236	TO	673	420	0	0	42	378	255	123
PCT9237	MV	779	395	0	0	35	360	234	126
PCT9237	ED	118	183	0	0	15	168	108	60
PCT9237	TO	897	578	0	0	50	528	342	186
PCT9238	MV	687	330	0	0	33	297	168	129
PCT9238	ED	118	174	0	0	25	149	101	48
PCT9238	TO	805	504	0	0	58	446	269	177
PCT9239	MV	740	391	0	0	45	346	225	121
PCT9239	ED	124	161	0	0	19	142	105	37
PCT9239	TO	864	552	0	0	64	488	330	158
PCT9241	MV	819	403	0	0	36	367	223	144
PCT9241	ED	141	196	0	0	22	174	120	54
PCT9241	TO	960	599	0	0	58	541	343	198
PCT9242	MV	771	349	0	1	39	309	216	93
PCT9242	ED	172	215	0	0	26	189	138	51
PCT9242	TO	943	564	0	1	65	498	354	144
PCT9243	MV	480	242	0	0	22	220	147	73
PCT9243	ED	123	141	0	0	21	120	87	33
PCT9243	TO	603	383	0	0	43	340	234	106
PCT9244	MV	756	396	0	0	51	345	256	89
PCT9244	ED	154	186	0	0	18	168	111	57
PCT9244	TO	910	582	0	0	69	513	367	146
PCT9245	MV	616	300	0	0	31	269	169	100
PCT9245	ED	98	129	0	0	14	115	81	34
PCT9245	TO	714	429	0	0	45	384	250	134
PCT9246	MV	815	430	0	0	35	395	258	137
PCT9246	ED	155	196	0	0	23	173	128	45
PCT9246	TO	970	626	0	0	58	568	386	182
PCT9247	MV	764	381	0	0	23	358	258	100
PCT9247	ED	148	205	0	0	29	176	125	51
PCT9247	TO	912	586	0	0	52	534	383	151
PCT9248	MV	757	358	0	0	35	323	245	78
PCT9248	ED	150	192	0	0	19	173	131	42
PCT9248	TO	907	550	0	0	54	496	376	120
PCT9249	MV	724	379	0	0	32	347	246	101
PCT9249	ED	191	214	0	0	17	197	138	59
PCT9249	TO	915	593	0	0	49	544	384	160
PCT9251	MV	792	392	0	0	33	359	234	125
PCT9251	ED	174	236	0	0	20	216	153	63
PCT9251	TO	966	628	0	0	53	575	387	188
PCT9252	MV	811	382	0	0	32	350	217	133
PCT9252	ED	142	179	0	0	14	165	114	51
PCT9252	TO	953	561	0	0	46	515	331	184
PCT9253	MV	599	300	0	0	18	282	188	94
PCT9253	ED	162	150	0	0	16	134	92	42
PCT9253	TO	761	450	0	0	34	416	280	136
PCT9254	MV	758	415	0	0	29	386	286	100
PCT9254	ED	163	197	0	0	32	165	108	57
PCT9254	TO	921	612	0	0	61	551	394	157
PCT9255	MV	436	196	0	0	25	171	112	59
PCT9255	ED	114	135	0	0	16	119	91	28
PCT9255	TO	550	331	0	0	41	290	203	87
PCT9256	MV	367	169	0	0	13	156	114	42
PCT9256	ED	95	119	0	0	11	108	77	31
PCT9256	TO	462	288	0	0	24	264	191	73
PCT9257	MV	359	162	0	0	16	146	124	22
PCT9257	ED	-39	13	0	0	1	12	11	1
PCT9257	TO	320	175	0	0	17	158	135	23
PCT9258	MV	583	307	0	0	29	278	191	87
PCT9258	ED	120	148	0	0	11	137	107	30
PCT9258	TO	703	455	0	0	40	415	298	117
PCT9401	MV	796	358	0	0	19	339	265	74
PCT9401	ED	242	226	0	0	18	208	173	35
PCT9401	TO	1038	584	0	0	37	547	438	109
PCT9402	MV	775	377	0	0	16	361	254	107
PCT9402	ED	242	207	0	0	16	191	154	37
PCT9402	TO	1017	584	0	0	32	552	408	144
PCT9403	MV	731	348	0	0	14	334	224	110
PCT9403	ED	190	168	0	0	9	159	137	22
PCT9403	TO	921	516	0	0	23	493	361	132
PCT9404	MV	753	345	0	0	17	328	211	117
PCT9404	ED	191	197	0	0	17	180	131	49
PCT9404	TO	944	542	0	0	34	508	342	166
PCT9405	MV	629	276	0	0	20	256	160	96
PCT9405	ED	151	131	0	0	5	126	84	42
PCT9405	TO	780	407	0	0	25	382	244	138
PCT9406	MV	695	330	0	0	19	311	201	110
PCT9406	ED	188	169	0	0	11	158	110	48
PCT9406	TO	883	499	0	0	30	469	311	158
PCT9407	MV	712	368	0	0	13	355	264	91
PCT9407	ED	201	174	0	0	17	157	117	40
PCT9407	TO	913	542	0	0	30	512	381	131
PCT9408	MV	711	321	0	0	24	297	235	62
PCT9408	ED	152	171	0	0	15	156	122	34
PCT9408	TO	863	492	0	0	39	453	357	96
PCT9409	MV	443	226	0	0	20	206	157	49
PCT9409	ED	158	146	0	0	6	140	117	23
PCT9409	TO	601	372	0	0	26	346	274	72
PCT9411	MV	816	378	0	0	25	353	261	92
PCT9411	ED	191	212	0	0	12	200	161	39
PCT9411	TO	1007	590	0	0	37	553	422	131
PCT9412	MV	668	339	0	0	20	319	199	120
PCT9412	ED	202	186	0	0	10	176	131	45
PCT9412	TO	870	525	0	0	30	495	330	165
PCT9413	MV	757	375	0	0	35	340	205	135
PCT9413	ED	179	170	0	0	15	155	113	42
PCT9413	TO	936	545	0	0	50	495	318	177
PCT9414	MV	734	361	0	0	22	339	210	129
PCT9414	ED	186	142	0	0	7	135	98	37
PCT9414	TO	920	503	0	0	29	474	308	166
PCT9415	MV	634	315	0	0	18	297	191	106
PCT9415	ED	154	135	0	0	4	131	92	39
PCT9415	TO	788	450	0	0	22	428	283	145
PCT9416	MV	769	391	0	0	34	357	226	131
PCT9416	ED	230	151	0	0	4	147	101	46
PCT9416	TO	999	542	0	0	38	504	327	177
PCT9417	MV	629	321	0	0	21	300	167	133
PCT9417	ED	145	125	0	0	3	122	84	38
PCT9417	TO	774	446	0	0	24	422	251	171
PCT9418	MV	631	310	0	0	22	288	160	128
PCT9418	ED	188	141	0	0	8	133	87	46
PCT9418	TO	819	451	0	0	30	421	247	174
PCT9419	MV	736	369	0	0	23	346	179	167
PCT9419	ED	173	140	0	0	10	130	75	55
PCT9419	TO	909	509	0	0	33	476	254	222
PCT9421	MV	752	338	0	0	25	313	159	154
PCT9421	ED	173	154	0	0	8	146	99	47
PCT9421	TO	925	492	0	0	33	459	258	201
PCT9422	MV	831	413	0	0	27	386	226	160
PCT9422	ED	270	209	0	0	18	191	141	50
PCT9422	TO	1101	622	0	0	45	577	367	210
PCT9423	MV	714	316	0	0	22	294	181	113
PCT9423	ED	190	158	0	0	9	149	111	38
PCT9423	TO	904	474	0	0	31	443	292	151
PCT9424	MV	799	385	0	1	23	361	204	157
PCT9424	ED	210	154	0	0	13	141	100	41
PCT9424	TO	1009	539	0	1	36	502	304	198
PCT9425	MV	789	346	0	0	24	322	189	133
PCT9425	ED	187	171	0	0	13	158	107	51
PCT9425	TO	976	517	0	0	37	480	296	184
PCT9426	MV	697	324	0	0	22	302	159	143
PCT9426	ED	156	139	0	0	17	122	84	38
PCT9426	TO	853	463	0	0	39	424	243	181
PCT9427	MV	799	383	0	1	20	362	190	172
PCT9427	ED	188	149	0	0	17	132	79	53
PCT9427	TO	987	532	0	1	37	494	269	225
PCT9428	MV	811	351	0	0	27	324	194	130
PCT9428	ED	179	144	0	0	14	130	98	32
PCT9428	TO	990	495	0	0	41	454	292	162
PCT9429	MV	709	343	0	0	20	323	173	150
PCT9429	ED	197	146	0	0	20	126	79	47
PCT9429	TO	906	489	0	0	40	449	252	197
PCT9431	MV	832	412	0	0	28	384	204	180
PCT9431	ED	204	171	0	0	6	165	108	57
PCT9431	TO	1036	583	0	0	34	549	312	237
PCT9432	MV	743	358	0	0	31	327	183	144
PCT9432	ED	215	136	0	0	13	123	88	35
PCT9432	TO	958	494	0	0	44	450	271	179
PCT9433	MV	794	373	0	0	29	344	185	159
PCT9433	ED	164	124	0	1	7	116	67	49
PCT9433	TO	958	497	0	1	36	460	252	208
PCT9434	MV	785	387	0	0	28	359	229	130
PCT9434	ED	227	210	0	0	25	185	139	46
PCT9434	TO	1012	597	0	0	53	544	368	176
PCT9435	MV	779	366	0	0	25	341	188	153
PCT9435	ED	225	186	0	0	13	173	114	59
PCT9435	TO	1004	552	0	0	38	514	302	212
PCT9436	MV	842	386	0	0	20	366	204	162
PCT9436	ED	226	149	0	0	11	138	93	45
PCT9436	TO	1068	535	0	0	31	504	297	207
PCT9437	MV	736	376	0	0	18	358	209	149
PCT9437	ED	191	149	0	0	6	143	93	50
PCT9437	TO	927	525	0	0	24	501	302	199
PCT9438	MV	837	419	0	0	22	397	220	177
PCT9438	ED	152	108	0	0	7	101	70	31
PCT9438	TO	989	527	0	0	29	498	290	208
PCT9439	MV	718	343	0	0	17	326	194	132
PCT9439	ED	199	141	0	0	17	124	85	39
PCT9439	TO	917	484	0	0	34	450	279	171
PCT9441	MV	778	396	0	0	29	367	220	147
PCT9441	ED	193	166	0	0	14	152	115	37
PCT9441	TO	971	562	0	0	43	519	335	184
PCT9442	MV	830	379	0	0	37	342	188	154
PCT9442	ED	210	212	0	0	15	197	150	47
PCT9442	TO	1040	591	0	0	52	539	338	201
PCT9443	MV	759	362	0	0	21	341	212	129
PCT9443	ED	196	152	0	0	11	141	98	43
PCT9443	TO	955	514	0	0	32	482	310	172
PCT9444	MV	768	340	0	0	13	327	176	151
PCT9444	ED	197	134	0	0	12	122	81	41
PCT9444	TO	965	474	0	0	25	449	257	192
PCT9445	MV	829	406	0	0	26	380	227	153
PCT9445	ED	167	147	0	0	9	138	90	48
PCT9445	TO	996	553	0	0	35	518	317	201
PCT9446	MV	900	465	0	0	27	438	245	193
PCT9446	ED	216	178	0	0	14	164	111	53
PCT9446	TO	1116	643	0	0	41	602	356	246
PCT9447	MV	729	392	0	0	17	375	211	164
PCT9447	ED	192	181	0	0	17	164	114	50
PCT9447	TO	921	573	0	0	34	539	325	214
PCT9448	MV	742	347	0	0	21	326	190	136
PCT9448	ED	198	157	0	0	10	147	114	33
PCT9448	TO	940	504	0	0	31	473	304	169
PCT9449	MV	719	340	0	0	20	320	152	168
PCT9449	ED	162	119	0	0	9	110	70	40
PCT9449	TO	881	459	0	0	29	430	222	208
PCT9451	MV	353	178	0	0	7	171	86	85
PCT9451	ED	88	69	0	0	3	66	46	20
PCT9451	TO	441	247	0	0	10	237	132	105
PCT9452	MV	647	334	0	0	22	312	168	144
PCT9452	ED	195	186	0	0	13	173	109	64
PCT9452	TO	842	520	0	0	35	485	277	208
PCT9453	MV	409	217	0	0	12	205	105	100
PCT9453	ED	115	84	0	0	8	76	45	31
PCT9453	TO	524	301	0	0	20	281	150	131
PCT9501	MV	158	92	0	0	11	81	58	23
PCT9501	ED	-8	3	0	0	0	3	2	1
PCT9501	TO	150	95	0	0	11	84	60	24
PCT9502	MV	294	136	0	0	12	124	91	33
PCT9502	ED	-43	6	0	0	1	5	5	0
PCT9502	TO	251	142	0	0	13	129	96	33
PCT9503	MV	550	263	0	0	28	235	205	30
PCT9503	ED	150	122	0	0	10	112	93	19
PCT9503	TO	700	385	0	0	38	347	298	49
PCT9505	MV	589	296	0	0	23	273	203	70
PCT9505	ED	176	136	0	0	9	127	106	21
PCT9505	TO	765	432	0	0	32	400	309	91
PCT9506	MV	547	232	0	0	18	214	173	41
PCT9506	ED	207	138	0	0	11	127	107	20
PCT9506	TO	754	370	0	0	29	341	280	61
PCT9507	MV	556	306	0	0	22	284	229	55
PCT9507	ED	160	182	0	0	20	162	135	27
PCT9507	TO	716	488	0	0	42	446	364	82
PCT9508	MV	632	317	0	0	18	299	246	53
PCT9508	ED	148	185	0	0	24	161	138	23
PCT9508	TO	780	502	0	0	42	460	384	76
PCT9509	MV	585	296	0	0	18	278	207	71
PCT9509	ED	142	167	0	0	17	150	128	22
PCT9509	TO	727	463	0	0	35	428	335	93
PCT9511	MV	458	240	0	0	18	222	181	41
PCT9511	ED	176	163	0	0	13	150	123	27
PCT9511	TO	634	403	0	0	31	372	304	68
PCT9512	MV	617	327	0	0	19	308	238	70
PCT9512	ED	160	179	0	0	16	163	138	25
PCT9512	TO	777	506	0	0	35	471	376	95
PCT9513	MV	686	334	0	0	22	312	271	41
PCT9513	ED	191	188	0	0	15	173	149	24
PCT9513	TO	877	522	0	0	37	485	420	65
PCT9514	MV	713	352	0	0	31	321	257	64
PCT9514	ED	183	213	0	0	15	198	166	32
PCT9514	TO	896	565	0	0	46	519	423	96
PCT9515	MV	543	305	0	0	21	284	221	63
PCT9515	ED	169	164	0	0	17	147	114	33
PCT9515	TO	712	469	0	0	38	431	335	96
PCT9516	MV	705	366	0	0	26	340	256	84
PCT9516	ED	184	190	0	0	12	178	129	49
PCT9516	TO	889	556	0	0	38	518	385	133
PCT9517	MV	626	335	0	0	28	307	249	58
PCT9517	ED	162	173	0	0	17	156	134	22
PCT9517	TO	788	508	0	0	45	463	383	80
PCT9518	MV	642	316	0	0	27	289	238	51
PCT9518	ED	146	195	0	0	11	184	141	43
PCT9518	TO	788	511	0	0	38	473	379	94
PCT9519	MV	693	368	0	0	25	343	268	75
PCT9519	ED	198	239	0	0	21	218	160	58
PCT9519	TO	891	607	0	0	46	561	428	133
PCT9521	MV	687	352	0	0	25	327	256	71
PCT9521	ED	214	242	0	0	23	219	186	33
PCT9521	TO	901	594	0	0	48	546	442	104
PCT9701	MV	498	269	0	0	21	248	181	67
PCT9701	ED	156	139	0	0	6	133	110	23
PCT9701	TO	654	408	0	0	27	381	291	90
PCT9702	MV	554	305	0	0	17	288	204	84
PCT9702	ED	166	148	0	0	6	142	121	21
PCT9702	TO	720	453	0	0	23	430	325	105
PCT9703	MV	809	403	0	0	38	365	213	152
PCT9703	ED	182	147	0	0	6	141	100	41
PCT9703	TO	991	550	0	0	44	506	313	193
PCT9704	MV	760	422	0	0	30	392	256	136
PCT9704	ED	199	199	0	0	11	188	142	46
PCT9704	TO	959	621	0	0	41	580	398	182
PCT9705	MV	754	421	0	0	29	392	283	109
PCT9705	ED	175	146	0	0	12	134	110	24
PCT9705	TO	929	567	0	0	41	526	393	133
PCT9706	MV	57	34	0	0	3	31	24	7
PCT9706	ED	-8	0	0	0	0	0	0	0
PCT9706	TO	49	34	0	0	3	31	24	7
PCT9707	MV	687	358	0	0	21	337	192	145
PCT9707	ED	139	103	0	0	9	94	62	32
PCT9707	TO	826	461	0	0	30	431	254	177
PCT9708	MV	786	429	0	1	36	392	280	112
PCT9708	ED	175	159	0	0	5	154	112	42
PCT9708	TO	961	588	0	1	41	546	392	154
PCT9709	MV	831	427	0	0	39	388	221	167
PCT9709	ED	209	183	0	0	8	175	112	63
PCT9709	TO	1040	610	0	0	47	563	333	230
PCT9711	MV	502	307	0	0	18	289	180	109
PCT9711	ED	144	162	0	0	12	150	95	55
PCT9711	TO	646	469	0	0	30	439	275	164
PCT9712	MV	534	335	0	0	21	314	181	133
PCT9712	ED	127	118	0	0	3	115	69	46
PCT9712	TO	661	453	0	0	24	429	250	179
PCT9713	MV	747	389	0	0	19	370	212	158
PCT9713	ED	203	171	0	0	10	161	106	55
PCT9713	TO	950	560	0	0	29	531	318	213
PCT9714	MV	795	447	0	0	31	416	239	177
PCT9714	ED	156	137	0	0	2	135	84	51
PCT9714	TO	951	584	0	0	33	551	323	228
PCT9715	MV	449	241	0	0	15	226	138	88
PCT9715	ED	130	135	0	0	3	132	90	42
PCT9715	TO	579	376	0	0	18	358	228	130
PCT9716	MV	745	398	0	0	30	368	220	148
PCT9716	ED	221	167	0	0	10	157	105	52
PCT9716	TO	966	565	0	0	40	525	325	200
PCT9717	MV	753	437	0	0	27	410	232	178
PCT9717	ED	224	173	0	0	17	156	93	63
PCT9717	TO	977	610	0	0	44	566	325	241
PCT9718	MV	749	449	0	0	28	421	259	162
PCT9718	ED	152	145	0	0	6	139	86	53
PCT9718	TO	901	594	0	0	34	560	345	215
PCT9719	MV	747	463	0	0	23	440	263	177
PCT9719	ED	173	151	0	0	8	143	86	57
PCT9719	TO	920	614	0	0	31	583	349	234
PCT9721	MV	498	288	0	0	18	270	143	127
PCT9721	ED	164	135	0	0	5	130	74	56
PCT9721	TO	662	423	0	0	23	400	217	183
PCT9722	MV	513	315	0	0	19	296	182	114
PCT9722	ED	84	76	0	0	5	71	45	26
PCT9722	TO	597	391	0	0	24	367	227	140
PCT9723	MV	436	224	0	0	9	215	76	139
PCT9723	ED	72	46	0	0	3	43	21	22
PCT9723	TO	508	270	0	0	12	258	97	161
PCT9724	MV	851	451	0	1	24	426	188	238
PCT9724	ED	169	100	0	0	5	95	54	41
PCT9724	TO	1020	551	0	1	29	521	242	279
PCT9725	MV	814	437	0	0	24	413	200	213
PCT9725	ED	157	97	0	0	10	87	35	52
PCT9725	TO	971	534	0	0	34	500	235	265
PCT9726	MV	630	217	0	0	19	198	153	45
PCT9726	ED	-14	103	0	0	7	96	71	25
PCT9726	TO	616	320	0	0	26	294	224	70
PCT9727	MV	404	227	0	2	11	214	117	97
PCT9727	ED	56	35	0	0	2	33	21	12
PCT9727	TO	460	262	0	2	13	247	138	109
PCT9728	MV	751	446	0	0	25	421	216	205
PCT9728	ED	212	137	0	0	8	129	78	51
PCT9728	TO	963	583	0	0	33	550	294	256
PCT9729	MV	654	335	0	0	22	313	158	155
PCT9729	ED	164	131	0	0	3	128	79	49
PCT9729	TO	818	466	0	0	25	441	237	204
PCT9731	MV	436	245	0	0	15	230	121	109
PCT9731	ED	143	111	0	0	9	102	59	43
PCT9731	TO	579	356	0	0	24	332	180	152
PCT9732	MV	78	47	0	0	6	41	22	19
PCT9732	ED	-5	0	0	0	0	0	0	0
PCT9732	TO	73	47	0	0	6	41	22	19
PCT9733	MV	261	162	0	0	4	158	115	43
PCT9733	ED	-21	1	0	0	0	1	1	0
PCT9733	TO	240	163	0	0	4	159	116	43
PCT9734	MV	473	286	0	0	17	269	150	119
PCT9734	ED	131	110	0	0	4	106	66	40
PCT9734	TO	604	396	0	0	21	375	216	159
PCT9735	MV	650	386	0	0	20	366	213	153
PCT9735	ED	170	133	0	0	16	117	67	50
PCT9735	TO	820	519	0	0	36	483	280	203
PCT9736	MV	586	325	0	0	21	304	198	106
PCT9736	ED	150	155	0	0	12	143	94	49
PCT9736	TO	736	480	0	0	33	447	292	155
PCT9737	MV	637	388	0	0	22	366	206	160
PCT9737	ED	154	137	0	0	8	129	91	38
PCT9737	TO	791	525	0	0	30	495	297	198
PCT9738	MV	688	320	0	0	22	298	222	76
PCT9738	ED	150	66	0	0	5	61	43	18
PCT9738	TO	838	386	0	0	27	359	265	94
PCT9739	MV	674	270	0	0	10	260	213	47
PCT9739	ED	115	88	0	0	3	85	71	14
PCT9739	TO	789	358	0	0	13	345	284	61
PCT9741	MV	837	173	0	0	15	158	147	11
PCT9741	ED	-396	10	0	0	2	8	8	0
PCT9741	TO	441	183	0	0	17	166	155	11
PCT9742	MV	530	229	0	0	10	219	112	107
PCT9742	ED	165	101	0	0	6	95	50	45
PCT9742	TO	695	330	0	0	16	314	162	152
PCT9743	MV	913	400	0	0	21	379	281	98
PCT9743	ED	227	174	0	0	13	161	134	27
PCT9743	TO	1140	574	0	0	34	540	415	125
PCT9744	MV	783	333	0	0	22	311	247	64
PCT9744	ED	160	126	0	0	11	115	96	19
PCT9744	TO	943	459	0	0	33	426	343	83
PCT9745	MV	790	317	0	0	23	294	243	51
PCT9745	ED	202	129	0	0	11	118	105	13
PCT9745	TO	992	446	0	0	34	412	348	64
PCT9746	MV	714	373	0	0	13	360	219	141
PCT9746	ED	189	120	0	0	11	109	66	43
PCT9746	TO	903	493	0	0	24	469	285	184
PCT9747	MV	772	401	0	0	18	383	257	126
PCT9747	ED	204	146	0	0	10	136	103	33
PCT9747	TO	976	547	0	0	28	519	360	159
PCT9748	MV	746	425	0	1	22	402	268	134
PCT9748	ED	167	119	0	0	4	115	69	46
PCT9748	TO	913	544	0	1	26	517	337	180
PCT9749	MV	750	289	0	0	9	280	196	84
PCT9749	ED	188	109	0	0	2	107	83	24
PCT9749	TO	938	398	0	0	11	387	279	108
PCT9751	MV	857	472	0	1	29	442	274	168
PCT9751	ED	214	153	0	0	15	138	101	37
PCT9751	TO	1071	625	0	1	44	580	375	205
PCT9752	MV	563	328	0	0	20	308	183	125
PCT9752	ED	134	109	0	0	3	106	78	28
PCT9752	TO	697	437	0	0	23	414	261	153
PCT9753	MV	617	300	0	0	18	282	206	76
PCT9753	ED	145	123	0	0	2	121	98	23
PCT9753	TO	762	423	0	0	20	403	304	99
PCT9754	MV	545	317	0	0	15	302	228	74
PCT9754	ED	162	115	0	0	9	106	87	19
PCT9754	TO	707	432	0	0	24	408	315	93
PCT9755	MV	441	239	0	0	18	221	151	70
PCT9755	ED	139	99	0	0	2	97	71	26
PCT9755	TO	580	338	0	0	20	318	222	96
PCT9756	MV	805	364	0	0	23	341	194	147
PCT9756	ED	162	107	0	0	6	101	71	30
PCT9756	TO	967	471	0	0	29	442	265	177
PCT9801	MV	320	163	0	0	12	151	109	42
PCT9801	ED	88	53	0	0	4	49	41	8
PCT9801	TO	408	216	0	0	16	200	150	50
CONG12	MV	355594	174824	0	29	13042	161753	114478	47275
CONG12	ED	90254	77529	0	11	6430	71088	54650	16438
CONG12	TO	445848	252353	0	40	19472	232841	169128	63713
CONG14	MV	47252	22365	0	10	1219	21136	13202	7934
CONG14	ED	10799	7055	0	0	423	6632	4699	1933
CONG14	TO	58051	29420	0	10	1642	27768	17901	9867
ASSM17	MV	232787	114654	0	17	8565	106072	78017	28055
ASSM17	ED	59635	47539	0	10	3823	43706	34806	8900
ASSM17	TO	292422	162193	0	27	12388	149778	112823	36955
ASSM19	MV	170059	82535	0	22	5696	76817	49663	27154
ASSM19	ED	41418	37045	0	1	3030	34014	24543	9471
ASSM19	TO	211477	119580	0	23	8726	110831	74206	36625
SUPV1	MV	33868	16583	0	2	1144	15437	10599	4838
SUPV1	ED	9248	8645	0	0	667	7978	6004	1974
SUPV1	TO	43116	25228	0	2	1811	23415	16603	6812
SUPV2	MV	41435	19991	0	8	1827	18156	11776	6380
SUPV2	ED	8611	10358	0	0	1181	9177	6318	2859
SUPV2	TO	50046	30349	0	8	3008	27333	18094	9239
SUPV3	MV	31943	14432	0	4	1285	13143	9105	4038
SUPV3	ED	7434	6535	0	4	664	5867	4518	1349
SUPV3	TO	39377	20967	0	8	1949	19010	13623	5387
SUPV4	MV	35049	16883	0	2	1062	15819	9440	6379
SUPV4	ED	9045	7574	0	1	556	7017	4985	2032
SUPV4	TO	44094	24457	0	3	1618	22836	14425	8411
SUPV5	MV	41966	21520	0	1	1682	19837	15750	4087
SUPV5	ED	10934	11548	0	1	1020	10527	8700	1827
SUPV5	TO	52900	33068	0	2	2702	30364	24450	5914
SUPV6	MV	35755	15237	0	2	1249	13986	10240	3746
SUPV6	ED	7940	5858	0	1	616	5241	4123	1118
SUPV6	TO	43695	21095	0	3	1865	19227	14363	4864
SUPV7	MV	38887	20739	0	7	1277	19455	12273	7182
SUPV7	ED	8556	7372	0	0	426	6946	4777	2169
SUPV7	TO	47443	28111	0	7	1703	26401	17050	9351
SUPV8	MV	46370	27513	0	5	2000	25508	19290	6218
SUPV8	ED	11807	11215	0	4	757	10454	8363	2091
SUPV8	TO	58177	38728	0	9	2757	35962	27653	8309
SUPV9	MV	33165	16788	0	1	1055	15732	12029	3703
SUPV9	ED	10098	7144	0	0	406	6738	5580	1158
SUPV9	TO	43263	23932	0	1	1461	22470	17609	4861
SUPV10	MV	33765	14063	0	2	963	13098	9072	4026
SUPV10	ED	9348	4282	0	0	317	3965	3119	846
SUPV10	TO	43113	18345	0	2	1280	17063	12191	4872
SUPV11	MV	30643	13440	0	5	717	12718	8106	4612
SUPV11	ED	8032	4053	0	0	243	3810	2862	948
SUPV11	TO	38675	17493	0	5	960	16528	10968	5560
NEIG1	MV	15464	5944	0	1	397	5546	3784	1762
NEIG1	ED	5021	1583	0	0	93	1490	1189	301
NEIG1	TO	20485	7527	0	1	490	7036	4973	2063
NEIG2	MV	14029	6280	0	0	625	5655	3784	1871
NEIG2	ED	3238	2815	0	2	314	2499	1882	617
NEIG2	TO	17267	9095	0	2	939	8154	5666	2488
NEIG3	MV	22050	9508	0	4	809	8695	6657	2038
NEIG3	ED	5969	4204	0	1	388	3815	3093	722
NEIG3	TO	28019	13712	0	5	1197	12510	9750	2760
NEIG4	MV	5630	3494	0	0	232	3262	2288	974
NEIG4	ED	1430	1249	0	1	87	1161	838	323
NEIG4	TO	7060	4743	0	1	319	4423	3126	1297
NEIG5	MV	22700	10125	0	1	570	9554	6070	3484
NEIG5	ED	5893	3002	0	0	183	2819	2082	737
NEIG5	TO	28593	13127	0	1	753	12373	8152	4221
NEIG6	MV	11526	5973	0	1	438	5534	4471	1063
NEIG6	ED	2336	3502	0	1	305	3196	2697	499
NEIG6	TO	13862	9475	0	2	743	8730	7168	1562
NEIG7	MV	9818	4131	0	4	191	3936	2535	1401
NEIG7	ED	2577	1320	0	0	72	1248	975	273
NEIG7	TO	12395	5451	0	4	263	5184	3510	1674
NEIG8	MV	7628	4028	0	0	309	3719	2878	841
NEIG8	ED	2030	2242	0	0	174	2068	1650	418
NEIG8	TO	9658	6270	0	0	483	5787	4528	1259
NEIG9	MV	7416	3142	0	1	189	2952	1970	982
NEIG9	ED	842	939	0	0	70	869	638	231
NEIG9	TO	8258	4081	0	1	259	3821	2608	1213
NEIG10	MV	8172	3953	0	0	307	3646	2567	1079
NEIG10	ED	1850	2034	0	0	170	1864	1415	449
NEIG10	TO	10022	5987	0	0	477	5510	3982	1528
NEIG11	MV	33509	15534	0	6	1474	14054	9121	4933
NEIG11	ED	5931	7964	0	0	967	6997	4829	2168
NEIG11	TO	39440	23498	0	6	2441	21051	13950	7101
NEIG12	MV	23572	11865	0	0	783	11082	9079	2003
NEIG12	ED	7433	5385	0	0	358	5027	4307	720
NEIG12	TO	31005	17250	0	0	1141	16109	13386	2723
NEIG14	MV	6791	3992	0	0	270	3722	2960	762
NEIG14	ED	1942	1795	0	0	84	1711	1424	287
NEIG14	TO	8733	5787	0	0	354	5433	4384	1049
NEIG15	MV	5779	2678	0	1	180	2497	1656	841
NEIG15	ED	1309	1197	0	2	112	1083	830	253
NEIG15	TO	7088	3875	0	3	292	3580	2486	1094
NEIG13	MV	13553	8168	0	2	621	7545	5582	1963
NEIG13	ED	3435	3395	0	0	216	3179	2494	685
NEIG13	TO	16988	11563	0	2	837	10724	8076	2648
NEIG26	MV	7830	3526	0	1	206	3319	1921	1398
NEIG26	ED	1802	958	0	0	51	907	637	270
NEIG26	TO	9632	4484	0	1	257	4226	2558	1668
NEIG16	MV	14623	6960	0	1	580	6379	4609	1770
NEIG16	ED	2733	2592	0	0	250	2342	1855	487
NEIG16	TO	17356	9552	0	1	830	8721	6464	2257
NEIG17	MV	29447	14415	0	2	999	13414	9152	4262
NEIG17	ED	8178	7576	0	0	586	6990	5250	1740
NEIG17	TO	37625	21991	0	2	1585	20404	14402	6002
NEIG19	MV	7165	4024	0	1	254	3769	2897	872
NEIG19	ED	2406	1880	0	0	108	1772	1437	335
NEIG19	TO	9571	5904	0	1	362	5541	4334	1207
NEIG18	MV	6458	3414	0	2	259	3153	2003	1150
NEIG18	ED	1563	1848	0	0	169	1679	1155	524
NEIG18	TO	8021	5262	0	2	428	4832	3158	1674
NEIG20	MV	20910	8912	0	1	711	8200	5835	2365
NEIG20	ED	4167	3399	0	0	370	3029	2301	728
NEIG20	TO	25077	12311	0	1	1081	11229	8136	3093
NEIG21	MV	34606	16657	0	2	1042	15613	9283	6330
NEIG21	ED	8887	7428	0	1	550	6877	4868	2009
NEIG21	TO	43493	24085	0	3	1592	22490	14151	8339
NEIG22	MV	15381	9297	0	2	672	8623	6582	2041
NEIG22	ED	3512	3650	0	3	247	3400	2744	656
NEIG22	TO	18893	12947	0	5	919	12023	9326	2697
NEIG23	MV	6638	2511	0	0	137	2374	1454	920
NEIG23	ED	1850	604	0	0	48	556	407	149
NEIG23	TO	8488	3115	0	0	185	2930	1861	1069
NEIG24	MV	28439	16112	0	6	1004	15102	9345	5757
NEIG24	ED	6935	5821	0	0	327	5494	3682	1812
NEIG24	TO	35374	21933	0	6	1331	20596	13027	7569
NEIG25	MV	23712	12546	0	0	1002	11544	9197	2347
NEIG25	ED	7784	6202	0	0	554	5648	4670	978
NEIG25	TO	31496	18748	0	0	1556	17192	13867	3325
