area_id	subtotal_type	RSReg	RSCst	RSRej	RSOvr	RSUnd	RSTot	3:YES	4:NO
ALLPCTS	TO	503899	144603	0	25	9779	134799	95380	39419
ALLPCTS	ED	503899	72177	0	9	5086	67082	51209	15873
ALLPCTS	MV	503899	72426	0	16	4693	67717	44171	23546
PCT1101	MV	562	89	0	0	9	80	50	30
PCT1101	ED	562	60	0	0	3	57	45	12
PCT1101	TO	562	149	0	0	12	137	95	42
PCT1102	MV	1004	120	0	0	4	116	72	44
PCT1102	ED	1004	158	0	0	10	148	106	42
PCT1102	TO	1004	278	0	0	14	264	178	86
PCT1103	MV	971	147	0	0	2	145	87	58
PCT1103	ED	971	142	0	0	6	136	103	33
PCT1103	TO	971	289	0	0	8	281	190	91
PCT1104	MV	1018	122	0	0	3	119	89	30
PCT1104	ED	1018	119	0	0	5	114	84	30
PCT1104	TO	1018	241	0	0	8	233	173	60
PCT1106	MV	771	93	0	0	3	90	41	49
PCT1106	ED	771	96	0	0	5	91	68	23
PCT1106	TO	771	189	0	0	8	181	109	72
PCT1107	MV	751	100	0	0	4	96	57	39
PCT1107	ED	751	76	0	0	5	71	53	18
PCT1107	TO	751	176	0	0	9	167	110	57
PCT1108	MV	923	117	0	0	7	110	69	41
PCT1108	ED	923	114	0	0	12	102	73	29
PCT1108	TO	923	231	0	0	19	212	142	70
PCT1109	MV	822	108	0	0	6	102	46	56
PCT1109	ED	822	97	0	0	4	93	71	22
PCT1109	TO	822	205	0	0	10	195	117	78
PCT1111	MV	1046	150	0	0	5	145	89	56
PCT1111	ED	1046	118	0	0	4	114	91	23
PCT1111	TO	1046	268	0	0	9	259	180	79
PCT1112	MV	802	100	0	0	7	93	58	35
PCT1112	ED	802	76	0	0	4	72	57	15
PCT1112	TO	802	176	0	0	11	165	115	50
PCT1113	MV	795	102	0	0	5	97	63	34
PCT1113	ED	795	65	0	0	6	59	44	15
PCT1113	TO	795	167	0	0	11	156	107	49
PCT1114	MV	991	102	0	0	5	97	70	27
PCT1114	ED	991	97	0	0	10	87	72	15
PCT1114	TO	991	199	0	0	15	184	142	42
PCT1115	MV	936	114	0	0	5	109	65	44
PCT1115	ED	936	85	0	0	3	82	67	15
PCT1115	TO	936	199	0	0	8	191	132	59
PCT1116	MV	931	141	0	0	10	131	85	46
PCT1116	ED	931	118	0	0	6	112	95	17
PCT1116	TO	931	259	0	0	16	243	180	63
PCT1117	MV	846	103	0	0	3	100	51	49
PCT1117	ED	846	71	0	0	2	69	53	16
PCT1117	TO	846	174	0	0	5	169	104	65
PCT1118	MV	1065	123	0	1	5	117	68	49
PCT1118	ED	1065	100	0	0	8	92	64	28
PCT1118	TO	1065	223	0	1	13	209	132	77
PCT1119	MV	797	114	0	0	3	111	69	42
PCT1119	ED	797	73	0	0	4	69	58	11
PCT1119	TO	797	187	0	0	7	180	127	53
PCT1121	MV	705	115	0	0	6	109	58	51
PCT1121	ED	705	81	0	0	6	75	47	28
PCT1121	TO	705	196	0	0	12	184	105	79
PCT1122	MV	637	67	0	0	5	62	30	32
PCT1122	ED	637	70	0	0	4	66	50	16
PCT1122	TO	637	137	0	0	9	128	80	48
PCT1123	MV	938	77	0	0	1	76	46	30
PCT1123	ED	938	89	0	0	6	83	66	17
PCT1123	TO	938	166	0	0	7	159	112	47
PCT1124	MV	829	96	0	2	2	92	45	47
PCT1124	ED	829	72	0	0	3	69	59	10
PCT1124	TO	829	168	0	2	5	161	104	57
PCT1125	MV	1097	154	0	0	14	140	79	61
PCT1125	ED	1097	65	0	0	6	59	49	10
PCT1125	TO	1097	219	0	0	20	199	128	71
PCT1126	MV	1012	149	0	0	9	140	95	45
PCT1126	ED	1012	68	0	0	3	65	49	16
PCT1126	TO	1012	217	0	0	12	205	144	61
PCT1127	MV	965	123	0	0	5	118	62	56
PCT1127	ED	965	99	0	0	3	96	69	27
PCT1127	TO	965	222	0	0	8	214	131	83
PCT1128	MV	879	111	0	0	4	107	56	51
PCT1128	ED	879	59	0	0	4	55	41	14
PCT1128	TO	879	170	0	0	8	162	97	65
PCT1129	MV	1036	129	0	0	3	126	81	45
PCT1129	ED	1036	108	0	0	13	95	68	27
PCT1129	TO	1036	237	0	0	16	221	149	72
PCT1131	MV	860	103	0	0	11	92	47	45
PCT1131	ED	860	60	0	0	4	56	46	10
PCT1131	TO	860	163	0	0	15	148	93	55
PCT1132	MV	1032	152	0	0	9	143	83	60
PCT1132	ED	1032	59	0	0	0	59	29	30
PCT1132	TO	1032	211	0	0	9	202	112	90
PCT1133	MV	875	140	0	0	3	137	78	59
PCT1133	ED	875	74	0	0	3	71	48	23
PCT1133	TO	875	214	0	0	6	208	126	82
PCT1134	MV	767	122	0	0	5	117	56	61
PCT1134	ED	767	80	0	0	8	72	61	11
PCT1134	TO	767	202	0	0	13	189	117	72
PCT1135	MV	556	83	0	0	3	80	46	34
PCT1135	ED	556	50	0	0	1	49	32	17
PCT1135	TO	556	133	0	0	4	129	78	51
PCT1136	MV	867	152	0	0	8	144	81	63
PCT1136	ED	867	77	0	0	9	68	51	17
PCT1136	TO	867	229	0	0	17	212	132	80
PCT1141	MV	1056	144	0	0	4	140	87	53
PCT1141	ED	1056	123	0	0	3	120	87	33
PCT1141	TO	1056	267	0	0	7	260	174	86
PCT1142	MV	896	111	0	0	9	102	67	35
PCT1142	ED	896	87	0	0	3	84	72	12
PCT1142	TO	896	198	0	0	12	186	139	47
PCT1143	MV	1049	152	0	0	9	143	92	51
PCT1143	ED	1049	113	0	0	6	107	88	19
PCT1143	TO	1049	265	0	0	15	250	180	70
PCT1144	MV	947	110	0	0	7	103	59	44
PCT1144	ED	947	121	0	0	10	111	80	31
PCT1144	TO	947	231	0	0	17	214	139	75
PCT1145	MV	905	146	0	0	10	136	84	52
PCT1145	ED	905	114	0	0	5	109	79	30
PCT1145	TO	905	260	0	0	15	245	163	82
PCT1146	MV	1054	143	0	0	9	134	84	50
PCT1146	ED	1054	109	0	0	6	103	79	24
PCT1146	TO	1054	252	0	0	15	237	163	74
PCT1147	MV	885	100	0	0	3	97	59	38
PCT1147	ED	885	107	0	0	5	102	76	26
PCT1147	TO	885	207	0	0	8	199	135	64
PCT1148	MV	1028	148	0	0	4	144	91	53
PCT1148	ED	1028	116	0	0	6	110	82	28
PCT1148	TO	1028	264	0	0	10	254	173	81
PCT1149	MV	939	107	0	0	5	102	67	35
PCT1149	ED	939	118	0	0	9	109	80	29
PCT1149	TO	939	225	0	0	14	211	147	64
PCT1151	MV	0	0	0	0	0	0	0	0
PCT1151	ED	0	0	0	0	0	0	0	0
PCT1151	TO	0	0	0	0	0	0	0	0
PCT1152	MV	890	112	0	0	5	107	79	28
PCT1152	ED	890	85	0	0	6	79	58	21
PCT1152	TO	890	197	0	0	11	186	137	49
PCT1153	MV	940	114	0	0	9	105	64	41
PCT1153	ED	940	116	0	0	7	109	64	45
PCT1153	TO	940	230	0	0	16	214	128	86
PCT1154	MV	0	0	0	0	0	0	0	0
PCT1154	ED	0	0	0	0	0	0	0	0
PCT1154	TO	0	0	0	0	0	0	0	0
PCT7001	MV	773	112	0	0	4	108	74	34
PCT7001	ED	773	101	0	0	7	94	80	14
PCT7001	TO	773	213	0	0	11	202	154	48
PCT7002	MV	714	81	0	0	8	73	44	29
PCT7002	ED	714	88	0	0	5	83	68	15
PCT7002	TO	714	169	0	0	13	156	112	44
PCT7003	MV	906	147	0	0	5	142	101	41
PCT7003	ED	906	144	0	0	12	132	99	33
PCT7003	TO	906	291	0	0	17	274	200	74
PCT7004	MV	913	146	0	0	12	134	99	35
PCT7004	ED	913	142	0	0	12	130	103	27
PCT7004	TO	913	288	0	0	24	264	202	62
PCT7005	MV	859	142	0	0	9	133	98	35
PCT7005	ED	859	162	0	0	20	142	116	26
PCT7005	TO	859	304	0	0	29	275	214	61
PCT7006	MV	932	119	0	0	7	112	83	29
PCT7006	ED	932	149	0	0	7	142	113	29
PCT7006	TO	932	268	0	0	14	254	196	58
PCT7007	MV	957	145	0	0	9	136	86	50
PCT7007	ED	957	168	0	0	14	154	125	29
PCT7007	TO	957	313	0	0	23	290	211	79
PCT7008	MV	909	154	0	0	15	139	94	45
PCT7008	ED	909	189	0	0	11	178	138	40
PCT7008	TO	909	343	0	0	26	317	232	85
PCT7009	MV	871	141	0	0	9	132	81	51
PCT7009	ED	871	91	0	0	4	87	58	29
PCT7009	TO	871	232	0	0	13	219	139	80
PCT7011	MV	973	66	0	0	4	62	47	15
PCT7011	ED	973	87	0	0	4	83	67	16
PCT7011	TO	973	153	0	0	8	145	114	31
PCT7012	MV	1226	192	0	0	15	177	124	53
PCT7012	ED	1226	203	0	0	17	186	150	36
PCT7012	TO	1226	395	0	0	32	363	274	89
PCT7013	MV	1139	122	0	0	3	119	89	30
PCT7013	ED	1139	151	0	0	15	136	114	22
PCT7013	TO	1139	273	0	0	18	255	203	52
PCT7014	MV	719	90	0	0	9	81	61	20
PCT7014	ED	719	111	0	0	15	96	81	15
PCT7014	TO	719	201	0	0	24	177	142	35
PCT7015	MV	110	13	0	0	2	11	11	0
PCT7015	ED	110	0	0	0	0	0	0	0
PCT7015	TO	110	13	0	0	2	11	11	0
PCT7016	MV	932	85	0	0	3	82	61	21
PCT7016	ED	932	75	0	0	6	69	55	14
PCT7016	TO	932	160	0	0	9	151	116	35
PCT7017	MV	781	52	0	0	3	49	38	11
PCT7017	ED	781	53	0	0	6	47	42	5
PCT7017	TO	781	105	0	0	9	96	80	16
PCT7018	MV	1047	130	0	0	11	119	81	38
PCT7018	ED	1047	56	0	0	4	52	47	5
PCT7018	TO	1047	186	0	0	15	171	128	43
PCT7019	MV	900	130	0	0	7	123	73	50
PCT7019	ED	900	73	0	0	8	65	54	11
PCT7019	TO	900	203	0	0	15	188	127	61
PCT7021	MV	967	78	0	0	5	73	52	21
PCT7021	ED	967	106	0	0	7	99	86	13
PCT7021	TO	967	184	0	0	12	172	138	34
PCT7022	MV	963	109	0	0	6	103	87	16
PCT7022	ED	963	54	0	0	1	53	44	9
PCT7022	TO	963	163	0	0	7	156	131	25
PCT7023	MV	920	142	0	0	5	137	94	43
PCT7023	ED	920	71	0	0	5	66	54	12
PCT7023	TO	920	213	0	0	10	203	148	55
PCT7024	MV	441	25	0	0	1	24	23	1
PCT7024	ED	441	20	0	0	3	17	17	0
PCT7024	TO	441	45	0	0	4	41	40	1
PCT7025	MV	483	41	0	0	1	40	37	3
PCT7025	ED	483	39	0	0	1	38	32	6
PCT7025	TO	483	80	0	0	2	78	69	9
PCT7026	MV	1010	137	0	0	5	132	72	60
PCT7026	ED	1010	72	0	0	3	69	54	15
PCT7026	TO	1010	209	0	0	8	201	126	75
PCT7027	MV	896	96	0	0	4	92	56	36
PCT7027	ED	896	96	0	0	4	92	73	19
PCT7027	TO	896	192	0	0	8	184	129	55
PCT7028	MV	856	85	0	0	4	81	61	20
PCT7028	ED	856	97	0	0	5	92	75	17
PCT7028	TO	856	182	0	0	9	173	136	37
PCT7029	MV	909	80	0	0	3	77	57	20
PCT7029	ED	909	39	0	0	1	38	31	7
PCT7029	TO	909	119	0	0	4	115	88	27
PCT7030	MV	795	128	0	0	4	124	61	63
PCT7030	ED	795	58	0	0	3	55	30	25
PCT7030	TO	795	186	0	0	7	179	91	88
PCT7031	MV	694	119	0	0	13	106	67	39
PCT7031	ED	694	48	0	0	4	44	32	12
PCT7031	TO	694	167	0	0	17	150	99	51
PCT7032	MV	881	112	0	0	9	103	65	38
PCT7032	ED	881	51	0	0	2	49	42	7
PCT7032	TO	881	163	0	0	11	152	107	45
PCT7033	MV	778	96	0	0	5	91	56	35
PCT7033	ED	778	86	0	0	5	81	63	18
PCT7033	TO	778	182	0	0	10	172	119	53
PCT7034	MV	938	52	0	0	5	47	41	6
PCT7034	ED	938	57	0	0	3	54	47	7
PCT7034	TO	938	109	0	0	8	101	88	13
PCT7035	MV	719	86	0	0	8	78	52	26
PCT7035	ED	719	52	0	0	5	47	39	8
PCT7035	TO	719	138	0	0	13	125	91	34
PCT7036	MV	974	108	0	0	5	103	60	43
PCT7036	ED	974	39	0	0	1	38	28	10
PCT7036	TO	974	147	0	0	6	141	88	53
PCT7037	MV	746	31	0	0	0	31	25	6
PCT7037	ED	746	38	0	0	5	33	32	1
PCT7037	TO	746	69	0	0	5	64	57	7
PCT7038	MV	961	145	0	0	10	135	76	59
PCT7038	ED	961	58	0	0	8	50	39	11
PCT7038	TO	961	203	0	0	18	185	115	70
PCT7039	MV	837	106	0	0	9	97	55	42
PCT7039	ED	837	104	0	0	5	99	63	36
PCT7039	TO	837	210	0	0	14	196	118	78
PCT7041	MV	66	13	0	0	1	12	6	6
PCT7041	ED	66	0	0	0	0	0	0	0
PCT7041	TO	66	13	0	0	1	12	6	6
PCT7042	MV	660	88	0	0	4	84	54	30
PCT7042	ED	660	58	0	0	2	56	41	15
PCT7042	TO	660	146	0	0	6	140	95	45
PCT7043	MV	978	116	0	0	5	111	74	37
PCT7043	ED	978	78	0	0	1	77	53	24
PCT7043	TO	978	194	0	0	6	188	127	61
PCT7044	MV	852	67	0	0	1	66	42	24
PCT7044	ED	852	33	0	0	2	31	26	5
PCT7044	TO	852	100	0	0	3	97	68	29
PCT7045	MV	786	120	0	0	9	111	76	35
PCT7045	ED	786	53	0	0	3	50	36	14
PCT7045	TO	786	173	0	0	12	161	112	49
PCT7046	MV	430	45	0	0	3	42	25	17
PCT7046	ED	430	48	0	0	3	45	34	11
PCT7046	TO	430	93	0	0	6	87	59	28
PCT7047	MV	883	135	0	0	5	130	66	64
PCT7047	ED	883	62	0	0	3	59	46	13
PCT7047	TO	883	197	0	0	8	189	112	77
PCT7048	MV	881	108	0	0	8	100	73	27
PCT7048	ED	881	56	0	0	4	52	41	11
PCT7048	TO	881	164	0	0	12	152	114	38
PCT7049	MV	826	105	0	0	2	103	57	46
PCT7049	ED	826	70	0	0	10	60	39	21
PCT7049	TO	826	175	0	0	12	163	96	67
PCT7051	MV	880	129	0	0	7	122	60	62
PCT7051	ED	880	70	0	0	6	64	45	19
PCT7051	TO	880	199	0	0	13	186	105	81
PCT7052	MV	906	121	0	0	3	118	60	58
PCT7052	ED	906	84	0	0	3	81	65	16
PCT7052	TO	906	205	0	0	6	199	125	74
PCT7053	MV	585	102	0	0	13	89	44	45
PCT7053	ED	585	40	0	0	4	36	27	9
PCT7053	TO	585	142	0	0	17	125	71	54
PCT7054	MV	1136	98	0	0	13	85	63	22
PCT7054	ED	1136	105	0	0	3	102	71	31
PCT7054	TO	1136	203	0	0	16	187	134	53
PCT7055	MV	826	120	0	0	7	113	68	45
PCT7055	ED	826	76	0	0	8	68	52	16
PCT7055	TO	826	196	0	0	15	181	120	61
PCT7056	MV	705	85	0	0	8	77	54	23
PCT7056	ED	705	119	0	0	12	107	83	24
PCT7056	TO	705	204	0	0	20	184	137	47
PCT7101	MV	147	31	0	0	1	30	26	4
PCT7101	ED	147	0	0	0	0	0	0	0
PCT7101	TO	147	31	0	0	1	30	26	4
PCT7201	MV	935	145	0	0	13	132	81	51
PCT7201	ED	935	98	0	0	12	86	64	22
PCT7201	TO	935	243	0	0	25	218	145	73
PCT7202	MV	851	136	0	0	12	124	74	50
PCT7202	ED	851	123	0	0	12	111	83	28
PCT7202	TO	851	259	0	0	24	235	157	78
PCT7203	MV	879	116	0	0	15	101	60	41
PCT7203	ED	879	148	0	0	18	130	97	33
PCT7203	TO	879	264	0	0	33	231	157	74
PCT7204	MV	899	164	0	0	20	144	97	47
PCT7204	ED	899	116	0	0	18	98	68	30
PCT7204	TO	899	280	0	0	38	242	165	77
PCT7205	MV	871	132	0	0	10	122	79	43
PCT7205	ED	871	133	0	0	16	117	86	31
PCT7205	TO	871	265	0	0	26	239	165	74
PCT7206	MV	377	41	0	0	3	38	29	9
PCT7206	ED	377	76	0	0	3	73	52	21
PCT7206	TO	377	117	0	0	6	111	81	30
PCT7207	MV	867	119	0	0	7	112	72	40
PCT7207	ED	867	117	0	0	11	106	83	23
PCT7207	TO	867	236	0	0	18	218	155	63
PCT7208	MV	570	92	0	0	15	77	52	25
PCT7208	ED	570	60	0	0	5	55	47	8
PCT7208	TO	570	152	0	0	20	132	99	33
PCT7209	MV	647	199	0	0	16	183	121	62
PCT7209	ED	647	63	0	0	4	59	46	13
PCT7209	TO	647	262	0	0	20	242	167	75
PCT7301	MV	1014	129	0	0	8	121	78	43
PCT7301	ED	1014	112	0	0	8	104	76	28
PCT7301	TO	1014	241	0	0	16	225	154	71
PCT7302	MV	849	175	0	0	14	161	105	56
PCT7302	ED	849	116	0	0	10	106	79	27
PCT7302	TO	849	291	0	0	24	267	184	83
PCT7303	MV	1068	148	0	0	4	144	90	54
PCT7303	ED	1068	141	0	0	10	131	108	23
PCT7303	TO	1068	289	0	0	14	275	198	77
PCT7304	MV	1001	137	0	0	13	124	68	56
PCT7304	ED	1001	163	0	0	11	152	117	35
PCT7304	TO	1001	300	0	0	24	276	185	91
PCT7305	MV	867	162	0	0	10	152	83	69
PCT7305	ED	867	141	0	0	8	133	96	37
PCT7305	TO	867	303	0	0	18	285	179	106
PCT7306	MV	1044	122	0	0	11	111	62	49
PCT7306	ED	1044	152	0	0	15	137	106	31
PCT7306	TO	1044	274	0	0	26	248	168	80
PCT7307	MV	774	96	0	0	7	89	56	33
PCT7307	ED	774	101	0	0	10	91	69	22
PCT7307	TO	774	197	0	0	17	180	125	55
PCT7308	MV	625	106	0	0	4	102	65	37
PCT7308	ED	625	126	0	1	8	117	88	29
PCT7308	TO	625	232	0	1	12	219	153	66
PCT7309	MV	858	116	0	0	8	108	69	39
PCT7309	ED	858	156	0	0	12	144	111	33
PCT7309	TO	858	272	0	0	20	252	180	72
PCT7311	MV	906	107	0	0	12	95	63	32
PCT7311	ED	906	169	0	0	11	158	130	28
PCT7311	TO	906	276	0	0	23	253	193	60
PCT7312	MV	810	150	0	0	9	141	90	51
PCT7312	ED	810	120	0	0	8	112	78	34
PCT7312	TO	810	270	0	0	17	253	168	85
PCT7313	MV	1003	173	0	0	10	163	95	68
PCT7313	ED	1003	115	0	0	16	99	71	28
PCT7313	TO	1003	288	0	0	26	262	166	96
PCT7314	MV	759	124	0	0	13	111	78	33
PCT7314	ED	759	56	0	0	5	51	39	12
PCT7314	TO	759	180	0	0	18	162	117	45
PCT7315	MV	765	82	0	0	5	77	47	30
PCT7315	ED	765	117	0	0	5	112	87	25
PCT7315	TO	765	199	0	0	10	189	134	55
PCT7316	MV	832	119	0	0	15	104	72	32
PCT7316	ED	832	100	0	0	15	85	68	17
PCT7316	TO	832	219	0	0	30	189	140	49
PCT7317	MV	890	146	0	0	10	136	80	56
PCT7317	ED	890	107	0	0	14	93	79	14
PCT7317	TO	890	253	0	0	24	229	159	70
PCT7318	MV	723	142	0	0	17	125	76	49
PCT7318	ED	723	99	0	0	15	84	51	33
PCT7318	TO	723	241	0	0	32	209	127	82
PCT7319	MV	1049	111	0	0	7	104	62	42
PCT7319	ED	1049	113	0	1	15	97	66	31
PCT7319	TO	1049	224	0	1	22	201	128	73
PCT7321	MV	659	86	0	0	11	75	45	30
PCT7321	ED	659	62	0	0	5	57	41	16
PCT7321	TO	659	148	0	0	16	132	86	46
PCT7322	MV	888	164	0	0	22	142	105	37
PCT7322	ED	888	25	0	0	3	22	20	2
PCT7322	TO	888	189	0	0	25	164	125	39
PCT7323	MV	956	128	0	0	13	115	75	40
PCT7323	ED	956	126	0	0	12	114	91	23
PCT7323	TO	956	254	0	0	25	229	166	63
PCT7324	MV	737	89	0	0	8	81	50	31
PCT7324	ED	737	88	0	0	10	78	50	28
PCT7324	TO	737	177	0	0	18	159	100	59
PCT7325	MV	886	115	0	0	11	104	66	38
PCT7325	ED	886	121	0	0	10	111	81	30
PCT7325	TO	886	236	0	0	21	215	147	68
PCT7326	MV	859	105	0	0	9	96	64	32
PCT7326	ED	859	116	0	1	18	97	70	27
PCT7326	TO	859	221	0	1	27	193	134	59
PCT7327	MV	687	130	0	0	15	115	81	34
PCT7327	ED	687	37	0	0	1	36	30	6
PCT7327	TO	687	167	0	0	16	151	111	40
PCT7328	MV	1002	188	0	0	31	157	101	56
PCT7328	ED	1002	46	0	0	5	41	31	10
PCT7328	TO	1002	234	0	0	36	198	132	66
PCT7329	MV	651	125	0	0	16	109	69	40
PCT7329	ED	651	56	0	0	5	51	37	14
PCT7329	TO	651	181	0	0	21	160	106	54
PCT7331	MV	870	171	0	0	14	157	96	61
PCT7331	ED	870	129	0	0	15	114	80	34
PCT7331	TO	870	300	0	0	29	271	176	95
PCT7332	MV	790	101	0	0	8	93	73	20
PCT7332	ED	790	113	0	0	4	109	90	19
PCT7332	TO	790	214	0	0	12	202	163	39
PCT7333	MV	1015	143	0	0	17	126	81	45
PCT7333	ED	1015	161	0	0	11	150	116	34
PCT7333	TO	1015	304	0	0	28	276	197	79
PCT7334	MV	819	117	0	0	5	112	82	30
PCT7334	ED	819	105	0	0	6	99	78	21
PCT7334	TO	819	222	0	0	11	211	160	51
PCT7335	MV	934	145	0	0	11	134	78	56
PCT7335	ED	934	144	0	0	11	133	106	27
PCT7335	TO	934	289	0	0	22	267	184	83
PCT7336	MV	954	147	0	0	9	138	73	65
PCT7336	ED	954	128	0	0	15	113	81	32
PCT7336	TO	954	275	0	0	24	251	154	97
PCT7337	MV	897	167	0	0	16	151	86	65
PCT7337	ED	897	84	0	0	4	80	57	23
PCT7337	TO	897	251	0	0	20	231	143	88
PCT7338	MV	895	189	0	0	17	172	101	71
PCT7338	ED	895	70	0	0	7	63	51	12
PCT7338	TO	895	259	0	0	24	235	152	83
PCT7339	MV	755	116	0	0	4	112	85	27
PCT7339	ED	755	89	0	0	4	85	67	18
PCT7339	TO	755	205	0	0	8	197	152	45
PCT7341	MV	853	100	0	0	9	91	60	31
PCT7341	ED	853	131	0	0	8	123	100	23
PCT7341	TO	853	231	0	0	17	214	160	54
PCT7342	MV	904	117	0	0	8	109	79	30
PCT7342	ED	904	200	0	0	17	183	146	37
PCT7342	TO	904	317	0	0	25	292	225	67
PCT7343	MV	704	88	0	0	5	83	70	13
PCT7343	ED	704	116	0	0	11	105	88	17
PCT7343	TO	704	204	0	0	16	188	158	30
PCT7344	MV	1064	151	0	0	9	142	95	47
PCT7344	ED	1064	160	0	0	9	151	108	43
PCT7344	TO	1064	311	0	0	18	293	203	90
PCT7345	MV	1114	159	0	0	14	145	104	41
PCT7345	ED	1114	170	0	0	11	159	126	33
PCT7345	TO	1114	329	0	0	25	304	230	74
PCT7346	MV	889	111	0	0	3	108	81	27
PCT7346	ED	889	126	0	0	12	114	95	19
PCT7346	TO	889	237	0	0	15	222	176	46
PCT7347	MV	1003	152	0	1	13	138	119	19
PCT7347	ED	1003	98	0	0	6	92	79	13
PCT7347	TO	1003	250	0	1	19	230	198	32
PCT7348	MV	843	122	0	0	8	114	86	28
PCT7348	ED	843	100	0	0	7	93	75	18
PCT7348	TO	843	222	0	0	15	207	161	46
PCT7349	MV	912	158	0	0	11	147	103	44
PCT7349	ED	912	104	0	0	9	95	75	20
PCT7349	TO	912	262	0	0	20	242	178	64
PCT7501	MV	551	75	0	0	4	71	37	34
PCT7501	ED	551	90	0	0	10	80	58	22
PCT7501	TO	551	165	0	0	14	151	95	56
PCT7502	MV	789	107	0	0	8	99	63	36
PCT7502	ED	789	99	0	0	10	89	65	24
PCT7502	TO	789	206	0	0	18	188	128	60
PCT7503	MV	762	112	0	0	8	104	80	24
PCT7503	ED	762	100	0	0	12	88	70	18
PCT7503	TO	762	212	0	0	20	192	150	42
PCT7504	MV	488	72	0	0	7	65	46	19
PCT7504	ED	488	52	0	0	4	48	35	13
PCT7504	TO	488	124	0	0	11	113	81	32
PCT7505	MV	862	198	0	0	14	184	145	39
PCT7505	ED	862	96	0	0	3	93	77	16
PCT7505	TO	862	294	0	0	17	277	222	55
PCT7506	MV	1000	122	0	0	13	109	75	34
PCT7506	ED	1000	111	0	0	9	102	87	15
PCT7506	TO	1000	233	0	0	22	211	162	49
PCT7507	MV	956	120	0	0	5	115	93	22
PCT7507	ED	956	95	0	0	4	91	79	12
PCT7507	TO	956	215	0	0	9	206	172	34
PCT7508	MV	744	164	0	0	18	146	106	40
PCT7508	ED	744	103	0	0	7	96	80	16
PCT7508	TO	744	267	0	0	25	242	186	56
PCT7509	MV	929	180	0	0	13	167	126	41
PCT7509	ED	929	145	0	0	9	136	107	29
PCT7509	TO	929	325	0	0	22	303	233	70
PCT7512	MV	600	102	0	0	9	93	63	30
PCT7512	ED	600	85	0	0	9	76	62	14
PCT7512	TO	600	187	0	0	18	169	125	44
PCT7513	MV	806	100	0	0	12	88	71	17
PCT7513	ED	806	107	0	0	13	94	82	12
PCT7513	TO	806	207	0	0	25	182	153	29
PCT7514	MV	916	110	0	0	12	98	74	24
PCT7514	ED	916	59	0	0	11	48	43	5
PCT7514	TO	916	169	0	0	23	146	117	29
PCT7515	MV	864	83	0	0	5	78	55	23
PCT7515	ED	864	90	0	0	11	79	69	10
PCT7515	TO	864	173	0	0	16	157	124	33
PCT7516	MV	920	175	0	0	12	163	121	42
PCT7516	ED	920	118	0	0	3	115	85	30
PCT7516	TO	920	293	0	0	15	278	206	72
PCT7517	MV	868	128	0	0	7	121	93	28
PCT7517	ED	868	179	0	0	9	170	141	29
PCT7517	TO	868	307	0	0	16	291	234	57
PCT7518	MV	926	105	0	0	8	97	72	25
PCT7518	ED	926	185	0	0	14	171	150	21
PCT7518	TO	926	290	0	0	22	268	222	46
PCT7519	MV	715	66	0	0	7	59	47	12
PCT7519	ED	715	136	0	0	7	129	106	23
PCT7519	TO	715	202	0	0	14	188	153	35
PCT7521	MV	779	100	0	1	7	92	83	9
PCT7521	ED	779	149	0	0	4	145	121	24
PCT7521	TO	779	249	0	1	11	237	204	33
PCT7522	MV	759	88	0	0	6	82	69	13
PCT7522	ED	759	158	0	0	14	144	124	20
PCT7522	TO	759	246	0	0	20	226	193	33
PCT7523	MV	744	79	0	0	11	68	54	14
PCT7523	ED	744	169	0	0	8	161	130	31
PCT7523	TO	744	248	0	0	19	229	184	45
PCT7524	MV	624	75	0	0	10	65	53	12
PCT7524	ED	624	102	0	0	7	95	81	14
PCT7524	TO	624	177	0	0	17	160	134	26
PCT7525	MV	764	74	0	0	5	69	54	15
PCT7525	ED	764	94	0	0	7	87	81	6
PCT7525	TO	764	168	0	0	12	156	135	21
PCT7526	MV	988	134	0	0	15	119	93	26
PCT7526	ED	988	147	0	0	14	133	105	28
PCT7526	TO	988	281	0	0	29	252	198	54
PCT7527	MV	710	93	0	0	4	89	70	19
PCT7527	ED	710	112	0	0	4	108	88	20
PCT7527	TO	710	205	0	0	8	197	158	39
PCT7529	MV	903	103	0	0	5	98	80	18
PCT7529	ED	903	185	0	0	7	178	153	25
PCT7529	TO	903	288	0	0	12	276	233	43
PCT7531	MV	873	80	0	0	6	74	60	14
PCT7531	ED	873	132	0	0	4	128	104	24
PCT7531	TO	873	212	0	0	10	202	164	38
PCT7532	MV	835	100	0	0	5	95	64	31
PCT7532	ED	835	126	0	0	10	116	82	34
PCT7532	TO	835	226	0	0	15	211	146	65
PCT7533	MV	970	117	0	0	8	109	93	16
PCT7533	ED	970	185	0	0	18	167	141	26
PCT7533	TO	970	302	0	0	26	276	234	42
PCT7534	MV	903	104	0	0	5	99	75	24
PCT7534	ED	903	177	0	0	16	161	147	14
PCT7534	TO	903	281	0	0	21	260	222	38
PCT7535	MV	745	91	0	0	8	83	63	20
PCT7535	ED	745	151	0	0	17	134	119	15
PCT7535	TO	745	242	0	0	25	217	182	35
PCT7536	MV	833	91	0	0	4	87	67	20
PCT7536	ED	833	170	0	0	15	155	133	22
PCT7536	TO	833	261	0	0	19	242	200	42
PCT7537	MV	745	78	0	0	7	71	52	19
PCT7537	ED	745	148	0	1	8	139	115	24
PCT7537	TO	745	226	0	1	15	210	167	43
PCT7538	MV	751	100	0	0	8	92	71	21
PCT7538	ED	751	172	0	0	17	155	131	24
PCT7538	TO	751	272	0	0	25	247	202	45
PCT7539	MV	921	92	0	0	7	85	64	21
PCT7539	ED	921	187	0	0	10	177	156	21
PCT7539	TO	921	279	0	0	17	262	220	42
PCT7541	MV	770	82	0	0	4	78	57	21
PCT7541	ED	770	159	0	0	16	143	119	24
PCT7541	TO	770	241	0	0	20	221	176	45
PCT7542	MV	824	86	0	0	3	83	61	22
PCT7542	ED	824	166	0	0	6	160	133	27
PCT7542	TO	824	252	0	0	9	243	194	49
PCT7543	MV	924	108	0	0	6	102	86	16
PCT7543	ED	924	138	0	0	7	131	106	25
PCT7543	TO	924	246	0	0	13	233	192	41
PCT7544	MV	899	128	0	0	10	118	96	22
PCT7544	ED	899	159	0	0	16	143	120	23
PCT7544	TO	899	287	0	0	26	261	216	45
PCT7545	MV	895	134	0	0	8	126	105	21
PCT7545	ED	895	146	0	0	10	136	117	19
PCT7545	TO	895	280	0	0	18	262	222	40
PCT7546	MV	953	105	0	0	6	99	79	20
PCT7546	ED	953	209	0	0	16	193	155	38
PCT7546	TO	953	314	0	0	22	292	234	58
PCT7547	MV	981	131	0	0	10	121	100	21
PCT7547	ED	981	172	0	0	8	164	151	13
PCT7547	TO	981	303	0	0	18	285	251	34
PCT7548	MV	1051	150	0	0	3	147	118	29
PCT7548	ED	1051	201	0	0	10	191	161	30
PCT7548	TO	1051	351	0	0	13	338	279	59
PCT7549	MV	806	137	0	0	7	130	94	36
PCT7549	ED	806	140	0	0	15	125	104	21
PCT7549	TO	806	277	0	0	22	255	198	57
PCT7551	MV	723	76	0	0	3	73	55	18
PCT7551	ED	723	171	0	0	10	161	125	36
PCT7551	TO	723	247	0	0	13	234	180	54
PCT7552	MV	685	94	0	0	9	85	70	15
PCT7552	ED	685	127	0	0	11	116	97	19
PCT7552	TO	685	221	0	0	20	201	167	34
PCT7553	MV	191	38	0	0	0	38	28	10
PCT7553	ED	191	0	0	0	0	0	0	0
PCT7553	TO	191	38	0	0	0	38	28	10
PCT7554	MV	821	106	0	0	8	98	71	27
PCT7554	ED	821	177	0	0	14	163	120	43
PCT7554	TO	821	283	0	0	22	261	191	70
PCT7555	MV	872	126	0	0	10	116	86	30
PCT7555	ED	872	210	0	0	15	195	162	33
PCT7555	TO	872	336	0	0	25	311	248	63
PCT7556	MV	966	158	0	0	7	151	107	44
PCT7556	ED	966	165	0	0	12	153	115	38
PCT7556	TO	966	323	0	0	19	304	222	82
PCT7601	MV	677	94	0	0	3	91	76	15
PCT7601	ED	677	89	0	0	10	79	67	12
PCT7601	TO	677	183	0	0	13	170	143	27
PCT7602	MV	886	120	0	0	10	110	94	16
PCT7602	ED	886	103	0	0	8	95	83	12
PCT7602	TO	886	223	0	0	18	205	177	28
PCT7603	MV	815	119	0	0	10	109	93	16
PCT7603	ED	815	167	0	0	10	157	132	25
PCT7603	TO	815	286	0	0	20	266	225	41
PCT7604	MV	944	116	0	0	11	105	83	22
PCT7604	ED	944	133	0	0	14	119	94	25
PCT7604	TO	944	249	0	0	25	224	177	47
PCT7605	MV	661	94	0	1	6	87	70	17
PCT7605	ED	661	62	0	0	5	57	50	7
PCT7605	TO	661	156	0	1	11	144	120	24
PCT7606	MV	883	114	0	0	9	105	87	18
PCT7606	ED	883	79	0	0	6	73	66	7
PCT7606	TO	883	193	0	0	15	178	153	25
PCT7607	MV	919	119	0	0	10	109	81	28
PCT7607	ED	919	100	0	0	5	95	80	15
PCT7607	TO	919	219	0	0	15	204	161	43
PCT7608	MV	380	67	0	0	8	59	41	18
PCT7608	ED	380	19	0	0	1	18	16	2
PCT7608	TO	380	86	0	0	9	77	57	20
PCT7609	MV	884	178	0	0	22	156	120	36
PCT7609	ED	884	49	0	1	3	45	38	7
PCT7609	TO	884	227	0	1	25	201	158	43
PCT7611	MV	788	126	0	0	10	116	103	13
PCT7611	ED	788	43	0	0	1	42	36	6
PCT7611	TO	788	169	0	0	11	158	139	19
PCT7612	MV	557	95	0	0	2	93	68	25
PCT7612	ED	557	29	0	0	1	28	21	7
PCT7612	TO	557	124	0	0	3	121	89	32
PCT7613	MV	883	100	0	0	4	96	76	20
PCT7613	ED	883	86	0	0	5	81	73	8
PCT7613	TO	883	186	0	0	9	177	149	28
PCT7614	MV	916	109	0	0	10	99	82	17
PCT7614	ED	916	78	0	0	4	74	58	16
PCT7614	TO	916	187	0	0	14	173	140	33
PCT7615	MV	750	75	0	0	4	71	53	18
PCT7615	ED	750	58	0	0	4	54	44	10
PCT7615	TO	750	133	0	0	8	125	97	28
PCT7616	MV	836	77	0	0	6	71	51	20
PCT7616	ED	836	86	0	0	8	78	59	19
PCT7616	TO	836	163	0	0	14	149	110	39
PCT7617	MV	752	113	0	0	13	100	85	15
PCT7617	ED	752	42	0	0	9	33	26	7
PCT7617	TO	752	155	0	0	22	133	111	22
PCT7618	MV	914	133	0	0	6	127	89	38
PCT7618	ED	914	84	0	0	9	75	53	22
PCT7618	TO	914	217	0	0	15	202	142	60
PCT7619	MV	1107	158	0	0	11	147	104	43
PCT7619	ED	1107	117	0	0	11	106	88	18
PCT7619	TO	1107	275	0	0	22	253	192	61
PCT7621	MV	1155	177	0	0	14	163	114	49
PCT7621	ED	1155	103	0	0	9	94	72	22
PCT7621	TO	1155	280	0	0	23	257	186	71
PCT7622	MV	960	100	0	0	7	93	84	9
PCT7622	ED	960	73	0	0	10	63	55	8
PCT7622	TO	960	173	0	0	17	156	139	17
PCT7623	MV	1004	99	0	1	8	90	73	17
PCT7623	ED	1004	98	0	0	8	90	83	7
PCT7623	TO	1004	197	0	1	16	180	156	24
PCT7624	MV	875	118	0	0	5	113	89	24
PCT7624	ED	875	72	0	0	11	61	53	8
PCT7624	TO	875	190	0	0	16	174	142	32
PCT7625	MV	822	265	0	0	38	227	174	53
PCT7625	ED	822	34	0	0	1	33	27	6
PCT7625	TO	822	299	0	0	39	260	201	59
PCT7626	MV	1073	158	0	0	15	143	93	50
PCT7626	ED	1073	105	0	0	4	101	75	26
PCT7626	TO	1073	263	0	0	19	244	168	76
PCT7627	MV	524	81	0	0	6	75	43	32
PCT7627	ED	524	57	0	0	7	50	32	18
PCT7627	TO	524	138	0	0	13	125	75	50
PCT7628	MV	938	116	0	0	4	112	87	25
PCT7628	ED	938	110	0	0	5	105	87	18
PCT7628	TO	938	226	0	0	9	217	174	43
PCT7629	MV	853	100	0	0	11	89	69	20
PCT7629	ED	853	86	0	0	7	79	67	12
PCT7629	TO	853	186	0	0	18	168	136	32
PCT7631	MV	1219	164	0	0	7	157	117	40
PCT7631	ED	1219	110	0	0	8	102	80	22
PCT7631	TO	1219	274	0	0	15	259	197	62
PCT7632	MV	1171	154	0	0	6	148	105	43
PCT7632	ED	1171	128	0	0	5	123	100	23
PCT7632	TO	1171	282	0	0	11	271	205	66
PCT7633	MV	735	134	0	0	13	121	88	33
PCT7633	ED	735	96	0	0	7	89	69	20
PCT7633	TO	735	230	0	0	20	210	157	53
PCT7634	MV	890	162	0	0	12	150	114	36
PCT7634	ED	890	101	0	0	11	90	69	21
PCT7634	TO	890	263	0	0	23	240	183	57
PCT7635	MV	853	103	0	0	4	99	67	32
PCT7635	ED	853	62	0	0	3	59	43	16
PCT7635	TO	853	165	0	0	7	158	110	48
PCT7636	MV	959	130	0	0	10	120	70	50
PCT7636	ED	959	107	0	0	7	100	72	28
PCT7636	TO	959	237	0	0	17	220	142	78
PCT7637	MV	868	143	0	0	12	131	72	59
PCT7637	ED	868	98	0	0	11	87	62	25
PCT7637	TO	868	241	0	0	23	218	134	84
PCT7638	MV	889	156	0	0	5	151	80	71
PCT7638	ED	889	87	0	0	10	77	40	37
PCT7638	TO	889	243	0	0	15	228	120	108
PCT7639	MV	1022	138	0	0	13	125	71	54
PCT7639	ED	1022	132	0	0	20	112	74	38
PCT7639	TO	1022	270	0	0	33	237	145	92
PCT7641	MV	951	182	0	0	13	169	97	72
PCT7641	ED	951	92	0	0	5	87	60	27
PCT7641	TO	951	274	0	0	18	256	157	99
PCT7642	MV	765	92	0	0	6	86	59	27
PCT7642	ED	765	79	0	0	13	66	45	21
PCT7642	TO	765	171	0	0	19	152	104	48
PCT7643	MV	941	177	0	0	11	166	108	58
PCT7643	ED	941	105	0	0	12	93	70	23
PCT7643	TO	941	282	0	0	23	259	178	81
PCT7644	MV	1176	141	0	0	10	131	78	53
PCT7644	ED	1176	142	0	0	9	133	117	16
PCT7644	TO	1176	283	0	0	19	264	195	69
PCT7645	MV	656	127	0	0	8	119	78	41
PCT7645	ED	656	56	0	0	8	48	35	13
PCT7645	TO	656	183	0	0	16	167	113	54
PCT7646	MV	1153	157	0	0	13	144	78	66
PCT7646	ED	1153	133	0	0	17	116	96	20
PCT7646	TO	1153	290	0	0	30	260	174	86
PCT7647	MV	987	85	0	0	2	83	65	18
PCT7647	ED	987	79	0	0	6	73	60	13
PCT7647	TO	987	164	0	0	8	156	125	31
PCT7648	MV	2	0	0	0	0	0	0	0
PCT7648	ED	2	0	0	0	0	0	0	0
PCT7648	TO	2	0	0	0	0	0	0	0
PCT7649	MV	900	127	0	0	6	121	92	29
PCT7649	ED	900	78	0	0	6	72	57	15
PCT7649	TO	900	205	0	0	12	193	149	44
PCT7651	MV	947	124	0	0	8	116	80	36
PCT7651	ED	947	72	0	0	9	63	41	22
PCT7651	TO	947	196	0	0	17	179	121	58
PCT7652	MV	635	77	0	0	5	72	43	29
PCT7652	ED	635	86	0	0	9	77	61	16
PCT7652	TO	635	163	0	0	14	149	104	45
PCT7653	MV	839	107	0	0	18	89	67	22
PCT7653	ED	839	79	0	0	9	70	51	19
PCT7653	TO	839	186	0	0	27	159	118	41
PCT7654	MV	466	66	0	0	5	61	43	18
PCT7654	ED	466	83	0	0	9	74	62	12
PCT7654	TO	466	149	0	0	14	135	105	30
PCT7655	MV	679	92	0	0	5	87	60	27
PCT7655	ED	679	59	0	0	9	50	42	8
PCT7655	TO	679	151	0	0	14	137	102	35
PCT7656	MV	638	130	0	0	10	120	69	51
PCT7656	ED	638	40	0	0	3	37	17	20
PCT7656	TO	638	170	0	0	13	157	86	71
PCT7657	MV	598	75	0	0	8	67	37	30
PCT7657	ED	598	61	0	0	6	55	37	18
PCT7657	TO	598	136	0	0	14	122	74	48
PCT7701	MV	1064	190	0	0	16	174	121	53
PCT7701	ED	1064	173	0	0	10	163	126	37
PCT7701	TO	1064	363	0	0	26	337	247	90
PCT7702	MV	756	125	0	0	6	119	58	61
PCT7702	ED	756	103	0	0	7	96	66	30
PCT7702	TO	756	228	0	0	13	215	124	91
PCT7703	MV	174	42	0	0	1	41	32	9
PCT7703	ED	174	0	0	0	0	0	0	0
PCT7703	TO	174	42	0	0	1	41	32	9
PCT7704	MV	1002	186	0	0	13	173	86	87
PCT7704	ED	1002	173	0	0	4	169	110	59
PCT7704	TO	1002	359	0	0	17	342	196	146
PCT7705	MV	595	119	0	0	7	112	55	57
PCT7705	ED	595	110	0	0	11	99	60	39
PCT7705	TO	595	229	0	0	18	211	115	96
PCT7706	MV	866	177	0	0	12	165	100	65
PCT7706	ED	866	162	0	0	7	155	103	52
PCT7706	TO	866	339	0	0	19	320	203	117
PCT7707	MV	872	148	0	0	5	143	83	60
PCT7707	ED	872	179	0	0	8	171	103	68
PCT7707	TO	872	327	0	0	13	314	186	128
PCT7708	MV	875	182	0	0	11	171	90	81
PCT7708	ED	875	152	0	0	11	141	98	43
PCT7708	TO	875	334	0	0	22	312	188	124
PCT7709	MV	406	67	0	0	2	65	38	27
PCT7709	ED	406	90	0	0	5	85	67	18
PCT7709	TO	406	157	0	0	7	150	105	45
PCT7711	MV	811	127	0	0	6	121	66	55
PCT7711	ED	811	125	0	0	6	119	92	27
PCT7711	TO	811	252	0	0	12	240	158	82
PCT7712	MV	532	81	0	0	2	79	57	22
PCT7712	ED	532	106	0	0	8	98	71	27
PCT7712	TO	532	187	0	0	10	177	128	49
PCT7801	MV	974	162	0	0	7	155	96	59
PCT7801	ED	974	190	0	0	9	181	133	48
PCT7801	TO	974	352	0	0	16	336	229	107
PCT7802	MV	798	154	0	0	10	144	100	44
PCT7802	ED	798	157	0	0	7	150	126	24
PCT7802	TO	798	311	0	0	17	294	226	68
PCT7803	MV	831	166	0	0	5	161	98	63
PCT7803	ED	831	128	0	0	12	116	89	27
PCT7803	TO	831	294	0	0	17	277	187	90
PCT7804	MV	885	148	0	0	9	139	95	44
PCT7804	ED	885	180	0	1	18	161	126	35
PCT7804	TO	885	328	0	1	27	300	221	79
PCT7805	MV	800	142	0	0	14	128	88	40
PCT7805	ED	800	155	0	0	12	143	122	21
PCT7805	TO	800	297	0	0	26	271	210	61
PCT7806	MV	755	99	0	0	7	92	64	28
PCT7806	ED	755	152	0	0	14	138	113	25
PCT7806	TO	755	251	0	0	21	230	177	53
PCT7807	MV	827	137	0	0	5	132	103	29
PCT7807	ED	827	174	0	0	17	157	136	21
PCT7807	TO	827	311	0	0	22	289	239	50
PCT7808	MV	654	91	0	0	4	87	65	22
PCT7808	ED	654	129	0	0	11	118	95	23
PCT7808	TO	654	220	0	0	15	205	160	45
PCT7809	MV	764	132	0	0	8	124	97	27
PCT7809	ED	764	135	0	0	13	122	112	10
PCT7809	TO	764	267	0	0	21	246	209	37
PCT7811	MV	758	94	0	0	10	84	66	18
PCT7811	ED	758	155	0	0	8	147	121	26
PCT7811	TO	758	249	0	0	18	231	187	44
PCT7812	MV	897	146	0	0	13	133	105	28
PCT7812	ED	897	163	0	0	10	153	126	27
PCT7812	TO	897	309	0	0	23	286	231	55
PCT7813	MV	1068	171	0	0	12	159	122	37
PCT7813	ED	1068	214	0	0	17	197	167	30
PCT7813	TO	1068	385	0	0	29	356	289	67
PCT7814	MV	901	99	0	0	7	92	68	24
PCT7814	ED	901	118	0	0	9	109	99	10
PCT7814	TO	901	217	0	0	16	201	167	34
PCT7815	MV	917	167	0	0	17	150	104	46
PCT7815	ED	917	176	0	0	8	168	136	32
PCT7815	TO	917	343	0	0	25	318	240	78
PCT7816	MV	872	164	0	0	19	145	106	39
PCT7816	ED	872	149	0	0	7	142	105	37
PCT7816	TO	872	313	0	0	26	287	211	76
PCT7817	MV	838	149	0	0	7	142	117	25
PCT7817	ED	838	182	0	0	10	172	149	23
PCT7817	TO	838	331	0	0	17	314	266	48
PCT7818	MV	839	126	0	0	6	120	87	33
PCT7818	ED	839	149	0	0	8	141	122	19
PCT7818	TO	839	275	0	0	14	261	209	52
PCT7819	MV	774	120	0	0	9	111	85	26
PCT7819	ED	774	89	0	0	6	83	75	8
PCT7819	TO	774	209	0	0	15	194	160	34
PCT7821	MV	976	155	0	0	11	144	110	34
PCT7821	ED	976	189	0	0	9	180	129	51
PCT7821	TO	976	344	0	0	20	324	239	85
PCT7822	MV	892	140	0	1	8	131	106	25
PCT7822	ED	892	222	0	0	21	201	153	48
PCT7822	TO	892	362	0	1	29	332	259	73
PCT7823	MV	883	159	0	0	6	153	117	36
PCT7823	ED	883	188	0	0	5	183	159	24
PCT7823	TO	883	347	0	0	11	336	276	60
PCT7824	MV	768	104	0	0	4	100	68	32
PCT7824	ED	768	158	0	0	12	146	123	23
PCT7824	TO	768	262	0	0	16	246	191	55
PCT7825	MV	608	82	0	0	3	79	70	9
PCT7825	ED	608	130	0	0	4	126	106	20
PCT7825	TO	608	212	0	0	7	205	176	29
PCT7826	MV	690	82	0	0	7	75	62	13
PCT7826	ED	690	162	0	0	6	156	142	14
PCT7826	TO	690	244	0	0	13	231	204	27
PCT7827	MV	826	80	0	0	6	74	62	12
PCT7827	ED	826	145	0	0	15	130	110	20
PCT7827	TO	826	225	0	0	21	204	172	32
PCT7828	MV	1028	178	0	0	12	166	112	54
PCT7828	ED	1028	177	0	1	18	158	126	32
PCT7828	TO	1028	355	0	1	30	324	238	86
PCT7829	MV	891	151	0	0	7	144	95	49
PCT7829	ED	891	151	0	0	5	146	118	28
PCT7829	TO	891	302	0	0	12	290	213	77
PCT7831	MV	902	174	0	0	12	162	122	40
PCT7831	ED	902	137	0	0	9	128	93	35
PCT7831	TO	902	311	0	0	21	290	215	75
PCT7832	MV	781	154	0	0	13	141	106	35
PCT7832	ED	781	127	0	0	9	118	99	19
PCT7832	TO	781	281	0	0	22	259	205	54
PCT7833	MV	733	102	0	0	6	96	71	25
PCT7833	ED	733	145	0	0	17	128	107	21
PCT7833	TO	733	247	0	0	23	224	178	46
PCT7834	MV	894	109	0	0	9	100	81	19
PCT7834	ED	894	175	0	0	13	162	137	25
PCT7834	TO	894	284	0	0	22	262	218	44
PCT7835	MV	863	158	0	0	8	150	99	51
PCT7835	ED	863	147	0	0	12	135	101	34
PCT7835	TO	863	305	0	0	20	285	200	85
PCT7836	MV	1043	209	0	0	11	198	129	69
PCT7836	ED	1043	169	0	0	6	163	115	48
PCT7836	TO	1043	378	0	0	17	361	244	117
PCT7837	MV	923	140	0	0	15	125	90	35
PCT7837	ED	923	198	0	0	9	189	155	34
PCT7837	TO	923	338	0	0	24	314	245	69
PCT7838	MV	895	174	0	0	16	158	106	52
PCT7838	ED	895	155	0	0	9	146	114	32
PCT7838	TO	895	329	0	0	25	304	220	84
PCT7839	MV	861	156	0	0	10	146	105	41
PCT7839	ED	861	136	0	1	9	126	97	29
PCT7839	TO	861	292	0	1	19	272	202	70
PCT7841	MV	950	138	0	0	7	131	97	34
PCT7841	ED	950	207	0	0	8	199	159	40
PCT7841	TO	950	345	0	0	15	330	256	74
PCT7842	MV	879	114	0	0	6	108	86	22
PCT7842	ED	879	154	0	0	6	148	122	26
PCT7842	TO	879	268	0	0	12	256	208	48
PCT7843	MV	729	88	0	0	3	85	67	18
PCT7843	ED	729	163	0	0	12	151	122	29
PCT7843	TO	729	251	0	0	15	236	189	47
PCT7844	MV	651	84	0	0	6	78	67	11
PCT7844	ED	651	136	0	0	13	123	100	23
PCT7844	TO	651	220	0	0	19	201	167	34
PCT7845	MV	880	129	0	0	4	125	97	28
PCT7845	ED	880	177	0	0	14	163	127	36
PCT7845	TO	880	306	0	0	18	288	224	64
PCT7846	MV	908	147	0	0	10	137	80	57
PCT7846	ED	908	166	0	0	15	151	121	30
PCT7846	TO	908	313	0	0	25	288	201	87
PCT7847	MV	891	142	0	0	9	133	100	33
PCT7847	ED	891	181	0	0	7	174	137	37
PCT7847	TO	891	323	0	0	16	307	237	70
PCT7848	MV	847	131	0	0	3	128	93	35
PCT7848	ED	847	168	0	0	18	150	117	33
PCT7848	TO	847	299	0	0	21	278	210	68
PCT7849	MV	901	141	0	0	12	129	92	37
PCT7849	ED	901	186	0	0	15	171	141	30
PCT7849	TO	901	327	0	0	27	300	233	67
PCT7851	MV	526	113	0	0	11	102	61	41
PCT7851	ED	526	84	0	0	8	76	48	28
PCT7851	TO	526	197	0	0	19	178	109	69
PCT7852	MV	644	139	0	0	8	131	81	50
PCT7852	ED	644	103	0	0	5	98	68	30
PCT7852	TO	644	242	0	0	13	229	149	80
PCT7853	MV	855	136	0	0	12	124	86	38
PCT7853	ED	855	137	0	0	9	128	92	36
PCT7853	TO	855	273	0	0	21	252	178	74
PCT7854	MV	878	138	0	0	14	124	86	38
PCT7854	ED	878	172	0	0	10	162	128	34
PCT7854	TO	878	310	0	0	24	286	214	72
PCT7855	MV	974	150	0	0	10	140	96	44
PCT7855	ED	974	202	0	0	16	186	150	36
PCT7855	TO	974	352	0	0	26	326	246	80
PCT7856	MV	847	106	0	0	5	101	71	30
PCT7856	ED	847	193	0	0	10	183	145	38
PCT7856	TO	847	299	0	0	15	284	216	68
PCT7857	MV	906	144	0	1	11	132	100	32
PCT7857	ED	906	153	0	0	9	144	119	25
PCT7857	TO	906	297	0	1	20	276	219	57
PCT7858	MV	779	120	0	0	10	110	91	19
PCT7858	ED	779	147	0	0	11	136	119	17
PCT7858	TO	779	267	0	0	21	246	210	36
PCT7859	MV	899	152	0	0	8	144	107	37
PCT7859	ED	899	165	0	0	16	149	106	43
PCT7859	TO	899	317	0	0	24	293	213	80
PCT7861	MV	863	144	0	0	7	137	87	50
PCT7861	ED	863	171	0	0	9	162	123	39
PCT7861	TO	863	315	0	0	16	299	210	89
PCT7862	MV	864	143	0	0	12	131	84	47
PCT7862	ED	864	197	0	0	12	185	149	36
PCT7862	TO	864	340	0	0	24	316	233	83
PCT7863	MV	901	102	0	0	4	98	71	27
PCT7863	ED	901	205	0	0	8	197	145	52
PCT7863	TO	901	307	0	0	12	295	216	79
PCT7864	MV	814	115	0	0	7	108	74	34
PCT7864	ED	814	157	0	0	12	145	114	31
PCT7864	TO	814	272	0	0	19	253	188	65
PCT7865	MV	840	132	0	0	6	126	90	36
PCT7865	ED	840	157	0	0	10	147	112	35
PCT7865	TO	840	289	0	0	16	273	202	71
PCT7866	MV	848	173	0	0	7	166	93	73
PCT7866	ED	848	141	0	0	6	135	90	45
PCT7866	TO	848	314	0	0	13	301	183	118
PCT7867	MV	978	179	0	0	13	166	122	44
PCT7867	ED	978	182	0	0	13	169	133	36
PCT7867	TO	978	361	0	0	26	335	255	80
PCT7868	MV	876	157	0	0	7	150	114	36
PCT7868	ED	876	161	0	1	9	151	116	35
PCT7868	TO	876	318	0	1	16	301	230	71
PCT7869	MV	861	157	0	0	10	147	104	43
PCT7869	ED	861	189	0	0	10	179	145	34
PCT7869	TO	861	346	0	0	20	326	249	77
PCT7871	MV	902	153	0	0	7	146	106	40
PCT7871	ED	902	157	0	0	9	148	108	40
PCT7871	TO	902	310	0	0	16	294	214	80
PCT7872	MV	874	149	0	0	8	141	94	47
PCT7872	ED	874	185	0	0	9	176	131	45
PCT7872	TO	874	334	0	0	17	317	225	92
PCT7873	MV	891	135	0	1	6	128	98	30
PCT7873	ED	891	212	0	0	15	197	164	33
PCT7873	TO	891	347	0	1	21	325	262	63
PCT7874	MV	489	58	0	0	3	55	37	18
PCT7874	ED	489	107	0	0	6	101	83	18
PCT7874	TO	489	165	0	0	9	156	120	36
PCT7875	MV	647	83	0	0	3	80	61	19
PCT7875	ED	647	114	0	0	5	109	92	17
PCT7875	TO	647	197	0	0	8	189	153	36
PCT7876	MV	568	93	0	0	8	85	67	18
PCT7876	ED	568	91	0	0	11	80	67	13
PCT7876	TO	568	184	0	0	19	165	134	31
PCT7901	MV	549	81	0	0	5	76	61	15
PCT7901	ED	549	65	0	0	3	62	53	9
PCT7901	TO	549	146	0	0	8	138	114	24
PCT7902	MV	912	102	0	0	5	97	73	24
PCT7902	ED	912	139	0	0	8	131	113	18
PCT7902	TO	912	241	0	0	13	228	186	42
PCT7903	MV	852	107	0	0	13	94	78	16
PCT7903	ED	852	123	0	0	7	116	109	7
PCT7903	TO	852	230	0	0	20	210	187	23
PCT7904	MV	837	104	0	0	8	96	80	16
PCT7904	ED	837	115	0	0	8	107	90	17
PCT7904	TO	837	219	0	0	16	203	170	33
PCT7905	MV	875	145	0	0	7	138	113	25
PCT7905	ED	875	183	0	0	8	175	151	24
PCT7905	TO	875	328	0	0	15	313	264	49
PCT7906	MV	786	79	0	0	2	77	60	17
PCT7906	ED	786	115	0	0	13	102	85	17
PCT7906	TO	786	194	0	0	15	179	145	34
PCT7907	MV	942	112	0	0	5	107	86	21
PCT7907	ED	942	163	0	0	15	148	127	21
PCT7907	TO	942	275	0	0	20	255	213	42
PCT7908	MV	992	142	0	0	8	134	116	18
PCT7908	ED	992	169	0	0	12	157	140	17
PCT7908	TO	992	311	0	0	20	291	256	35
PCT7909	MV	743	89	0	0	7	82	67	15
PCT7909	ED	743	140	0	0	7	133	117	16
PCT7909	TO	743	229	0	0	14	215	184	31
PCT7911	MV	871	107	0	0	9	98	74	24
PCT7911	ED	871	129	0	0	8	121	104	17
PCT7911	TO	871	236	0	0	17	219	178	41
PCT7912	MV	1059	118	0	0	11	107	92	15
PCT7912	ED	1059	176	0	0	19	157	143	14
PCT7912	TO	1059	294	0	0	30	264	235	29
PCT7913	MV	923	123	0	0	4	119	97	22
PCT7913	ED	923	212	0	0	5	207	171	36
PCT7913	TO	923	335	0	0	9	326	268	58
PCT7914	MV	902	106	0	0	5	101	78	23
PCT7914	ED	902	140	0	0	11	129	109	20
PCT7914	TO	902	246	0	0	16	230	187	43
PCT7915	MV	843	87	0	0	4	83	67	16
PCT7915	ED	843	181	0	0	5	176	147	29
PCT7915	TO	843	268	0	0	9	259	214	45
PCT7916	MV	858	100	0	0	3	97	72	25
PCT7916	ED	858	160	0	0	10	150	137	13
PCT7916	TO	858	260	0	0	13	247	209	38
PCT7917	MV	987	112	0	0	7	105	88	17
PCT7917	ED	987	187	0	0	8	179	157	22
PCT7917	TO	987	299	0	0	15	284	245	39
PCT7918	MV	824	79	0	0	3	76	64	12
PCT7918	ED	824	143	0	0	7	136	114	22
PCT7918	TO	824	222	0	0	10	212	178	34
PCT7919	MV	866	102	0	0	3	99	81	18
PCT7919	ED	866	175	0	0	9	166	147	19
PCT7919	TO	866	277	0	0	12	265	228	37
PCT7921	MV	911	113	0	0	5	108	89	19
PCT7921	ED	911	101	0	0	4	97	88	9
PCT7921	TO	911	214	0	0	9	205	177	28
PCT7922	MV	858	114	0	0	3	111	84	27
PCT7922	ED	858	155	0	0	13	142	118	24
PCT7922	TO	858	269	0	0	16	253	202	51
PCT7923	MV	880	108	0	0	5	103	73	30
PCT7923	ED	880	170	0	0	10	160	134	26
PCT7923	TO	880	278	0	0	15	263	207	56
PCT7924	MV	851	93	0	0	3	90	61	29
PCT7924	ED	851	124	0	0	10	114	92	22
PCT7924	TO	851	217	0	0	13	204	153	51
PCT7925	MV	544	81	0	0	4	77	57	20
PCT7925	ED	544	89	0	0	4	85	74	11
PCT7925	TO	544	170	0	0	8	162	131	31
PCT7926	MV	788	97	0	0	8	89	70	19
PCT7926	ED	788	150	0	0	6	144	115	29
PCT7926	TO	788	247	0	0	14	233	185	48
PCT7927	MV	742	106	0	0	10	96	71	25
PCT7927	ED	742	152	0	0	6	146	123	23
PCT7927	TO	742	258	0	0	16	242	194	48
PCT7928	MV	917	130	0	0	6	124	95	29
PCT7928	ED	917	208	0	0	4	204	164	40
PCT7928	TO	917	338	0	0	10	328	259	69
PCT7929	MV	847	128	0	0	7	121	97	24
PCT7929	ED	847	170	0	0	8	162	146	16
PCT7929	TO	847	298	0	0	15	283	243	40
PCT7931	MV	751	114	0	0	7	107	86	21
PCT7931	ED	751	149	0	0	6	143	118	25
PCT7931	TO	751	263	0	0	13	250	204	46
PCT7932	MV	561	98	0	0	7	91	54	37
PCT7932	ED	561	95	0	0	6	89	72	17
PCT7932	TO	561	193	0	0	13	180	126	54
PCT7933	MV	8	2	0	0	0	2	2	0
PCT7933	ED	8	0	0	0	0	0	0	0
PCT7933	TO	8	2	0	0	0	2	2	0
PCT7934	MV	884	140	0	0	12	128	107	21
PCT7934	ED	884	154	0	0	10	144	120	24
PCT7934	TO	884	294	0	0	22	272	227	45
PCT7935	MV	943	138	0	0	5	133	101	32
PCT7935	ED	943	225	0	0	15	210	176	34
PCT7935	TO	943	363	0	0	20	343	277	66
PCT7936	MV	856	119	0	0	10	109	91	18
PCT7936	ED	856	220	0	0	10	210	170	40
PCT7936	TO	856	339	0	0	20	319	261	58
PCT7937	MV	900	143	0	0	5	138	113	25
PCT7937	ED	900	171	0	0	7	164	138	26
PCT7937	TO	900	314	0	0	12	302	251	51
PCT7938	MV	751	105	0	0	6	99	71	28
PCT7938	ED	751	120	0	0	7	113	97	16
PCT7938	TO	751	225	0	0	13	212	168	44
PCT7939	MV	686	76	0	0	6	70	48	22
PCT7939	ED	686	191	0	0	10	181	153	28
PCT7939	TO	686	267	0	0	16	251	201	50
PCT7941	MV	772	92	0	0	14	78	57	21
PCT7941	ED	772	170	0	0	10	160	123	37
PCT7941	TO	772	262	0	0	24	238	180	58
PCT7942	MV	932	134	0	0	6	128	101	27
PCT7942	ED	932	141	0	0	5	136	114	22
PCT7942	TO	932	275	0	0	11	264	215	49
PCT7943	MV	900	128	0	0	5	123	93	30
PCT7943	ED	900	156	0	0	11	145	105	40
PCT7943	TO	900	284	0	0	16	268	198	70
PCT7944	MV	814	104	0	0	7	97	82	15
PCT7944	ED	814	196	0	0	11	185	152	33
PCT7944	TO	814	300	0	0	18	282	234	48
PCT7945	MV	954	116	0	0	6	110	85	25
PCT7945	ED	954	82	0	0	6	76	69	7
PCT7945	TO	954	198	0	0	12	186	154	32
PCT7946	MV	985	161	0	0	10	151	82	69
PCT7946	ED	985	114	0	0	7	107	81	26
PCT7946	TO	985	275	0	0	17	258	163	95
PCT7947	MV	986	160	0	0	12	148	72	76
PCT7947	ED	986	93	0	0	2	91	69	22
PCT7947	TO	986	253	0	0	14	239	141	98
PCT7948	MV	930	151	0	0	10	141	82	59
PCT7948	ED	930	119	0	0	3	116	85	31
PCT7948	TO	930	270	0	0	13	257	167	90
PCT7949	MV	590	107	0	0	4	103	48	55
PCT7949	ED	590	56	0	0	7	49	35	14
PCT7949	TO	590	163	0	0	11	152	83	69
PCT7951	MV	887	149	0	0	7	142	69	73
PCT7951	ED	887	90	0	0	3	87	56	31
PCT7951	TO	887	239	0	0	10	229	125	104
PCT7952	MV	912	105	0	0	4	101	48	53
PCT7952	ED	912	86	0	0	6	80	51	29
PCT7952	TO	912	191	0	0	10	181	99	82
PCT7953	MV	830	136	0	0	3	133	72	61
PCT7953	ED	830	106	0	0	5	101	63	38
PCT7953	TO	830	242	0	0	8	234	135	99
PCT7954	MV	0	0	0	0	0	0	0	0
PCT7954	ED	0	0	0	0	0	0	0	0
PCT7954	TO	0	0	0	0	0	0	0	0
PCT7955	MV	947	120	0	0	3	117	67	50
PCT7955	ED	947	97	0	0	8	89	54	35
PCT7955	TO	947	217	0	0	11	206	121	85
PCT7956	MV	869	102	0	0	1	101	59	42
PCT7956	ED	869	39	0	0	2	37	30	7
PCT7956	TO	869	141	0	0	3	138	89	49
PCT7957	MV	673	101	0	0	8	93	60	33
PCT7957	ED	673	83	0	0	5	78	59	19
PCT7957	TO	673	184	0	0	13	171	119	52
PCT7958	MV	297	36	0	0	3	33	27	6
PCT7958	ED	297	0	0	0	0	0	0	0
PCT7958	TO	297	36	0	0	3	33	27	6
PCT7959	MV	686	86	0	0	7	79	62	17
PCT7959	ED	686	65	0	0	5	60	56	4
PCT7959	TO	686	151	0	0	12	139	118	21
PCT9001	MV	284	39	0	0	0	39	32	7
PCT9001	ED	284	0	0	0	0	0	0	0
PCT9001	TO	284	39	0	0	0	39	32	7
PCT9101	MV	913	162	0	0	10	152	99	53
PCT9101	ED	913	150	0	0	3	147	99	48
PCT9101	TO	913	312	0	0	13	299	198	101
PCT9102	MV	992	134	0	0	6	128	81	47
PCT9102	ED	992	126	0	0	7	119	91	28
PCT9102	TO	992	260	0	0	13	247	172	75
PCT9103	MV	957	147	0	0	15	132	89	43
PCT9103	ED	957	153	0	0	11	142	89	53
PCT9103	TO	957	300	0	0	26	274	178	96
PCT9104	MV	1030	143	0	0	12	131	89	42
PCT9104	ED	1030	152	0	0	11	141	110	31
PCT9104	TO	1030	295	0	0	23	272	199	73
PCT9105	MV	918	152	0	0	11	141	93	48
PCT9105	ED	918	173	0	0	16	157	109	48
PCT9105	TO	918	325	0	0	27	298	202	96
PCT9106	MV	946	149	0	0	14	135	87	48
PCT9106	ED	946	178	0	0	12	166	126	40
PCT9106	TO	946	327	0	0	26	301	213	88
PCT9107	MV	844	124	0	0	7	117	79	38
PCT9107	ED	844	118	0	0	9	109	86	23
PCT9107	TO	844	242	0	0	16	226	165	61
PCT9108	MV	810	104	0	0	12	92	64	28
PCT9108	ED	810	136	0	0	6	130	103	27
PCT9108	TO	810	240	0	0	18	222	167	55
PCT9109	MV	883	103	0	0	7	96	63	33
PCT9109	ED	883	162	0	0	6	156	118	38
PCT9109	TO	883	265	0	0	13	252	181	71
PCT9111	MV	834	123	0	0	16	107	61	46
PCT9111	ED	834	134	0	0	11	123	98	25
PCT9111	TO	834	257	0	0	27	230	159	71
PCT9112	MV	961	129	0	0	4	125	88	37
PCT9112	ED	961	160	0	0	10	150	116	34
PCT9112	TO	961	289	0	0	14	275	204	71
PCT9113	MV	1004	126	0	0	7	119	78	41
PCT9113	ED	1004	180	0	0	15	165	115	50
PCT9113	TO	1004	306	0	0	22	284	193	91
PCT9114	MV	890	107	0	0	7	100	66	34
PCT9114	ED	890	147	0	0	12	135	108	27
PCT9114	TO	890	254	0	0	19	235	174	61
PCT9115	MV	881	122	0	0	8	114	87	27
PCT9115	ED	881	155	0	0	19	136	117	19
PCT9115	TO	881	277	0	0	27	250	204	46
PCT9116	MV	961	129	0	0	7	122	73	49
PCT9116	ED	961	148	0	0	11	137	100	37
PCT9116	TO	961	277	0	0	18	259	173	86
PCT9117	MV	800	139	0	0	7	132	82	50
PCT9117	ED	800	158	0	0	10	148	99	49
PCT9117	TO	800	297	0	0	17	280	181	99
PCT9118	MV	984	105	0	0	4	101	48	53
PCT9118	ED	984	165	0	0	13	152	104	48
PCT9118	TO	984	270	0	0	17	253	152	101
PCT9119	MV	900	152	0	0	8	144	78	66
PCT9119	ED	900	120	0	0	12	108	86	22
PCT9119	TO	900	272	0	0	20	252	164	88
PCT9121	MV	953	114	0	0	4	110	69	41
PCT9121	ED	953	141	0	0	10	131	84	47
PCT9121	TO	953	255	0	0	14	241	153	88
PCT9122	MV	967	143	0	0	12	131	74	57
PCT9122	ED	967	122	0	0	11	111	83	28
PCT9122	TO	967	265	0	0	23	242	157	85
PCT9123	MV	852	121	0	0	4	117	71	46
PCT9123	ED	852	139	0	0	8	131	98	33
PCT9123	TO	852	260	0	0	12	248	169	79
PCT9124	MV	903	131	0	0	4	127	72	55
PCT9124	ED	903	118	0	0	6	112	80	32
PCT9124	TO	903	249	0	0	10	239	152	87
PCT9125	MV	869	132	0	0	3	129	86	43
PCT9125	ED	869	124	0	0	8	116	89	27
PCT9125	TO	869	256	0	0	11	245	175	70
PCT9126	MV	1013	172	0	1	9	162	83	79
PCT9126	ED	1013	152	0	0	11	141	106	35
PCT9126	TO	1013	324	0	1	20	303	189	114
PCT9127	MV	971	141	0	0	7	134	96	38
PCT9127	ED	971	184	0	0	8	176	129	47
PCT9127	TO	971	325	0	0	15	310	225	85
PCT9128	MV	818	93	0	0	6	87	60	27
PCT9128	ED	818	166	0	0	12	154	115	39
PCT9128	TO	818	259	0	0	18	241	175	66
PCT9129	MV	738	107	0	0	7	100	55	45
PCT9129	ED	738	129	0	0	6	123	97	26
PCT9129	TO	738	236	0	0	13	223	152	71
PCT9131	MV	734	119	0	0	5	114	69	45
PCT9131	ED	734	111	0	0	6	105	74	31
PCT9131	TO	734	230	0	0	11	219	143	76
PCT9132	MV	821	85	0	0	6	79	65	14
PCT9132	ED	821	130	0	0	10	120	97	23
PCT9132	TO	821	215	0	0	16	199	162	37
PCT9133	MV	1017	172	0	0	11	161	119	42
PCT9133	ED	1017	157	0	0	9	148	111	37
PCT9133	TO	1017	329	0	0	20	309	230	79
PCT9134	MV	891	121	0	0	4	117	64	53
PCT9134	ED	891	102	0	0	10	92	70	22
PCT9134	TO	891	223	0	0	14	209	134	75
PCT9135	MV	822	134	0	0	8	126	77	49
PCT9135	ED	822	125	0	0	7	118	72	46
PCT9135	TO	822	259	0	0	15	244	149	95
PCT9136	MV	918	124	0	0	6	118	69	49
PCT9136	ED	918	139	0	0	10	129	102	27
PCT9136	TO	918	263	0	0	16	247	171	76
PCT9137	MV	1015	153	0	0	12	141	94	47
PCT9137	ED	1015	133	0	0	4	129	96	33
PCT9137	TO	1015	286	0	0	16	270	190	80
PCT9138	MV	945	157	0	0	6	151	95	56
PCT9138	ED	945	119	0	0	7	112	85	27
PCT9138	TO	945	276	0	0	13	263	180	83
PCT9139	MV	1018	158	0	0	8	150	88	62
PCT9139	ED	1018	141	0	0	11	130	94	36
PCT9139	TO	1018	299	0	0	19	280	182	98
PCT9141	MV	973	160	0	0	15	145	85	60
PCT9141	ED	973	144	0	0	12	132	98	34
PCT9141	TO	973	304	0	0	27	277	183	94
PCT9142	MV	986	146	0	0	9	137	92	45
PCT9142	ED	986	162	0	0	12	150	113	37
PCT9142	TO	986	308	0	0	21	287	205	82
PCT9143	MV	914	149	0	0	11	138	74	64
PCT9143	ED	914	150	0	0	4	146	101	45
PCT9143	TO	914	299	0	0	15	284	175	109
PCT9144	MV	970	152	0	0	10	142	86	56
PCT9144	ED	970	177	0	0	8	169	131	38
PCT9144	TO	970	329	0	0	18	311	217	94
PCT9145	MV	875	117	0	0	6	111	74	37
PCT9145	ED	875	157	0	0	8	149	109	40
PCT9145	TO	875	274	0	0	14	260	183	77
PCT9146	MV	885	120	0	0	12	108	70	38
PCT9146	ED	885	143	0	0	10	133	103	30
PCT9146	TO	885	263	0	0	22	241	173	68
PCT9147	MV	990	111	0	0	8	103	61	42
PCT9147	ED	990	161	0	0	10	151	110	41
PCT9147	TO	990	272	0	0	18	254	171	83
PCT9148	MV	1014	135	0	0	7	128	89	39
PCT9148	ED	1014	177	0	0	14	163	135	28
PCT9148	TO	1014	312	0	0	21	291	224	67
PCT9149	MV	991	124	0	0	10	114	76	38
PCT9149	ED	991	240	0	0	11	229	176	53
PCT9149	TO	991	364	0	0	21	343	252	91
PCT9151	MV	861	133	0	0	8	125	90	35
PCT9151	ED	861	111	0	0	5	106	76	30
PCT9151	TO	861	244	0	0	13	231	166	65
PCT9152	MV	737	63	0	0	2	61	48	13
PCT9152	ED	737	124	0	0	10	114	96	18
PCT9152	TO	737	187	0	0	12	175	144	31
PCT9201	MV	971	110	0	0	3	107	93	14
PCT9201	ED	971	166	0	0	11	155	126	29
PCT9201	TO	971	276	0	0	14	262	219	43
PCT9202	MV	996	126	0	0	12	114	91	23
PCT9202	ED	996	164	0	0	13	151	113	38
PCT9202	TO	996	290	0	0	25	265	204	61
PCT9203	MV	1002	142	0	0	14	128	69	59
PCT9203	ED	1002	120	0	0	16	104	54	50
PCT9203	TO	1002	262	0	0	30	232	123	109
PCT9204	MV	862	115	0	0	11	104	53	51
PCT9204	ED	862	138	0	0	13	125	73	52
PCT9204	TO	862	253	0	0	24	229	126	103
PCT9205	MV	736	119	0	0	16	103	77	26
PCT9205	ED	736	92	0	0	13	79	49	30
PCT9205	TO	736	211	0	0	29	182	126	56
PCT9206	MV	929	141	0	0	12	129	57	72
PCT9206	ED	929	149	0	0	26	123	71	52
PCT9206	TO	929	290	0	0	38	252	128	124
PCT9207	MV	989	129	0	0	10	119	69	50
PCT9207	ED	989	130	0	0	7	123	77	46
PCT9207	TO	989	259	0	0	17	242	146	96
PCT9208	MV	987	127	0	0	10	117	61	56
PCT9208	ED	987	127	0	0	13	114	74	40
PCT9208	TO	987	254	0	0	23	231	135	96
PCT9209	MV	771	100	0	0	8	92	53	39
PCT9209	ED	771	119	0	0	13	106	61	45
PCT9209	TO	771	219	0	0	21	198	114	84
PCT9211	MV	891	114	0	1	10	103	56	47
PCT9211	ED	891	132	0	0	20	112	65	47
PCT9211	TO	891	246	0	1	30	215	121	94
PCT9212	MV	808	100	0	0	2	98	54	44
PCT9212	ED	808	114	0	0	14	100	62	38
PCT9212	TO	808	214	0	0	16	198	116	82
PCT9213	MV	937	138	0	0	11	127	62	65
PCT9213	ED	937	130	0	0	15	115	79	36
PCT9213	TO	937	268	0	0	26	242	141	101
PCT9214	MV	627	95	0	0	6	89	52	37
PCT9214	ED	627	103	0	0	16	87	52	35
PCT9214	TO	627	198	0	0	22	176	104	72
PCT9215	MV	644	97	0	0	3	94	47	47
PCT9215	ED	644	100	0	0	12	88	53	35
PCT9215	TO	644	197	0	0	15	182	100	82
PCT9216	MV	824	95	0	0	8	87	49	38
PCT9216	ED	824	125	0	0	10	115	79	36
PCT9216	TO	824	220	0	0	18	202	128	74
PCT9217	MV	705	89	0	0	4	85	53	32
PCT9217	ED	705	87	0	0	5	82	50	32
PCT9217	TO	705	176	0	0	9	167	103	64
PCT9218	MV	816	97	0	0	5	92	41	51
PCT9218	ED	816	112	0	0	9	103	72	31
PCT9218	TO	816	209	0	0	14	195	113	82
PCT9219	MV	790	95	0	0	8	87	56	31
PCT9219	ED	790	116	0	0	8	108	88	20
PCT9219	TO	790	211	0	0	16	195	144	51
PCT9221	MV	651	144	0	0	4	140	56	84
PCT9221	ED	651	99	0	0	8	91	65	26
PCT9221	TO	651	243	0	0	12	231	121	110
PCT9222	MV	910	145	0	0	17	128	74	54
PCT9222	ED	910	116	0	0	10	106	68	38
PCT9222	TO	910	261	0	0	27	234	142	92
PCT9223	MV	667	124	0	0	7	117	52	65
PCT9223	ED	667	59	0	0	6	53	30	23
PCT9223	TO	667	183	0	0	13	170	82	88
PCT9224	MV	949	173	0	0	12	161	97	64
PCT9224	ED	949	151	0	0	16	135	80	55
PCT9224	TO	949	324	0	0	28	296	177	119
PCT9225	MV	926	109	0	0	11	98	57	41
PCT9225	ED	926	156	0	0	21	135	91	44
PCT9225	TO	926	265	0	0	32	233	148	85
PCT9226	MV	896	140	0	0	16	124	79	45
PCT9226	ED	896	143	0	0	10	133	93	40
PCT9226	TO	896	283	0	0	26	257	172	85
PCT9227	MV	729	150	0	0	10	140	78	62
PCT9227	ED	729	114	0	0	4	110	71	39
PCT9227	TO	729	264	0	0	14	250	149	101
PCT9228	MV	738	114	0	0	9	105	56	49
PCT9228	ED	738	141	0	0	8	133	85	48
PCT9228	TO	738	255	0	0	17	238	141	97
PCT9229	MV	579	106	0	0	12	94	60	34
PCT9229	ED	579	106	0	0	3	103	67	36
PCT9229	TO	579	212	0	0	15	197	127	70
PCT9231	MV	962	133	0	0	11	122	75	47
PCT9231	ED	962	208	0	0	16	192	141	51
PCT9231	TO	962	341	0	0	27	314	216	98
PCT9232	MV	734	98	0	0	4	94	47	47
PCT9232	ED	734	140	0	0	13	127	77	50
PCT9232	TO	734	238	0	0	17	221	124	97
PCT9233	MV	818	140	0	0	10	130	69	61
PCT9233	ED	818	141	0	0	15	126	92	34
PCT9233	TO	818	281	0	0	25	256	161	95
PCT9234	MV	734	134	0	0	9	125	65	60
PCT9234	ED	734	112	0	0	14	98	64	34
PCT9234	TO	734	246	0	0	23	223	129	94
PCT9235	MV	863	143	0	0	5	138	74	64
PCT9235	ED	863	140	0	0	10	130	83	47
PCT9235	TO	863	283	0	0	15	268	157	111
PCT9236	MV	673	114	0	0	12	102	64	38
PCT9236	ED	673	101	0	0	10	91	65	26
PCT9236	TO	673	215	0	0	22	193	129	64
PCT9237	MV	897	129	0	0	8	121	73	48
PCT9237	ED	897	134	0	0	9	125	80	45
PCT9237	TO	897	263	0	0	17	246	153	93
PCT9238	MV	805	126	0	0	14	112	64	48
PCT9238	ED	805	118	0	0	16	102	69	33
PCT9238	TO	805	244	0	0	30	214	133	81
PCT9239	MV	864	176	0	0	19	157	92	65
PCT9239	ED	864	117	0	0	8	109	79	30
PCT9239	TO	864	293	0	0	27	266	171	95
PCT9241	MV	960	156	0	0	6	150	83	67
PCT9241	ED	960	139	0	0	12	127	89	38
PCT9241	TO	960	295	0	0	18	277	172	105
PCT9242	MV	943	125	0	1	15	109	61	48
PCT9242	ED	943	155	0	0	13	142	102	40
PCT9242	TO	943	280	0	1	28	251	163	88
PCT9243	MV	603	75	0	0	7	68	41	27
PCT9243	ED	603	113	0	0	16	97	73	24
PCT9243	TO	603	188	0	0	23	165	114	51
PCT9244	MV	910	114	0	0	12	102	71	31
PCT9244	ED	910	121	0	0	7	114	79	35
PCT9244	TO	910	235	0	0	19	216	150	66
PCT9245	MV	714	105	0	0	9	96	59	37
PCT9245	ED	714	91	0	0	7	84	63	21
PCT9245	TO	714	196	0	0	16	180	122	58
PCT9246	MV	970	161	0	0	13	148	86	62
PCT9246	ED	970	140	0	0	20	120	92	28
PCT9246	TO	970	301	0	0	33	268	178	90
PCT9247	MV	912	139	0	0	9	130	80	50
PCT9247	ED	912	156	0	0	21	135	94	41
PCT9247	TO	912	295	0	0	30	265	174	91
PCT9248	MV	907	130	0	0	11	119	89	30
PCT9248	ED	907	145	0	0	11	134	103	31
PCT9248	TO	907	275	0	0	22	253	192	61
PCT9249	MV	915	137	0	0	7	130	86	44
PCT9249	ED	915	171	0	0	17	154	106	48
PCT9249	TO	915	308	0	0	24	284	192	92
PCT9251	MV	966	143	0	0	10	133	81	52
PCT9251	ED	966	179	0	0	11	168	117	51
PCT9251	TO	966	322	0	0	21	301	198	103
PCT9252	MV	953	162	0	0	7	155	95	60
PCT9252	ED	953	127	0	0	9	118	85	33
PCT9252	TO	953	289	0	0	16	273	180	93
PCT9253	MV	761	100	0	0	4	96	57	39
PCT9253	ED	761	116	0	0	10	106	73	33
PCT9253	TO	761	216	0	0	14	202	130	72
PCT9254	MV	921	162	0	0	4	158	112	46
PCT9254	ED	921	155	0	0	23	132	84	48
PCT9254	TO	921	317	0	0	27	290	196	94
PCT9255	MV	550	52	0	0	2	50	34	16
PCT9255	ED	550	112	0	0	11	101	76	25
PCT9255	TO	550	164	0	0	13	151	110	41
PCT9256	MV	462	61	0	0	3	58	37	21
PCT9256	ED	462	74	0	0	7	67	45	22
PCT9256	TO	462	135	0	0	10	125	82	43
PCT9257	MV	320	36	0	0	4	32	24	8
PCT9257	ED	320	0	0	0	0	0	0	0
PCT9257	TO	320	36	0	0	4	32	24	8
PCT9258	MV	703	114	0	0	10	104	66	38
PCT9258	ED	703	103	0	0	6	97	73	24
PCT9258	TO	703	217	0	0	16	201	139	62
PCT9401	MV	1038	129	0	0	5	124	89	35
PCT9401	ED	1038	176	0	0	9	167	137	30
PCT9401	TO	1038	305	0	0	14	291	226	65
PCT9402	MV	1017	120	0	0	9	111	68	43
PCT9402	ED	1017	159	0	0	11	148	119	29
PCT9402	TO	1017	279	0	0	20	259	187	72
PCT9403	MV	921	125	0	0	3	122	69	53
PCT9403	ED	921	123	0	0	6	117	99	18
PCT9403	TO	921	248	0	0	9	239	168	71
PCT9404	MV	944	115	0	0	9	106	56	50
PCT9404	ED	944	154	0	0	10	144	106	38
PCT9404	TO	944	269	0	0	19	250	162	88
PCT9405	MV	780	106	0	0	6	100	60	40
PCT9405	ED	780	104	0	0	4	100	65	35
PCT9405	TO	780	210	0	0	10	200	125	75
PCT9406	MV	883	111	0	0	7	104	57	47
PCT9406	ED	883	150	0	0	6	144	98	46
PCT9406	TO	883	261	0	0	13	248	155	93
PCT9407	MV	913	123	0	0	6	117	85	32
PCT9407	ED	913	131	0	0	13	118	90	28
PCT9407	TO	913	254	0	0	19	235	175	60
PCT9408	MV	863	104	0	0	7	97	69	28
PCT9408	ED	863	125	0	0	12	113	90	23
PCT9408	TO	863	229	0	0	19	210	159	51
PCT9409	MV	601	81	0	0	3	78	52	26
PCT9409	ED	601	127	0	0	5	122	101	21
PCT9409	TO	601	208	0	0	8	200	153	47
PCT9411	MV	1007	106	0	0	6	100	75	25
PCT9411	ED	1007	135	0	0	6	129	102	27
PCT9411	TO	1007	241	0	0	12	229	177	52
PCT9412	MV	870	128	0	0	7	121	68	53
PCT9412	ED	870	138	0	0	7	131	99	32
PCT9412	TO	870	266	0	0	14	252	167	85
PCT9413	MV	936	130	0	0	9	121	63	58
PCT9413	ED	936	127	0	0	7	120	88	32
PCT9413	TO	936	257	0	0	16	241	151	90
PCT9414	MV	920	156	0	0	9	147	93	54
PCT9414	ED	920	107	0	0	4	103	73	30
PCT9414	TO	920	263	0	0	13	250	166	84
PCT9415	MV	788	112	0	0	8	104	67	37
PCT9415	ED	788	96	0	0	4	92	66	26
PCT9415	TO	788	208	0	0	12	196	133	63
PCT9416	MV	999	157	0	0	11	146	81	65
PCT9416	ED	999	143	0	0	4	139	96	43
PCT9416	TO	999	300	0	0	15	285	177	108
PCT9417	MV	774	143	0	0	7	136	67	69
PCT9417	ED	774	110	0	0	3	107	75	32
PCT9417	TO	774	253	0	0	10	243	142	101
PCT9418	MV	819	129	0	0	10	119	56	63
PCT9418	ED	819	122	0	0	8	114	75	39
PCT9418	TO	819	251	0	0	18	233	131	102
PCT9419	MV	909	144	0	0	8	136	67	69
PCT9419	ED	909	107	0	0	8	99	58	41
PCT9419	TO	909	251	0	0	16	235	125	110
PCT9421	MV	925	128	0	0	7	121	54	67
PCT9421	ED	925	112	0	0	6	106	70	36
PCT9421	TO	925	240	0	0	13	227	124	103
PCT9422	MV	1101	153	0	0	12	141	78	63
PCT9422	ED	1101	145	0	0	10	135	97	38
PCT9422	TO	1101	298	0	0	22	276	175	101
PCT9423	MV	904	100	0	0	4	96	51	45
PCT9423	ED	904	121	0	0	7	114	84	30
PCT9423	TO	904	221	0	0	11	210	135	75
PCT9424	MV	1009	136	0	1	6	129	76	53
PCT9424	ED	1009	114	0	0	8	106	77	29
PCT9424	TO	1009	250	0	1	14	235	153	82
PCT9425	MV	976	134	0	0	11	123	69	54
PCT9425	ED	976	114	0	0	7	107	72	35
PCT9425	TO	976	248	0	0	18	230	141	89
PCT9426	MV	853	110	0	0	8	102	47	55
PCT9426	ED	853	104	0	0	12	92	59	33
PCT9426	TO	853	214	0	0	20	194	106	88
PCT9427	MV	987	154	0	0	6	148	68	80
PCT9427	ED	987	115	0	0	13	102	56	46
PCT9427	TO	987	269	0	0	19	250	124	126
PCT9428	MV	990	136	0	0	8	128	80	48
PCT9428	ED	990	113	0	0	8	105	78	27
PCT9428	TO	990	249	0	0	16	233	158	75
PCT9429	MV	906	120	0	0	6	114	58	56
PCT9429	ED	906	124	0	0	16	108	67	41
PCT9429	TO	906	244	0	0	22	222	125	97
PCT9431	MV	1036	154	0	0	9	145	69	76
PCT9431	ED	1036	125	0	0	4	121	82	39
PCT9431	TO	1036	279	0	0	13	266	151	115
PCT9432	MV	958	134	0	0	6	128	62	66
PCT9432	ED	958	117	0	0	8	109	77	32
PCT9432	TO	958	251	0	0	14	237	139	98
PCT9433	MV	958	155	0	0	10	145	71	74
PCT9433	ED	958	93	0	0	6	87	49	38
PCT9433	TO	958	248	0	0	16	232	120	112
PCT9434	MV	1012	132	0	0	5	127	69	58
PCT9434	ED	1012	162	0	0	17	145	107	38
PCT9434	TO	1012	294	0	0	22	272	176	96
PCT9435	MV	1004	141	0	0	9	132	69	63
PCT9435	ED	1004	157	0	0	7	150	98	52
PCT9435	TO	1004	298	0	0	16	282	167	115
PCT9436	MV	1068	154	0	0	6	148	77	71
PCT9436	ED	1068	129	0	0	9	120	79	41
PCT9436	TO	1068	283	0	0	15	268	156	112
PCT9437	MV	927	192	0	0	7	185	98	87
PCT9437	ED	927	130	0	0	2	128	83	45
PCT9437	TO	927	322	0	0	9	313	181	132
PCT9438	MV	989	179	0	0	8	171	76	95
PCT9438	ED	989	83	0	0	6	77	51	26
PCT9438	TO	989	262	0	0	14	248	127	121
PCT9439	MV	917	123	0	0	6	117	63	54
PCT9439	ED	917	111	0	0	12	99	64	35
PCT9439	TO	917	234	0	0	18	216	127	89
PCT9441	MV	971	134	0	0	7	127	65	62
PCT9441	ED	971	125	0	0	13	112	84	28
PCT9441	TO	971	259	0	0	20	239	149	90
PCT9442	MV	1040	133	0	0	12	121	59	62
PCT9442	ED	1040	156	0	0	10	146	108	38
PCT9442	TO	1040	289	0	0	22	267	167	100
PCT9443	MV	955	142	0	0	8	134	73	61
PCT9443	ED	955	109	0	0	4	105	72	33
PCT9443	TO	955	251	0	0	12	239	145	94
PCT9444	MV	965	144	0	0	4	140	65	75
PCT9444	ED	965	94	0	0	9	85	59	26
PCT9444	TO	965	238	0	0	13	225	124	101
PCT9445	MV	996	143	0	0	8	135	66	69
PCT9445	ED	996	113	0	0	6	107	69	38
PCT9445	TO	996	256	0	0	14	242	135	107
PCT9446	MV	1116	178	0	0	9	169	81	88
PCT9446	ED	1116	145	0	0	10	135	91	44
PCT9446	TO	1116	323	0	0	19	304	172	132
PCT9447	MV	921	127	0	0	10	117	70	47
PCT9447	ED	921	143	0	0	13	130	86	44
PCT9447	TO	921	270	0	0	23	247	156	91
PCT9448	MV	940	143	0	0	7	136	74	62
PCT9448	ED	940	127	0	0	6	121	93	28
PCT9448	TO	940	270	0	0	13	257	167	90
PCT9449	MV	881	132	0	0	6	126	49	77
PCT9449	ED	881	96	0	0	7	89	59	30
PCT9449	TO	881	228	0	0	13	215	108	107
PCT9451	MV	441	55	0	0	1	54	25	29
PCT9451	ED	441	54	0	0	2	52	37	15
PCT9451	TO	441	109	0	0	3	106	62	44
PCT9452	MV	842	108	0	0	10	98	49	49
PCT9452	ED	842	134	0	0	10	124	70	54
PCT9452	TO	842	242	0	0	20	222	119	103
PCT9453	MV	524	99	0	0	6	93	40	53
PCT9453	ED	524	70	0	0	7	63	37	26
PCT9453	TO	524	169	0	0	13	156	77	79
PCT9501	MV	150	36	0	0	4	32	23	9
PCT9501	ED	150	0	0	0	0	0	0	0
PCT9501	TO	150	36	0	0	4	32	23	9
PCT9502	MV	251	41	0	0	3	38	25	13
PCT9502	ED	251	0	0	0	0	0	0	0
PCT9502	TO	251	41	0	0	3	38	25	13
PCT9503	MV	700	109	0	0	12	97	88	9
PCT9503	ED	700	82	0	0	4	78	66	12
PCT9503	TO	700	191	0	0	16	175	154	21
PCT9505	MV	765	112	0	0	7	105	79	26
PCT9505	ED	765	110	0	0	6	104	85	19
PCT9505	TO	765	222	0	0	13	209	164	45
PCT9506	MV	754	76	0	0	5	71	50	21
PCT9506	ED	754	128	0	0	11	117	100	17
PCT9506	TO	754	204	0	0	16	188	150	38
PCT9507	MV	716	90	0	0	10	80	64	16
PCT9507	ED	716	152	0	0	17	135	111	24
PCT9507	TO	716	242	0	0	27	215	175	40
PCT9508	MV	780	101	0	0	3	98	80	18
PCT9508	ED	780	132	0	0	9	123	108	15
PCT9508	TO	780	233	0	0	12	221	188	33
PCT9509	MV	727	85	0	0	3	82	52	30
PCT9509	ED	727	121	0	0	8	113	96	17
PCT9509	TO	727	206	0	0	11	195	148	47
PCT9511	MV	634	56	0	0	6	50	39	11
PCT9511	ED	634	120	0	0	3	117	96	21
PCT9511	TO	634	176	0	0	9	167	135	32
PCT9512	MV	777	97	0	0	9	88	60	28
PCT9512	ED	777	132	0	0	8	124	107	17
PCT9512	TO	777	229	0	0	17	212	167	45
PCT9513	MV	877	104	0	0	6	98	84	14
PCT9513	ED	877	126	0	0	7	119	104	15
PCT9513	TO	877	230	0	0	13	217	188	29
PCT9514	MV	896	95	0	0	7	88	70	18
PCT9514	ED	896	167	0	0	14	153	133	20
PCT9514	TO	896	262	0	0	21	241	203	38
PCT9515	MV	712	94	0	0	6	88	71	17
PCT9515	ED	712	133	0	0	11	122	94	28
PCT9515	TO	712	227	0	0	17	210	165	45
PCT9516	MV	889	128	0	0	10	118	81	37
PCT9516	ED	889	157	0	0	8	149	106	43
PCT9516	TO	889	285	0	0	18	267	187	80
PCT9517	MV	788	125	0	0	10	115	85	30
PCT9517	ED	788	135	0	0	16	119	103	16
PCT9517	TO	788	260	0	0	26	234	188	46
PCT9518	MV	788	87	0	0	6	81	62	19
PCT9518	ED	788	146	0	0	5	141	107	34
PCT9518	TO	788	233	0	0	11	222	169	53
PCT9519	MV	891	105	0	0	8	97	68	29
PCT9519	ED	891	170	0	0	9	161	118	43
PCT9519	TO	891	275	0	0	17	258	186	72
PCT9521	MV	901	115	0	0	5	110	77	33
PCT9521	ED	901	190	0	0	14	176	149	27
PCT9521	TO	901	305	0	0	19	286	226	60
PCT9701	MV	654	95	0	0	7	88	66	22
PCT9701	ED	654	135	0	0	5	130	107	23
PCT9701	TO	654	230	0	0	12	218	173	45
PCT9702	MV	720	88	0	0	5	83	56	27
PCT9702	ED	720	143	0	0	6	137	117	20
PCT9702	TO	720	231	0	0	11	220	173	47
PCT9703	MV	991	144	0	0	12	132	65	67
PCT9703	ED	991	142	0	0	6	136	95	41
PCT9703	TO	991	286	0	0	18	268	160	108
PCT9704	MV	959	150	0	0	9	141	89	52
PCT9704	ED	959	196	0	0	10	186	141	45
PCT9704	TO	959	346	0	0	19	327	230	97
PCT9705	MV	929	155	0	0	10	145	101	44
PCT9705	ED	929	142	0	0	11	131	107	24
PCT9705	TO	929	297	0	0	21	276	208	68
PCT9706	MV	49	7	0	0	0	7	4	3
PCT9706	ED	49	0	0	0	0	0	0	0
PCT9706	TO	49	7	0	0	0	7	4	3
PCT9707	MV	826	138	0	0	8	130	70	60
PCT9707	ED	826	101	0	0	8	93	61	32
PCT9707	TO	826	239	0	0	16	223	131	92
PCT9708	MV	961	159	0	1	15	143	89	54
PCT9708	ED	961	157	0	0	5	152	110	42
PCT9708	TO	961	316	0	1	20	295	199	96
PCT9709	MV	1040	139	0	0	7	132	65	67
PCT9709	ED	1040	178	0	0	7	171	110	61
PCT9709	TO	1040	317	0	0	14	303	175	128
PCT9711	MV	646	119	0	0	5	114	62	52
PCT9711	ED	646	138	0	0	6	132	85	47
PCT9711	TO	646	257	0	0	11	246	147	99
PCT9712	MV	661	125	0	0	8	117	60	57
PCT9712	ED	661	116	0	0	3	113	69	44
PCT9712	TO	661	241	0	0	11	230	129	101
PCT9713	MV	950	157	0	0	5	152	80	72
PCT9713	ED	950	137	0	0	6	131	85	46
PCT9713	TO	950	294	0	0	11	283	165	118
PCT9714	MV	951	181	0	0	9	172	80	92
PCT9714	ED	951	133	0	0	2	131	80	51
PCT9714	TO	951	314	0	0	11	303	160	143
PCT9715	MV	579	100	0	0	7	93	43	50
PCT9715	ED	579	134	0	0	3	131	89	42
PCT9715	TO	579	234	0	0	10	224	132	92
PCT9716	MV	966	152	0	0	8	144	78	66
PCT9716	ED	966	164	0	0	10	154	102	52
PCT9716	TO	966	316	0	0	18	298	180	118
PCT9717	MV	977	138	0	0	6	132	70	62
PCT9717	ED	977	144	0	0	13	131	80	51
PCT9717	TO	977	282	0	0	19	263	150	113
PCT9718	MV	901	171	0	0	13	158	92	66
PCT9718	ED	901	144	0	0	6	138	85	53
PCT9718	TO	901	315	0	0	19	296	177	119
PCT9719	MV	920	153	0	0	5	148	74	74
PCT9719	ED	920	150	0	0	8	142	86	56
PCT9719	TO	920	303	0	0	13	290	160	130
PCT9721	MV	662	91	0	0	3	88	44	44
PCT9721	ED	662	133	0	0	5	128	73	55
PCT9721	TO	662	224	0	0	8	216	117	99
PCT9722	MV	597	135	0	0	5	130	74	56
PCT9722	ED	597	76	0	0	5	71	45	26
PCT9722	TO	597	211	0	0	10	201	119	82
PCT9723	MV	508	107	0	0	3	104	32	72
PCT9723	ED	508	44	0	0	3	41	20	21
PCT9723	TO	508	151	0	0	6	145	52	93
PCT9724	MV	1020	189	0	0	9	180	85	95
PCT9724	ED	1020	99	0	0	4	95	54	41
PCT9724	TO	1020	288	0	0	13	275	139	136
PCT9725	MV	971	166	0	0	6	160	59	101
PCT9725	ED	971	95	0	0	10	85	35	50
PCT9725	TO	971	261	0	0	16	245	94	151
PCT9726	MV	616	62	0	0	4	58	42	16
PCT9726	ED	616	102	0	0	6	96	71	25
PCT9726	TO	616	164	0	0	10	154	113	41
PCT9727	MV	460	89	0	0	1	88	35	53
PCT9727	ED	460	33	0	0	2	31	19	12
PCT9727	TO	460	122	0	0	3	119	54	65
PCT9728	MV	963	178	0	0	7	171	71	100
PCT9728	ED	963	137	0	0	8	129	78	51
PCT9728	TO	963	315	0	0	15	300	149	151
PCT9729	MV	818	148	0	0	10	138	62	76
PCT9729	ED	818	128	0	0	3	125	78	47
PCT9729	TO	818	276	0	0	13	263	140	123
PCT9731	MV	579	86	0	0	6	80	26	54
PCT9731	ED	579	111	0	0	9	102	59	43
PCT9731	TO	579	197	0	0	15	182	85	97
PCT9732	MV	73	16	0	0	0	16	8	8
PCT9732	ED	73	0	0	0	0	0	0	0
PCT9732	TO	73	16	0	0	0	16	8	8
PCT9733	MV	240	55	0	0	3	52	41	11
PCT9733	ED	240	0	0	0	0	0	0	0
PCT9733	TO	240	55	0	0	3	52	41	11
PCT9734	MV	604	111	0	0	7	104	48	56
PCT9734	ED	604	109	0	0	3	106	66	40
PCT9734	TO	604	220	0	0	10	210	114	96
PCT9735	MV	820	140	0	0	5	135	71	64
PCT9735	ED	820	132	0	0	16	116	66	50
PCT9735	TO	820	272	0	0	21	251	137	114
PCT9736	MV	736	126	0	0	11	115	72	43
PCT9736	ED	736	151	0	0	10	141	94	47
PCT9736	TO	736	277	0	0	21	256	166	90
PCT9737	MV	791	172	0	0	9	163	87	76
PCT9737	ED	791	135	0	0	7	128	90	38
PCT9737	TO	791	307	0	0	16	291	177	114
PCT9738	MV	838	152	0	0	12	140	97	43
PCT9738	ED	838	64	0	0	5	59	41	18
PCT9738	TO	838	216	0	0	17	199	138	61
PCT9739	MV	789	86	0	0	1	85	60	25
PCT9739	ED	789	88	0	0	3	85	71	14
PCT9739	TO	789	174	0	0	4	170	131	39
PCT9741	MV	441	15	0	0	1	14	13	1
PCT9741	ED	441	10	0	0	2	8	8	0
PCT9741	TO	441	25	0	0	3	22	21	1
PCT9742	MV	695	86	0	0	3	83	30	53
PCT9742	ED	695	98	0	0	6	92	48	44
PCT9742	TO	695	184	0	0	9	175	78	97
PCT9743	MV	1140	161	0	0	8	153	99	54
PCT9743	ED	1140	170	0	0	13	157	130	27
PCT9743	TO	1140	331	0	0	21	310	229	81
PCT9744	MV	943	141	0	0	7	134	96	38
PCT9744	ED	943	121	0	0	9	112	93	19
PCT9744	TO	943	262	0	0	16	246	189	57
PCT9745	MV	992	120	0	0	7	113	88	25
PCT9745	ED	992	128	0	0	11	117	104	13
PCT9745	TO	992	248	0	0	18	230	192	38
PCT9746	MV	903	146	0	0	3	143	83	60
PCT9746	ED	903	118	0	0	11	107	66	41
PCT9746	TO	903	264	0	0	14	250	149	101
PCT9747	MV	976	132	0	0	5	127	83	44
PCT9747	ED	976	145	0	0	10	135	103	32
PCT9747	TO	976	277	0	0	15	262	186	76
PCT9748	MV	913	149	0	0	3	146	93	53
PCT9748	ED	913	116	0	0	4	112	68	44
PCT9748	TO	913	265	0	0	7	258	161	97
PCT9749	MV	938	99	0	0	3	96	65	31
PCT9749	ED	938	108	0	0	2	106	82	24
PCT9749	TO	938	207	0	0	5	202	147	55
PCT9751	MV	1071	174	0	1	10	163	94	69
PCT9751	ED	1071	151	0	0	15	136	99	37
PCT9751	TO	1071	325	0	1	25	299	193	106
PCT9752	MV	697	145	0	0	7	138	69	69
PCT9752	ED	697	108	0	0	3	105	77	28
PCT9752	TO	697	253	0	0	10	243	146	97
PCT9753	MV	762	108	0	0	9	99	70	29
PCT9753	ED	762	123	0	0	2	121	98	23
PCT9753	TO	762	231	0	0	11	220	168	52
PCT9754	MV	707	104	0	0	4	100	65	35
PCT9754	ED	707	113	0	0	8	105	86	19
PCT9754	TO	707	217	0	0	12	205	151	54
PCT9755	MV	580	86	0	0	7	79	49	30
PCT9755	ED	580	99	0	0	2	97	71	26
PCT9755	TO	580	185	0	0	9	176	120	56
PCT9756	MV	967	158	0	0	10	148	71	77
PCT9756	ED	967	106	0	0	5	101	71	30
PCT9756	TO	967	264	0	0	15	249	142	107
PCT9801	MV	408	63	0	0	6	57	41	16
PCT9801	ED	408	52	0	0	3	49	41	8
PCT9801	TO	408	115	0	0	9	106	82	24
PCT9900	MV	0	0	0	0	0	0	0	0
PCT9900	ED	0	0	0	0	0	0	0	0
PCT9900	TO	0	0	0	0	0	0	0	0
PCT9901	MV	0	0	0	0	0	0	0	0
PCT9901	ED	0	0	0	0	0	0	0	0
PCT9901	TO	0	0	0	0	0	0	0	0
PCT9902	MV	0	0	0	0	0	0	0	0
PCT9902	ED	0	0	0	0	0	0	0	0
PCT9902	TO	0	0	0	0	0	0	0	0
