area_id	subtotal_type	RSReg	RSCst	RSRej	RSOvr	RSUnd	RSTot	3:YES	4:NO
ALLPCTS	TO	503899	265563	0	47	18912	246604	176243	70361
ALLPCTS	ED	101847	72177	0	9	5086	67082	51209	15873
ALLPCTS	MV	402052	193386	0	38	13826	179522	125034	54488
PCT1101	MV	447	211	0	0	15	196	125	71
PCT1101	ED	115	60	0	0	3	57	45	12
PCT1101	TO	562	271	0	0	18	253	170	83
PCT1102	MV	771	364	0	0	19	345	225	120
PCT1102	ED	233	158	0	0	10	148	106	42
PCT1102	TO	1004	522	0	0	29	493	331	162
PCT1103	MV	748	360	0	0	19	341	231	110
PCT1103	ED	223	142	0	0	6	136	103	33
PCT1103	TO	971	502	0	0	25	477	334	143
PCT1104	MV	750	340	0	0	13	327	236	91
PCT1104	ED	268	119	0	0	5	114	84	30
PCT1104	TO	1018	459	0	0	18	441	320	121
PCT1106	MV	597	246	0	0	11	235	129	106
PCT1106	ED	174	96	0	0	5	91	68	23
PCT1106	TO	771	342	0	0	16	326	197	129
PCT1107	MV	606	281	0	0	16	265	168	97
PCT1107	ED	145	76	0	0	5	71	53	18
PCT1107	TO	751	357	0	0	21	336	221	115
PCT1108	MV	721	350	0	0	20	330	230	100
PCT1108	ED	202	114	0	0	12	102	73	29
PCT1108	TO	923	464	0	0	32	432	303	129
PCT1109	MV	650	278	0	0	14	264	154	110
PCT1109	ED	172	97	0	0	4	93	71	22
PCT1109	TO	822	375	0	0	18	357	225	132
PCT1111	MV	845	346	0	0	17	329	197	132
PCT1111	ED	201	118	0	0	4	114	91	23
PCT1111	TO	1046	464	0	0	21	443	288	155
PCT1112	MV	642	271	0	0	14	257	173	84
PCT1112	ED	160	76	0	0	4	72	57	15
PCT1112	TO	802	347	0	0	18	329	230	99
PCT1113	MV	674	280	0	0	12	268	170	98
PCT1113	ED	121	65	0	0	6	59	44	15
PCT1113	TO	795	345	0	0	18	327	214	113
PCT1114	MV	768	324	0	0	22	302	221	81
PCT1114	ED	223	97	0	0	10	87	72	15
PCT1114	TO	991	421	0	0	32	389	293	96
PCT1115	MV	741	287	0	0	15	272	171	101
PCT1115	ED	195	85	0	0	3	82	67	15
PCT1115	TO	936	372	0	0	18	354	238	116
PCT1116	MV	709	305	0	0	16	289	184	105
PCT1116	ED	222	118	0	0	6	112	95	17
PCT1116	TO	931	423	0	0	22	401	279	122
PCT1117	MV	659	250	0	0	14	236	156	80
PCT1117	ED	187	71	0	0	2	69	53	16
PCT1117	TO	846	321	0	0	16	305	209	96
PCT1118	MV	843	353	0	1	10	342	218	124
PCT1118	ED	222	100	0	0	8	92	64	28
PCT1118	TO	1065	453	0	1	18	434	282	152
PCT1119	MV	659	302	0	0	11	291	202	89
PCT1119	ED	138	73	0	0	4	69	58	11
PCT1119	TO	797	375	0	0	15	360	260	100
PCT1121	MV	556	261	0	0	19	242	136	106
PCT1121	ED	149	81	0	0	6	75	47	28
PCT1121	TO	705	342	0	0	25	317	183	134
PCT1122	MV	519	243	0	0	18	225	115	110
PCT1122	ED	118	70	0	0	4	66	50	16
PCT1122	TO	637	313	0	0	22	291	165	126
PCT1123	MV	722	254	0	1	8	245	169	76
PCT1123	ED	216	89	0	0	6	83	66	17
PCT1123	TO	938	343	0	1	14	328	235	93
PCT1124	MV	621	240	0	2	7	231	141	90
PCT1124	ED	208	72	0	0	3	69	59	10
PCT1124	TO	829	312	0	2	10	300	200	100
PCT1125	MV	916	353	0	1	27	325	187	138
PCT1125	ED	181	65	0	0	6	59	49	10
PCT1125	TO	1097	418	0	1	33	384	236	148
PCT1126	MV	811	304	0	0	15	289	206	83
PCT1126	ED	201	68	0	0	3	65	49	16
PCT1126	TO	1012	372	0	0	18	354	255	99
PCT1127	MV	742	290	0	0	10	280	150	130
PCT1127	ED	223	99	0	0	3	96	69	27
PCT1127	TO	965	389	0	0	13	376	219	157
PCT1128	MV	733	292	0	0	13	279	155	124
PCT1128	ED	146	59	0	0	4	55	41	14
PCT1128	TO	879	351	0	0	17	334	196	138
PCT1129	MV	788	310	0	0	21	289	170	119
PCT1129	ED	248	108	0	0	13	95	68	27
PCT1129	TO	1036	418	0	0	34	384	238	146
PCT1131	MV	693	276	0	0	24	252	140	112
PCT1131	ED	167	60	0	0	4	56	46	10
PCT1131	TO	860	336	0	0	28	308	186	122
PCT1132	MV	837	368	0	0	26	342	213	129
PCT1132	ED	195	59	0	0	0	59	29	30
PCT1132	TO	1032	427	0	0	26	401	242	159
PCT1133	MV	716	332	0	0	9	323	206	117
PCT1133	ED	159	74	0	0	3	71	48	23
PCT1133	TO	875	406	0	0	12	394	254	140
PCT1134	MV	584	285	0	0	9	276	148	128
PCT1134	ED	183	80	0	0	8	72	61	11
PCT1134	TO	767	365	0	0	17	348	209	139
PCT1135	MV	464	216	0	0	6	210	127	83
PCT1135	ED	92	50	0	0	1	49	32	17
PCT1135	TO	556	266	0	0	7	259	159	100
PCT1136	MV	710	335	0	0	14	321	196	125
PCT1136	ED	157	77	0	0	9	68	51	17
PCT1136	TO	867	412	0	0	23	389	247	142
PCT1141	MV	836	387	0	0	20	367	234	133
PCT1141	ED	220	123	0	0	3	120	87	33
PCT1141	TO	1056	510	0	0	23	487	321	166
PCT1142	MV	721	322	0	0	27	295	199	96
PCT1142	ED	175	87	0	0	3	84	72	12
PCT1142	TO	896	409	0	0	30	379	271	108
PCT1143	MV	823	358	0	0	26	332	224	108
PCT1143	ED	226	113	0	0	6	107	88	19
PCT1143	TO	1049	471	0	0	32	439	312	127
PCT1144	MV	727	319	0	0	11	308	197	111
PCT1144	ED	220	121	0	0	10	111	80	31
PCT1144	TO	947	440	0	0	21	419	277	142
PCT1145	MV	752	411	0	0	25	386	251	135
PCT1145	ED	153	114	0	0	5	109	79	30
PCT1145	TO	905	525	0	0	30	495	330	165
PCT1146	MV	837	359	0	0	17	342	239	103
PCT1146	ED	217	109	0	0	6	103	79	24
PCT1146	TO	1054	468	0	0	23	445	318	127
PCT1147	MV	671	303	0	0	12	291	194	97
PCT1147	ED	214	107	0	0	5	102	76	26
PCT1147	TO	885	410	0	0	17	393	270	123
PCT1148	MV	804	364	0	0	18	346	208	138
PCT1148	ED	224	116	0	0	6	110	82	28
PCT1148	TO	1028	480	0	0	24	456	290	166
PCT1149	MV	709	316	0	0	22	294	189	105
PCT1149	ED	230	118	0	0	9	109	80	29
PCT1149	TO	939	434	0	0	31	403	269	134
PCT1151	MV	0	0	0	0	0	0	0	0
PCT1151	ED	0	0	0	0	0	0	0	0
PCT1151	TO	0	0	0	0	0	0	0	0
PCT1152	MV	710	308	0	0	18	290	205	85
PCT1152	ED	180	85	0	0	6	79	58	21
PCT1152	TO	890	393	0	0	24	369	263	106
PCT1153	MV	730	283	0	0	18	265	183	82
PCT1153	ED	210	116	0	0	7	109	64	45
PCT1153	TO	940	399	0	0	25	374	247	127
PCT1154	MV	0	0	0	0	0	0	0	0
PCT1154	ED	0	0	0	0	0	0	0	0
PCT1154	TO	0	0	0	0	0	0	0	0
PCT7001	MV	632	322	0	0	21	301	224	77
PCT7001	ED	141	101	0	0	7	94	80	14
PCT7001	TO	773	423	0	0	28	395	304	91
PCT7002	MV	598	259	0	1	22	236	173	63
PCT7002	ED	116	88	0	0	5	83	68	15
PCT7002	TO	714	347	0	1	27	319	241	78
PCT7003	MV	759	427	0	0	29	398	296	102
PCT7003	ED	147	144	0	0	12	132	99	33
PCT7003	TO	906	571	0	0	41	530	395	135
PCT7004	MV	764	411	0	0	29	382	287	95
PCT7004	ED	149	142	0	0	12	130	103	27
PCT7004	TO	913	553	0	0	41	512	390	122
PCT7005	MV	697	342	0	0	25	317	247	70
PCT7005	ED	162	162	0	0	20	142	116	26
PCT7005	TO	859	504	0	0	45	459	363	96
PCT7006	MV	728	349	0	0	26	323	249	74
PCT7006	ED	204	149	0	0	7	142	113	29
PCT7006	TO	932	498	0	0	33	465	362	103
PCT7007	MV	777	427	0	0	33	394	278	116
PCT7007	ED	180	168	0	0	14	154	125	29
PCT7007	TO	957	595	0	0	47	548	403	145
PCT7008	MV	732	362	0	0	39	323	233	90
PCT7008	ED	177	189	0	0	11	178	138	40
PCT7008	TO	909	551	0	0	50	501	371	130
PCT7009	MV	752	387	0	0	23	364	265	99
PCT7009	ED	119	91	0	0	4	87	58	29
PCT7009	TO	871	478	0	0	27	451	323	128
PCT7011	MV	703	228	0	0	15	213	158	55
PCT7011	ED	270	87	0	0	4	83	67	16
PCT7011	TO	973	315	0	0	19	296	225	71
PCT7012	MV	999	479	0	0	35	444	332	112
PCT7012	ED	227	203	0	0	17	186	150	36
PCT7012	TO	1226	682	0	0	52	630	482	148
PCT7013	MV	984	271	0	0	19	252	189	63
PCT7013	ED	155	151	0	0	15	136	114	22
PCT7013	TO	1139	422	0	0	34	388	303	85
PCT7014	MV	609	295	0	0	30	265	212	53
PCT7014	ED	110	111	0	0	15	96	81	15
PCT7014	TO	719	406	0	0	45	361	293	68
PCT7015	MV	128	39	0	0	4	35	31	4
PCT7015	ED	-18	0	0	0	0	0	0	0
PCT7015	TO	110	39	0	0	4	35	31	4
PCT7016	MV	654	235	0	0	16	219	144	75
PCT7016	ED	278	75	0	0	6	69	55	14
PCT7016	TO	932	310	0	0	22	288	199	89
PCT7017	MV	543	182	0	0	17	165	129	36
PCT7017	ED	238	53	0	0	6	47	42	5
PCT7017	TO	781	235	0	0	23	212	171	41
PCT7018	MV	847	353	0	0	23	330	205	125
PCT7018	ED	200	56	0	0	4	52	47	5
PCT7018	TO	1047	409	0	0	27	382	252	130
PCT7019	MV	733	351	0	0	23	328	208	120
PCT7019	ED	167	73	0	0	8	65	54	11
PCT7019	TO	900	424	0	0	31	393	262	131
PCT7021	MV	679	268	0	0	15	253	195	58
PCT7021	ED	288	106	0	0	7	99	86	13
PCT7021	TO	967	374	0	0	22	352	281	71
PCT7022	MV	770	301	0	1	22	278	213	65
PCT7022	ED	193	54	0	0	1	53	44	9
PCT7022	TO	963	355	0	1	23	331	257	74
PCT7023	MV	687	328	0	0	18	310	232	78
PCT7023	ED	233	71	0	0	5	66	54	12
PCT7023	TO	920	399	0	0	23	376	286	90
PCT7024	MV	251	50	0	0	2	48	43	5
PCT7024	ED	190	20	0	0	3	17	17	0
PCT7024	TO	441	70	0	0	5	65	60	5
PCT7025	MV	316	93	0	0	4	89	74	15
PCT7025	ED	167	39	0	0	1	38	32	6
PCT7025	TO	483	132	0	0	5	127	106	21
PCT7026	MV	818	332	0	0	14	318	167	151
PCT7026	ED	192	72	0	0	3	69	54	15
PCT7026	TO	1010	404	0	0	17	387	221	166
PCT7027	MV	676	266	0	0	14	252	160	92
PCT7027	ED	220	96	0	0	4	92	73	19
PCT7027	TO	896	362	0	0	18	344	233	111
PCT7028	MV	585	215	0	0	15	200	154	46
PCT7028	ED	271	97	0	0	5	92	75	17
PCT7028	TO	856	312	0	0	20	292	229	63
PCT7029	MV	642	205	0	0	15	190	149	41
PCT7029	ED	267	39	0	0	1	38	31	7
PCT7029	TO	909	244	0	0	16	228	180	48
PCT7030	MV	654	274	0	0	11	263	146	117
PCT7030	ED	141	58	0	0	3	55	30	25
PCT7030	TO	795	332	0	0	14	318	176	142
PCT7031	MV	621	257	0	0	24	233	153	80
PCT7031	ED	73	48	0	0	4	44	32	12
PCT7031	TO	694	305	0	0	28	277	185	92
PCT7032	MV	642	264	0	0	18	246	174	72
PCT7032	ED	239	51	0	0	2	49	42	7
PCT7032	TO	881	315	0	0	20	295	216	79
PCT7033	MV	549	210	0	0	17	193	136	57
PCT7033	ED	229	86	0	0	5	81	63	18
PCT7033	TO	778	296	0	0	22	274	199	75
PCT7034	MV	620	136	0	0	15	121	108	13
PCT7034	ED	318	57	0	0	3	54	47	7
PCT7034	TO	938	193	0	0	18	175	155	20
PCT7035	MV	567	232	0	0	20	212	147	65
PCT7035	ED	152	52	0	0	5	47	39	8
PCT7035	TO	719	284	0	0	25	259	186	73
PCT7036	MV	780	259	0	0	16	243	158	85
PCT7036	ED	194	39	0	0	1	38	28	10
PCT7036	TO	974	298	0	0	17	281	186	95
PCT7037	MV	433	62	0	0	0	62	49	13
PCT7037	ED	313	38	0	0	5	33	32	1
PCT7037	TO	746	100	0	0	5	95	81	14
PCT7038	MV	758	304	0	0	15	289	173	116
PCT7038	ED	203	58	0	0	8	50	39	11
PCT7038	TO	961	362	0	0	23	339	212	127
PCT7039	MV	636	240	0	0	16	224	126	98
PCT7039	ED	201	104	0	0	5	99	63	36
PCT7039	TO	837	344	0	0	21	323	189	134
PCT7041	MV	70	29	0	0	3	26	16	10
PCT7041	ED	-4	0	0	0	0	0	0	0
PCT7041	TO	66	29	0	0	3	26	16	10
PCT7042	MV	514	219	0	0	11	208	141	67
PCT7042	ED	146	58	0	0	2	56	41	15
PCT7042	TO	660	277	0	0	13	264	182	82
PCT7043	MV	754	290	0	0	21	269	174	95
PCT7043	ED	224	78	0	0	1	77	53	24
PCT7043	TO	978	368	0	0	22	346	227	119
PCT7044	MV	586	133	0	0	3	130	93	37
PCT7044	ED	266	33	0	0	2	31	26	5
PCT7044	TO	852	166	0	0	5	161	119	42
PCT7045	MV	632	264	0	0	16	248	146	102
PCT7045	ED	154	53	0	0	3	50	36	14
PCT7045	TO	786	317	0	0	19	298	182	116
PCT7046	MV	334	130	0	0	9	121	72	49
PCT7046	ED	96	48	0	0	3	45	34	11
PCT7046	TO	430	178	0	0	12	166	106	60
PCT7047	MV	730	309	0	0	11	298	175	123
PCT7047	ED	153	62	0	0	3	59	46	13
PCT7047	TO	883	371	0	0	14	357	221	136
PCT7048	MV	685	263	0	0	15	248	174	74
PCT7048	ED	196	56	0	0	4	52	41	11
PCT7048	TO	881	319	0	0	19	300	215	85
PCT7049	MV	616	239	0	0	13	226	127	99
PCT7049	ED	210	70	0	0	10	60	39	21
PCT7049	TO	826	309	0	0	23	286	166	120
PCT7051	MV	715	301	0	0	20	281	153	128
PCT7051	ED	165	70	0	0	6	64	45	19
PCT7051	TO	880	371	0	0	26	345	198	147
PCT7052	MV	721	291	0	0	12	279	153	126
PCT7052	ED	185	84	0	0	3	81	65	16
PCT7052	TO	906	375	0	0	15	360	218	142
PCT7053	MV	542	226	0	0	31	195	100	95
PCT7053	ED	43	40	0	0	4	36	27	9
PCT7053	TO	585	266	0	0	35	231	127	104
PCT7054	MV	862	305	0	0	20	285	216	69
PCT7054	ED	274	105	0	0	3	102	71	31
PCT7054	TO	1136	410	0	0	23	387	287	100
PCT7055	MV	732	289	0	0	21	268	180	88
PCT7055	ED	94	76	0	0	8	68	52	16
PCT7055	TO	826	365	0	0	29	336	232	104
PCT7056	MV	618	269	0	0	23	246	178	68
PCT7056	ED	87	119	0	0	12	107	83	24
PCT7056	TO	705	388	0	0	35	353	261	92
PCT7101	MV	162	99	0	0	6	93	84	9
PCT7101	ED	-15	0	0	0	0	0	0	0
PCT7101	TO	147	99	0	0	6	93	84	9
PCT7201	MV	788	374	0	0	29	345	223	122
PCT7201	ED	147	98	0	0	12	86	64	22
PCT7201	TO	935	472	0	0	41	431	287	144
PCT7202	MV	707	303	0	0	29	274	178	96
PCT7202	ED	144	123	0	0	12	111	83	28
PCT7202	TO	851	426	0	0	41	385	261	124
PCT7203	MV	693	316	0	0	34	282	184	98
PCT7203	ED	186	148	0	0	18	130	97	33
PCT7203	TO	879	464	0	0	52	412	281	131
PCT7204	MV	773	411	0	0	44	367	259	108
PCT7204	ED	126	116	0	0	18	98	68	30
PCT7204	TO	899	527	0	0	62	465	327	138
PCT7205	MV	724	357	0	1	26	330	222	108
PCT7205	ED	147	133	0	0	16	117	86	31
PCT7205	TO	871	490	0	1	42	447	308	139
PCT7206	MV	299	127	0	0	8	119	82	37
PCT7206	ED	78	76	0	0	3	73	52	21
PCT7206	TO	377	203	0	0	11	192	134	58
PCT7207	MV	744	329	0	0	28	301	193	108
PCT7207	ED	123	117	0	0	11	106	83	23
PCT7207	TO	867	446	0	0	39	407	276	131
PCT7208	MV	492	248	0	0	27	221	153	68
PCT7208	ED	78	60	0	0	5	55	47	8
PCT7208	TO	570	308	0	0	32	276	200	76
PCT7209	MV	595	338	0	0	25	313	217	96
PCT7209	ED	52	63	0	0	4	59	46	13
PCT7209	TO	647	401	0	0	29	372	263	109
PCT7301	MV	812	312	0	0	21	291	204	87
PCT7301	ED	202	112	0	0	8	104	76	28
PCT7301	TO	1014	424	0	0	29	395	280	115
PCT7302	MV	713	345	0	0	28	317	212	105
PCT7302	ED	136	116	0	0	10	106	79	27
PCT7302	TO	849	461	0	0	38	423	291	132
PCT7303	MV	869	370	0	0	23	347	235	112
PCT7303	ED	199	141	0	0	10	131	108	23
PCT7303	TO	1068	511	0	0	33	478	343	135
PCT7304	MV	802	359	0	0	28	331	220	111
PCT7304	ED	199	163	0	0	11	152	117	35
PCT7304	TO	1001	522	0	0	39	483	337	146
PCT7305	MV	713	372	0	0	25	347	208	139
PCT7305	ED	154	141	0	0	8	133	96	37
PCT7305	TO	867	513	0	0	33	480	304	176
PCT7306	MV	801	365	0	0	44	321	195	126
PCT7306	ED	243	152	0	0	15	137	106	31
PCT7306	TO	1044	517	0	0	59	458	301	157
PCT7307	MV	605	264	0	0	13	251	166	85
PCT7307	ED	169	101	0	0	10	91	69	22
PCT7307	TO	774	365	0	0	23	342	235	107
PCT7308	MV	520	249	0	0	12	237	161	76
PCT7308	ED	105	126	0	1	8	117	88	29
PCT7308	TO	625	375	0	1	20	354	249	105
PCT7309	MV	691	317	0	0	30	287	196	91
PCT7309	ED	167	156	0	0	12	144	111	33
PCT7309	TO	858	473	0	0	42	431	307	124
PCT7311	MV	698	325	0	0	27	298	214	84
PCT7311	ED	208	169	0	0	11	158	130	28
PCT7311	TO	906	494	0	0	38	456	344	112
PCT7312	MV	699	384	0	0	28	356	227	129
PCT7312	ED	111	120	0	0	8	112	78	34
PCT7312	TO	810	504	0	0	36	468	305	163
PCT7313	MV	818	365	0	0	22	343	225	118
PCT7313	ED	185	115	0	0	16	99	71	28
PCT7313	TO	1003	480	0	0	38	442	296	146
PCT7314	MV	612	222	0	0	25	197	136	61
PCT7314	ED	147	56	0	0	5	51	39	12
PCT7314	TO	759	278	0	0	30	248	175	73
PCT7315	MV	570	202	0	0	14	188	125	63
PCT7315	ED	195	117	0	0	5	112	87	25
PCT7315	TO	765	319	0	0	19	300	212	88
PCT7316	MV	654	255	0	0	29	226	154	72
PCT7316	ED	178	100	0	0	15	85	68	17
PCT7316	TO	832	355	0	0	44	311	222	89
PCT7317	MV	744	339	0	1	23	315	202	113
PCT7317	ED	146	107	0	0	14	93	79	14
PCT7317	TO	890	446	0	1	37	408	281	127
PCT7318	MV	605	289	0	0	34	255	167	88
PCT7318	ED	118	99	0	0	15	84	51	33
PCT7318	TO	723	388	0	0	49	339	218	121
PCT7319	MV	861	340	0	0	25	315	212	103
PCT7319	ED	188	113	0	1	15	97	66	31
PCT7319	TO	1049	453	0	1	40	412	278	134
PCT7321	MV	557	200	0	0	19	181	111	70
PCT7321	ED	102	62	0	0	5	57	41	16
PCT7321	TO	659	262	0	0	24	238	152	86
PCT7322	MV	742	292	0	0	33	259	180	79
PCT7322	ED	146	25	0	0	3	22	20	2
PCT7322	TO	888	317	0	0	36	281	200	81
PCT7323	MV	789	362	0	0	43	319	218	101
PCT7323	ED	167	126	0	0	12	114	91	23
PCT7323	TO	956	488	0	0	55	433	309	124
PCT7324	MV	586	253	0	0	28	225	153	72
PCT7324	ED	151	88	0	0	10	78	50	28
PCT7324	TO	737	341	0	0	38	303	203	100
PCT7325	MV	714	315	0	0	35	280	194	86
PCT7325	ED	172	121	0	0	10	111	81	30
PCT7325	TO	886	436	0	0	45	391	275	116
PCT7326	MV	685	298	0	0	28	270	187	83
PCT7326	ED	174	116	0	1	18	97	70	27
PCT7326	TO	859	414	0	1	46	367	257	110
PCT7327	MV	561	224	0	0	26	198	127	71
PCT7327	ED	126	37	0	0	1	36	30	6
PCT7327	TO	687	261	0	0	27	234	157	77
PCT7328	MV	829	321	0	0	52	269	174	95
PCT7328	ED	173	46	0	0	5	41	31	10
PCT7328	TO	1002	367	0	0	57	310	205	105
PCT7329	MV	556	222	0	0	24	198	137	61
PCT7329	ED	95	56	0	0	5	51	37	14
PCT7329	TO	651	278	0	0	29	249	174	75
PCT7331	MV	710	358	0	0	33	325	222	103
PCT7331	ED	160	129	0	0	15	114	80	34
PCT7331	TO	870	487	0	0	48	439	302	137
PCT7332	MV	654	256	0	0	20	236	180	56
PCT7332	ED	136	113	0	0	4	109	90	19
PCT7332	TO	790	369	0	0	24	345	270	75
PCT7333	MV	822	385	0	0	39	346	241	105
PCT7333	ED	193	161	0	0	11	150	116	34
PCT7333	TO	1015	546	0	0	50	496	357	139
PCT7334	MV	686	301	0	0	18	283	219	64
PCT7334	ED	133	105	0	0	6	99	78	21
PCT7334	TO	819	406	0	0	24	382	297	85
PCT7335	MV	788	385	0	0	38	347	224	123
PCT7335	ED	146	144	0	0	11	133	106	27
PCT7335	TO	934	529	0	0	49	480	330	150
PCT7336	MV	778	396	0	1	26	369	222	147
PCT7336	ED	176	128	0	0	15	113	81	32
PCT7336	TO	954	524	0	1	41	482	303	179
PCT7337	MV	772	379	0	0	40	339	224	115
PCT7337	ED	125	84	0	0	4	80	57	23
PCT7337	TO	897	463	0	0	44	419	281	138
PCT7338	MV	769	353	0	0	39	314	200	114
PCT7338	ED	126	70	0	0	7	63	51	12
PCT7338	TO	895	423	0	0	46	377	251	126
PCT7339	MV	605	262	0	0	23	239	181	58
PCT7339	ED	150	89	0	0	4	85	67	18
PCT7339	TO	755	351	0	0	27	324	248	76
PCT7341	MV	675	288	0	1	32	255	185	70
PCT7341	ED	178	131	0	0	8	123	100	23
PCT7341	TO	853	419	0	1	40	378	285	93
PCT7342	MV	673	316	0	0	17	299	228	71
PCT7342	ED	231	200	0	0	17	183	146	37
PCT7342	TO	904	516	0	0	34	482	374	108
PCT7343	MV	554	242	0	0	20	222	189	33
PCT7343	ED	150	116	0	0	11	105	88	17
PCT7343	TO	704	358	0	0	31	327	277	50
PCT7344	MV	863	378	0	0	27	351	256	95
PCT7344	ED	201	160	0	0	9	151	108	43
PCT7344	TO	1064	538	0	0	36	502	364	138
PCT7345	MV	903	418	0	0	35	383	289	94
PCT7345	ED	211	170	0	0	11	159	126	33
PCT7345	TO	1114	588	0	0	46	542	415	127
PCT7346	MV	680	280	0	0	20	260	202	58
PCT7346	ED	209	126	0	0	12	114	95	19
PCT7346	TO	889	406	0	0	32	374	297	77
PCT7347	MV	833	356	0	1	36	319	281	38
PCT7347	ED	170	98	0	0	6	92	79	13
PCT7347	TO	1003	454	0	1	42	411	360	51
PCT7348	MV	649	268	0	0	19	249	195	54
PCT7348	ED	194	100	0	0	7	93	75	18
PCT7348	TO	843	368	0	0	26	342	270	72
PCT7349	MV	710	310	0	0	22	288	200	88
PCT7349	ED	202	104	0	0	9	95	75	20
PCT7349	TO	912	414	0	0	31	383	275	108
PCT7501	MV	456	241	0	0	28	213	134	79
PCT7501	ED	95	90	0	0	10	80	58	22
PCT7501	TO	551	331	0	0	38	293	192	101
PCT7502	MV	668	310	0	0	27	283	203	80
PCT7502	ED	121	99	0	0	10	89	65	24
PCT7502	TO	789	409	0	0	37	372	268	104
PCT7503	MV	614	281	0	0	22	259	200	59
PCT7503	ED	148	100	0	0	12	88	70	18
PCT7503	TO	762	381	0	0	34	347	270	77
PCT7504	MV	404	173	0	0	15	158	126	32
PCT7504	ED	84	52	0	0	4	48	35	13
PCT7504	TO	488	225	0	0	19	206	161	45
PCT7505	MV	729	397	0	0	31	366	290	76
PCT7505	ED	133	96	0	0	3	93	77	16
PCT7505	TO	862	493	0	0	34	459	367	92
PCT7506	MV	842	360	0	0	41	319	239	80
PCT7506	ED	158	111	0	0	9	102	87	15
PCT7506	TO	1000	471	0	0	50	421	326	95
PCT7507	MV	693	286	0	0	19	267	221	46
PCT7507	ED	263	95	0	0	4	91	79	12
PCT7507	TO	956	381	0	0	23	358	300	58
PCT7508	MV	618	370	0	0	38	332	244	88
PCT7508	ED	126	103	0	0	7	96	80	16
PCT7508	TO	744	473	0	0	45	428	324	104
PCT7509	MV	756	396	0	0	28	368	277	91
PCT7509	ED	173	145	0	0	9	136	107	29
PCT7509	TO	929	541	0	0	37	504	384	120
PCT7512	MV	475	245	0	0	21	224	161	63
PCT7512	ED	125	85	0	0	9	76	62	14
PCT7512	TO	600	330	0	0	30	300	223	77
PCT7513	MV	575	243	0	0	25	218	180	38
PCT7513	ED	231	107	0	0	13	94	82	12
PCT7513	TO	806	350	0	0	38	312	262	50
PCT7514	MV	709	238	0	0	28	210	161	49
PCT7514	ED	207	59	0	0	11	48	43	5
PCT7514	TO	916	297	0	0	39	258	204	54
PCT7515	MV	663	311	0	0	20	291	209	82
PCT7515	ED	201	90	0	0	11	79	69	10
PCT7515	TO	864	401	0	0	31	370	278	92
PCT7516	MV	773	415	0	0	23	392	290	102
PCT7516	ED	147	118	0	0	3	115	85	30
PCT7516	TO	920	533	0	0	26	507	375	132
PCT7517	MV	645	354	0	0	31	323	256	67
PCT7517	ED	223	179	0	0	9	170	141	29
PCT7517	TO	868	533	0	0	40	493	397	96
PCT7518	MV	708	381	0	0	30	351	271	80
PCT7518	ED	218	185	0	0	14	171	150	21
PCT7518	TO	926	566	0	0	44	522	421	101
PCT7519	MV	543	254	0	0	27	227	184	43
PCT7519	ED	172	136	0	0	7	129	106	23
PCT7519	TO	715	390	0	0	34	356	290	66
PCT7521	MV	597	312	0	1	22	289	241	48
PCT7521	ED	182	149	0	0	4	145	121	24
PCT7521	TO	779	461	0	1	26	434	362	72
PCT7522	MV	588	291	0	0	22	269	223	46
PCT7522	ED	171	158	0	0	14	144	124	20
PCT7522	TO	759	449	0	0	36	413	347	66
PCT7523	MV	564	282	0	0	27	255	210	45
PCT7523	ED	180	169	0	0	8	161	130	31
PCT7523	TO	744	451	0	0	35	416	340	76
PCT7524	MV	480	221	0	0	25	196	168	28
PCT7524	ED	144	102	0	0	7	95	81	14
PCT7524	TO	624	323	0	0	32	291	249	42
PCT7525	MV	594	243	0	0	23	220	175	45
PCT7525	ED	170	94	0	0	7	87	81	6
PCT7525	TO	764	337	0	0	30	307	256	51
PCT7526	MV	825	390	0	0	45	345	283	62
PCT7526	ED	163	147	0	0	14	133	105	28
PCT7526	TO	988	537	0	0	59	478	388	90
PCT7527	MV	538	291	0	0	26	265	206	59
PCT7527	ED	172	112	0	0	4	108	88	20
PCT7527	TO	710	403	0	0	30	373	294	79
PCT7529	MV	748	361	0	0	19	342	291	51
PCT7529	ED	155	185	0	0	7	178	153	25
PCT7529	TO	903	546	0	0	26	520	444	76
PCT7531	MV	714	328	0	0	25	303	253	50
PCT7531	ED	159	132	0	0	4	128	104	24
PCT7531	TO	873	460	0	0	29	431	357	74
PCT7532	MV	668	325	0	0	29	296	228	68
PCT7532	ED	167	126	0	0	10	116	82	34
PCT7532	TO	835	451	0	0	39	412	310	102
PCT7533	MV	776	395	0	0	32	363	298	65
PCT7533	ED	194	185	0	0	18	167	141	26
PCT7533	TO	970	580	0	0	50	530	439	91
PCT7534	MV	670	363	0	0	32	331	257	74
PCT7534	ED	233	177	0	0	16	161	147	14
PCT7534	TO	903	540	0	0	48	492	404	88
PCT7535	MV	606	297	0	0	23	274	217	57
PCT7535	ED	139	151	0	0	17	134	119	15
PCT7535	TO	745	448	0	0	40	408	336	72
PCT7536	MV	670	337	0	0	21	316	260	56
PCT7536	ED	163	170	0	0	15	155	133	22
PCT7536	TO	833	507	0	0	36	471	393	78
PCT7537	MV	619	294	0	0	23	271	209	62
PCT7537	ED	126	148	0	1	8	139	115	24
PCT7537	TO	745	442	0	1	31	410	324	86
PCT7538	MV	562	313	0	0	19	294	236	58
PCT7538	ED	189	172	0	0	17	155	131	24
PCT7538	TO	751	485	0	0	36	449	367	82
PCT7539	MV	696	363	0	0	24	339	285	54
PCT7539	ED	225	187	0	0	10	177	156	21
PCT7539	TO	921	550	0	0	34	516	441	75
PCT7541	MV	600	289	0	0	27	262	205	57
PCT7541	ED	170	159	0	0	16	143	119	24
PCT7541	TO	770	448	0	0	43	405	324	81
PCT7542	MV	631	315	0	0	16	299	246	53
PCT7542	ED	193	166	0	0	6	160	133	27
PCT7542	TO	824	481	0	0	22	459	379	80
PCT7543	MV	694	365	0	0	15	350	287	63
PCT7543	ED	230	138	0	0	7	131	106	25
PCT7543	TO	924	503	0	0	22	481	393	88
PCT7544	MV	731	383	0	0	37	346	279	67
PCT7544	ED	168	159	0	0	16	143	120	23
PCT7544	TO	899	542	0	0	53	489	399	90
PCT7545	MV	723	385	0	0	26	359	286	73
PCT7545	ED	172	146	0	0	10	136	117	19
PCT7545	TO	895	531	0	0	36	495	403	92
PCT7546	MV	770	413	0	0	21	392	331	61
PCT7546	ED	183	209	0	0	16	193	155	38
PCT7546	TO	953	622	0	0	37	585	486	99
PCT7547	MV	796	413	0	0	33	380	324	56
PCT7547	ED	185	172	0	0	8	164	151	13
PCT7547	TO	981	585	0	0	41	544	475	69
PCT7548	MV	802	434	0	0	22	412	344	68
PCT7548	ED	249	201	0	0	10	191	161	30
PCT7548	TO	1051	635	0	0	32	603	505	98
PCT7549	MV	660	350	0	0	31	319	250	69
PCT7549	ED	146	140	0	0	15	125	104	21
PCT7549	TO	806	490	0	0	46	444	354	90
PCT7551	MV	587	295	0	0	16	279	222	57
PCT7551	ED	136	171	0	0	10	161	125	36
PCT7551	TO	723	466	0	0	26	440	347	93
PCT7552	MV	561	282	0	0	24	258	213	45
PCT7552	ED	124	127	0	0	11	116	97	19
PCT7552	TO	685	409	0	0	35	374	310	64
PCT7553	MV	211	94	0	0	7	87	68	19
PCT7553	ED	-20	0	0	0	0	0	0	0
PCT7553	TO	191	94	0	0	7	87	68	19
PCT7554	MV	653	372	0	0	28	344	259	85
PCT7554	ED	168	177	0	0	14	163	120	43
PCT7554	TO	821	549	0	0	42	507	379	128
PCT7555	MV	662	407	0	0	30	377	298	79
PCT7555	ED	210	210	0	0	15	195	162	33
PCT7555	TO	872	617	0	0	45	572	460	112
PCT7556	MV	813	505	0	0	29	476	359	117
PCT7556	ED	153	165	0	0	12	153	115	38
PCT7556	TO	966	670	0	0	41	629	474	155
PCT7601	MV	485	205	0	0	13	192	158	34
PCT7601	ED	192	89	0	0	10	79	67	12
PCT7601	TO	677	294	0	0	23	271	225	46
PCT7602	MV	654	271	0	0	20	251	215	36
PCT7602	ED	232	103	0	0	8	95	83	12
PCT7602	TO	886	374	0	0	28	346	298	48
PCT7603	MV	612	285	0	0	27	258	218	40
PCT7603	ED	203	167	0	0	10	157	132	25
PCT7603	TO	815	452	0	0	37	415	350	65
PCT7604	MV	685	261	0	0	18	243	207	36
PCT7604	ED	259	133	0	0	14	119	94	25
PCT7604	TO	944	394	0	0	32	362	301	61
PCT7605	MV	468	184	0	1	16	167	136	31
PCT7605	ED	193	62	0	0	5	57	50	7
PCT7605	TO	661	246	0	1	21	224	186	38
PCT7606	MV	673	263	0	0	26	237	195	42
PCT7606	ED	210	79	0	0	6	73	66	7
PCT7606	TO	883	342	0	0	32	310	261	49
PCT7607	MV	712	282	0	0	21	261	206	55
PCT7607	ED	207	100	0	0	5	95	80	15
PCT7607	TO	919	382	0	0	26	356	286	70
PCT7608	MV	279	96	0	0	9	87	64	23
PCT7608	ED	101	19	0	0	1	18	16	2
PCT7608	TO	380	115	0	0	10	105	80	25
PCT7609	MV	699	280	0	0	29	251	201	50
PCT7609	ED	185	49	0	1	3	45	38	7
PCT7609	TO	884	329	0	1	32	296	239	57
PCT7611	MV	586	230	0	0	15	215	185	30
PCT7611	ED	202	43	0	0	1	42	36	6
PCT7611	TO	788	273	0	0	16	257	221	36
PCT7612	MV	452	213	0	0	10	203	154	49
PCT7612	ED	105	29	0	0	1	28	21	7
PCT7612	TO	557	242	0	0	11	231	175	56
PCT7613	MV	634	236	0	0	16	220	187	33
PCT7613	ED	249	86	0	0	5	81	73	8
PCT7613	TO	883	322	0	0	21	301	260	41
PCT7614	MV	712	244	0	0	22	222	185	37
PCT7614	ED	204	78	0	0	4	74	58	16
PCT7614	TO	916	322	0	0	26	296	243	53
PCT7615	MV	510	162	0	0	8	154	124	30
PCT7615	ED	240	58	0	0	4	54	44	10
PCT7615	TO	750	220	0	0	12	208	168	40
PCT7616	MV	754	325	0	0	33	292	209	83
PCT7616	ED	82	86	0	0	8	78	59	19
PCT7616	TO	836	411	0	0	41	370	268	102
PCT7617	MV	583	218	0	0	20	198	163	35
PCT7617	ED	169	42	0	0	9	33	26	7
PCT7617	TO	752	260	0	0	29	231	189	42
PCT7618	MV	763	360	0	0	23	337	247	90
PCT7618	ED	151	84	0	0	9	75	53	22
PCT7618	TO	914	444	0	0	32	412	300	112
PCT7619	MV	937	432	0	0	27	405	312	93
PCT7619	ED	170	117	0	0	11	106	88	18
PCT7619	TO	1107	549	0	0	38	511	400	111
PCT7621	MV	1006	437	0	0	35	402	301	101
PCT7621	ED	149	103	0	0	9	94	72	22
PCT7621	TO	1155	540	0	0	44	496	373	123
PCT7622	MV	697	213	0	0	13	200	167	33
PCT7622	ED	263	73	0	0	10	63	55	8
PCT7622	TO	960	286	0	0	23	263	222	41
PCT7623	MV	767	255	0	1	22	232	200	32
PCT7623	ED	237	98	0	0	8	90	83	7
PCT7623	TO	1004	353	0	1	30	322	283	39
PCT7624	MV	651	205	0	0	11	194	160	34
PCT7624	ED	224	72	0	0	11	61	53	8
PCT7624	TO	875	277	0	0	22	255	213	42
PCT7625	MV	749	386	0	0	50	336	255	81
PCT7625	ED	73	34	0	0	1	33	27	6
PCT7625	TO	822	420	0	0	51	369	282	87
PCT7626	MV	944	396	0	0	43	353	235	118
PCT7626	ED	129	105	0	0	4	101	75	26
PCT7626	TO	1073	501	0	0	47	454	310	144
PCT7627	MV	456	194	0	0	17	177	106	71
PCT7627	ED	68	57	0	0	7	50	32	18
PCT7627	TO	524	251	0	0	24	227	138	89
PCT7628	MV	718	324	0	0	14	310	246	64
PCT7628	ED	220	110	0	0	5	105	87	18
PCT7628	TO	938	434	0	0	19	415	333	82
PCT7629	MV	691	266	0	0	19	247	196	51
PCT7629	ED	162	86	0	0	7	79	67	12
PCT7629	TO	853	352	0	0	26	326	263	63
PCT7631	MV	1009	433	0	0	28	405	307	98
PCT7631	ED	210	110	0	0	8	102	80	22
PCT7631	TO	1219	543	0	0	36	507	387	120
PCT7632	MV	1002	411	0	0	26	385	288	97
PCT7632	ED	169	128	0	0	5	123	100	23
PCT7632	TO	1171	539	0	0	31	508	388	120
PCT7633	MV	609	278	0	0	23	255	187	68
PCT7633	ED	126	96	0	0	7	89	69	20
PCT7633	TO	735	374	0	0	30	344	256	88
PCT7634	MV	704	338	0	0	36	302	233	69
PCT7634	ED	186	101	0	0	11	90	69	21
PCT7634	TO	890	439	0	0	47	392	302	90
PCT7635	MV	665	267	0	0	16	251	173	78
PCT7635	ED	188	62	0	0	3	59	43	16
PCT7635	TO	853	329	0	0	19	310	216	94
PCT7636	MV	797	321	0	0	31	290	180	110
PCT7636	ED	162	107	0	0	7	100	72	28
PCT7636	TO	959	428	0	0	38	390	252	138
PCT7637	MV	747	340	0	0	30	310	190	120
PCT7637	ED	121	98	0	0	11	87	62	25
PCT7637	TO	868	438	0	0	41	397	252	145
PCT7638	MV	806	370	0	0	29	341	191	150
PCT7638	ED	83	87	0	0	10	77	40	37
PCT7638	TO	889	457	0	0	39	418	231	187
PCT7639	MV	889	390	0	0	40	350	225	125
PCT7639	ED	133	132	0	0	20	112	74	38
PCT7639	TO	1022	522	0	0	60	462	299	163
PCT7641	MV	817	397	0	0	27	370	232	138
PCT7641	ED	134	92	0	0	5	87	60	27
PCT7641	TO	951	489	0	0	32	457	292	165
PCT7642	MV	647	305	0	0	36	269	190	79
PCT7642	ED	118	79	0	0	13	66	45	21
PCT7642	TO	765	384	0	0	49	335	235	100
PCT7643	MV	810	429	0	0	30	399	262	137
PCT7643	ED	131	105	0	0	12	93	70	23
PCT7643	TO	941	534	0	0	42	492	332	160
PCT7644	MV	1014	397	0	0	43	354	235	119
PCT7644	ED	162	142	0	0	9	133	117	16
PCT7644	TO	1176	539	0	0	52	487	352	135
PCT7645	MV	595	282	0	0	21	261	176	85
PCT7645	ED	61	56	0	0	8	48	35	13
PCT7645	TO	656	338	0	0	29	309	211	98
PCT7646	MV	1032	480	0	0	44	436	292	144
PCT7646	ED	121	133	0	0	17	116	96	20
PCT7646	TO	1153	613	0	0	61	552	388	164
PCT7647	MV	724	206	0	0	4	202	159	43
PCT7647	ED	263	79	0	0	6	73	60	13
PCT7647	TO	987	285	0	0	10	275	219	56
PCT7648	MV	2	1	0	0	1	0	0	0
PCT7648	ED	0	0	0	0	0	0	0	0
PCT7648	TO	2	1	0	0	1	0	0	0
PCT7649	MV	722	284	0	0	12	272	204	68
PCT7649	ED	178	78	0	0	6	72	57	15
PCT7649	TO	900	362	0	0	18	344	261	83
PCT7651	MV	834	323	0	0	29	294	202	92
PCT7651	ED	113	72	0	0	9	63	41	22
PCT7651	TO	947	395	0	0	38	357	243	114
PCT7652	MV	534	200	0	0	18	182	120	62
PCT7652	ED	101	86	0	0	9	77	61	16
PCT7652	TO	635	286	0	0	27	259	181	78
PCT7653	MV	750	322	0	0	35	287	210	77
PCT7653	ED	89	79	0	0	9	70	51	19
PCT7653	TO	839	401	0	0	44	357	261	96
PCT7654	MV	413	188	0	0	12	176	128	48
PCT7654	ED	53	83	0	0	9	74	62	12
PCT7654	TO	466	271	0	0	21	250	190	60
PCT7655	MV	582	211	0	0	10	201	143	58
PCT7655	ED	97	59	0	0	9	50	42	8
PCT7655	TO	679	270	0	0	19	251	185	66
PCT7656	MV	603	302	0	0	28	274	155	119
PCT7656	ED	35	40	0	0	3	37	17	20
PCT7656	TO	638	342	0	0	31	311	172	139
PCT7657	MV	561	265	0	0	30	235	144	91
PCT7657	ED	37	61	0	0	6	55	37	18
PCT7657	TO	598	326	0	0	36	290	181	109
PCT7701	MV	868	474	0	0	36	438	330	108
PCT7701	ED	196	173	0	0	10	163	126	37
PCT7701	TO	1064	647	0	0	46	601	456	145
PCT7702	MV	623	369	0	0	21	348	220	128
PCT7702	ED	133	103	0	0	7	96	66	30
PCT7702	TO	756	472	0	0	28	444	286	158
PCT7703	MV	187	71	0	0	4	67	58	9
PCT7703	ED	-13	0	0	0	0	0	0	0
PCT7703	TO	174	71	0	0	4	67	58	9
PCT7704	MV	798	485	0	0	37	448	264	184
PCT7704	ED	204	173	0	0	4	169	110	59
PCT7704	TO	1002	658	0	0	41	617	374	243
PCT7705	MV	470	281	0	0	17	264	150	114
PCT7705	ED	125	110	0	0	11	99	60	39
PCT7705	TO	595	391	0	0	28	363	210	153
PCT7706	MV	686	446	0	0	25	421	258	163
PCT7706	ED	180	162	0	0	7	155	103	52
PCT7706	TO	866	608	0	0	32	576	361	215
PCT7707	MV	683	424	0	0	23	401	272	129
PCT7707	ED	189	179	0	0	8	171	103	68
PCT7707	TO	872	603	0	0	31	572	375	197
PCT7708	MV	710	455	0	0	38	417	266	151
PCT7708	ED	165	152	0	0	11	141	98	43
PCT7708	TO	875	607	0	0	49	558	364	194
PCT7709	MV	322	191	0	0	10	181	118	63
PCT7709	ED	84	90	0	0	5	85	67	18
PCT7709	TO	406	281	0	0	15	266	185	81
PCT7711	MV	658	372	0	1	20	351	241	110
PCT7711	ED	153	125	0	0	6	119	92	27
PCT7711	TO	811	497	0	1	26	470	333	137
PCT7712	MV	423	254	0	0	13	241	180	61
PCT7712	ED	109	106	0	0	8	98	71	27
PCT7712	TO	532	360	0	0	21	339	251	88
PCT7801	MV	823	469	0	0	20	449	318	131
PCT7801	ED	151	190	0	0	9	181	133	48
PCT7801	TO	974	659	0	0	29	630	451	179
PCT7802	MV	646	393	0	0	24	369	279	90
PCT7802	ED	152	157	0	0	7	150	126	24
PCT7802	TO	798	550	0	0	31	519	405	114
PCT7803	MV	718	470	0	0	30	440	312	128
PCT7803	ED	113	128	0	0	12	116	89	27
PCT7803	TO	831	598	0	0	42	556	401	155
PCT7804	MV	733	459	0	0	46	413	298	115
PCT7804	ED	152	180	0	1	18	161	126	35
PCT7804	TO	885	639	0	1	64	574	424	150
PCT7805	MV	644	389	0	0	40	349	253	96
PCT7805	ED	156	155	0	0	12	143	122	21
PCT7805	TO	800	544	0	0	52	492	375	117
PCT7806	MV	602	353	0	0	28	325	258	67
PCT7806	ED	153	152	0	0	14	138	113	25
PCT7806	TO	755	505	0	0	42	463	371	92
PCT7807	MV	642	353	0	0	19	334	266	68
PCT7807	ED	185	174	0	0	17	157	136	21
PCT7807	TO	827	527	0	0	36	491	402	89
PCT7808	MV	525	288	0	0	24	264	214	50
PCT7808	ED	129	129	0	0	11	118	95	23
PCT7808	TO	654	417	0	0	35	382	309	73
PCT7809	MV	624	348	0	0	21	327	270	57
PCT7809	ED	140	135	0	0	13	122	112	10
PCT7809	TO	764	483	0	0	34	449	382	67
PCT7811	MV	582	303	0	0	21	282	235	47
PCT7811	ED	176	155	0	0	8	147	121	26
PCT7811	TO	758	458	0	0	29	429	356	73
PCT7812	MV	680	364	0	0	32	332	268	64
PCT7812	ED	217	163	0	0	10	153	126	27
PCT7812	TO	897	527	0	0	42	485	394	91
PCT7813	MV	842	478	0	0	25	453	356	97
PCT7813	ED	226	214	0	0	17	197	167	30
PCT7813	TO	1068	692	0	0	42	650	523	127
PCT7814	MV	660	274	0	0	19	255	200	55
PCT7814	ED	241	118	0	0	9	109	99	10
PCT7814	TO	901	392	0	0	28	364	299	65
PCT7815	MV	749	460	0	0	48	412	318	94
PCT7815	ED	168	176	0	0	8	168	136	32
PCT7815	TO	917	636	0	0	56	580	454	126
PCT7816	MV	724	466	0	0	36	430	326	104
PCT7816	ED	148	149	0	0	7	142	105	37
PCT7816	TO	872	615	0	0	43	572	431	141
PCT7817	MV	652	386	0	0	13	373	312	61
PCT7817	ED	186	182	0	0	10	172	149	23
PCT7817	TO	838	568	0	0	23	545	461	84
PCT7818	MV	668	389	0	0	26	363	286	77
PCT7818	ED	171	149	0	0	8	141	122	19
PCT7818	TO	839	538	0	0	34	504	408	96
PCT7819	MV	635	346	0	0	28	318	244	74
PCT7819	ED	139	89	0	0	6	83	75	8
PCT7819	TO	774	435	0	0	34	401	319	82
PCT7821	MV	806	513	0	0	31	482	376	106
PCT7821	ED	170	189	0	0	9	180	129	51
PCT7821	TO	976	702	0	0	40	662	505	157
PCT7822	MV	673	390	0	1	24	365	292	73
PCT7822	ED	219	222	0	0	21	201	153	48
PCT7822	TO	892	612	0	1	45	566	445	121
PCT7823	MV	706	398	0	0	24	374	297	77
PCT7823	ED	177	188	0	0	5	183	159	24
PCT7823	TO	883	586	0	0	29	557	456	101
PCT7824	MV	614	324	0	0	27	297	221	76
PCT7824	ED	154	158	0	0	12	146	123	23
PCT7824	TO	768	482	0	0	39	443	344	99
PCT7825	MV	457	248	0	0	17	231	204	27
PCT7825	ED	151	130	0	0	4	126	106	20
PCT7825	TO	608	378	0	0	21	357	310	47
PCT7826	MV	486	256	0	0	18	238	195	43
PCT7826	ED	204	162	0	0	6	156	142	14
PCT7826	TO	690	418	0	0	24	394	337	57
PCT7827	MV	607	312	0	0	17	295	236	59
PCT7827	ED	219	145	0	0	15	130	110	20
PCT7827	TO	826	457	0	0	32	425	346	79
PCT7828	MV	857	469	0	1	31	437	322	115
PCT7828	ED	171	177	0	1	18	158	126	32
PCT7828	TO	1028	646	0	2	49	595	448	147
PCT7829	MV	742	456	0	0	35	421	288	133
PCT7829	ED	149	151	0	0	5	146	118	28
PCT7829	TO	891	607	0	0	40	567	406	161
PCT7831	MV	763	478	0	0	40	438	327	111
PCT7831	ED	139	137	0	0	9	128	93	35
PCT7831	TO	902	615	0	0	49	566	420	146
PCT7832	MV	663	401	0	0	33	368	285	83
PCT7832	ED	118	127	0	0	9	118	99	19
PCT7832	TO	781	528	0	0	42	486	384	102
PCT7833	MV	587	339	0	0	24	315	249	66
PCT7833	ED	146	145	0	0	17	128	107	21
PCT7833	TO	733	484	0	0	41	443	356	87
PCT7834	MV	700	363	0	0	25	338	287	51
PCT7834	ED	194	175	0	0	13	162	137	25
PCT7834	TO	894	538	0	0	38	500	424	76
PCT7835	MV	721	423	0	0	26	397	270	127
PCT7835	ED	142	147	0	0	12	135	101	34
PCT7835	TO	863	570	0	0	38	532	371	161
PCT7836	MV	850	503	0	0	25	478	333	145
PCT7836	ED	193	169	0	0	6	163	115	48
PCT7836	TO	1043	672	0	0	31	641	448	193
PCT7837	MV	717	416	0	0	44	372	266	106
PCT7837	ED	206	198	0	0	9	189	155	34
PCT7837	TO	923	614	0	0	53	561	421	140
PCT7838	MV	752	484	0	0	38	446	317	129
PCT7838	ED	143	155	0	0	9	146	114	32
PCT7838	TO	895	639	0	0	47	592	431	161
PCT7839	MV	731	445	0	0	38	407	297	110
PCT7839	ED	130	136	0	1	9	126	97	29
PCT7839	TO	861	581	0	1	47	533	394	139
PCT7841	MV	752	449	0	0	33	416	317	99
PCT7841	ED	198	207	0	0	8	199	159	40
PCT7841	TO	950	656	0	0	41	615	476	139
PCT7842	MV	702	382	0	0	28	354	286	68
PCT7842	ED	177	154	0	0	6	148	122	26
PCT7842	TO	879	536	0	0	34	502	408	94
PCT7843	MV	546	289	0	0	12	277	229	48
PCT7843	ED	183	163	0	0	12	151	122	29
PCT7843	TO	729	452	0	0	24	428	351	77
PCT7844	MV	499	276	0	0	27	249	210	39
PCT7844	ED	152	136	0	0	13	123	100	23
PCT7844	TO	651	412	0	0	40	372	310	62
PCT7845	MV	676	393	0	0	24	369	292	77
PCT7845	ED	204	177	0	0	14	163	127	36
PCT7845	TO	880	570	0	0	38	532	419	113
PCT7846	MV	736	454	0	0	41	413	290	123
PCT7846	ED	172	166	0	0	15	151	121	30
PCT7846	TO	908	620	0	0	56	564	411	153
PCT7847	MV	698	421	0	0	40	381	300	81
PCT7847	ED	193	181	0	0	7	174	137	37
PCT7847	TO	891	602	0	0	47	555	437	118
PCT7848	MV	665	427	0	0	26	401	304	97
PCT7848	ED	182	168	0	0	18	150	117	33
PCT7848	TO	847	595	0	0	44	551	421	130
PCT7849	MV	729	427	0	1	33	393	304	89
PCT7849	ED	172	186	0	0	15	171	141	30
PCT7849	TO	901	613	0	1	48	564	445	119
PCT7851	MV	414	266	0	0	21	245	149	96
PCT7851	ED	112	84	0	0	8	76	48	28
PCT7851	TO	526	350	0	0	29	321	197	124
PCT7852	MV	533	347	0	0	23	324	203	121
PCT7852	ED	111	103	0	0	5	98	68	30
PCT7852	TO	644	450	0	0	28	422	271	151
PCT7853	MV	694	382	0	0	32	350	244	106
PCT7853	ED	161	137	0	0	9	128	92	36
PCT7853	TO	855	519	0	0	41	478	336	142
PCT7854	MV	703	422	0	0	34	388	279	109
PCT7854	ED	175	172	0	0	10	162	128	34
PCT7854	TO	878	594	0	0	44	550	407	143
PCT7855	MV	763	440	0	0	35	405	298	107
PCT7855	ED	211	202	0	0	16	186	150	36
PCT7855	TO	974	642	0	0	51	591	448	143
PCT7856	MV	643	362	0	0	22	340	259	81
PCT7856	ED	204	193	0	0	10	183	145	38
PCT7856	TO	847	555	0	0	32	523	404	119
PCT7857	MV	748	427	0	1	35	391	298	93
PCT7857	ED	158	153	0	0	9	144	119	25
PCT7857	TO	906	580	0	1	44	535	417	118
PCT7858	MV	622	345	0	0	30	315	257	58
PCT7858	ED	157	147	0	0	11	136	119	17
PCT7858	TO	779	492	0	0	41	451	376	75
PCT7859	MV	747	457	0	0	33	424	306	118
PCT7859	ED	152	165	0	0	16	149	106	43
PCT7859	TO	899	622	0	0	49	573	412	161
PCT7861	MV	699	424	0	0	21	403	288	115
PCT7861	ED	164	171	0	0	9	162	123	39
PCT7861	TO	863	595	0	0	30	565	411	154
PCT7862	MV	669	397	0	0	26	371	269	102
PCT7862	ED	195	197	0	0	12	185	149	36
PCT7862	TO	864	594	0	0	38	556	418	138
PCT7863	MV	692	361	0	0	21	340	262	78
PCT7863	ED	209	205	0	0	8	197	145	52
PCT7863	TO	901	566	0	0	29	537	407	130
PCT7864	MV	661	365	0	0	28	337	247	90
PCT7864	ED	153	157	0	0	12	145	114	31
PCT7864	TO	814	522	0	0	40	482	361	121
PCT7865	MV	677	402	0	0	37	365	277	88
PCT7865	ED	163	157	0	0	10	147	112	35
PCT7865	TO	840	559	0	0	47	512	389	123
PCT7866	MV	690	444	0	0	21	423	262	161
PCT7866	ED	158	141	0	0	6	135	90	45
PCT7866	TO	848	585	0	0	27	558	352	206
PCT7867	MV	766	462	0	0	28	434	326	108
PCT7867	ED	212	182	0	0	13	169	133	36
PCT7867	TO	978	644	0	0	41	603	459	144
PCT7868	MV	659	368	0	0	19	349	258	91
PCT7868	ED	217	161	0	1	9	151	116	35
PCT7868	TO	876	529	0	1	28	500	374	126
PCT7869	MV	682	436	0	0	30	406	302	104
PCT7869	ED	179	189	0	0	10	179	145	34
PCT7869	TO	861	625	0	0	40	585	447	138
PCT7871	MV	702	456	0	0	33	423	323	100
PCT7871	ED	200	157	0	0	9	148	108	40
PCT7871	TO	902	613	0	0	42	571	431	140
PCT7872	MV	675	410	0	0	23	387	292	95
PCT7872	ED	199	185	0	0	9	176	131	45
PCT7872	TO	874	595	0	0	32	563	423	140
PCT7873	MV	688	437	0	1	27	409	311	98
PCT7873	ED	203	212	0	0	15	197	164	33
PCT7873	TO	891	649	0	1	42	606	475	131
PCT7874	MV	370	187	0	0	8	179	133	46
PCT7874	ED	119	107	0	0	6	101	83	18
PCT7874	TO	489	294	0	0	14	280	216	64
PCT7875	MV	500	247	0	0	15	232	174	58
PCT7875	ED	147	114	0	0	5	109	92	17
PCT7875	TO	647	361	0	0	20	341	266	75
PCT7876	MV	462	250	0	0	27	223	181	42
PCT7876	ED	106	91	0	0	11	80	67	13
PCT7876	TO	568	341	0	0	38	303	248	55
PCT7901	MV	399	191	0	0	14	177	148	29
PCT7901	ED	150	65	0	0	3	62	53	9
PCT7901	TO	549	256	0	0	17	239	201	38
PCT7902	MV	680	286	0	0	14	272	230	42
PCT7902	ED	232	139	0	0	8	131	113	18
PCT7902	TO	912	425	0	0	22	403	343	60
PCT7903	MV	622	278	0	0	22	256	217	39
PCT7903	ED	230	123	0	0	7	116	109	7
PCT7903	TO	852	401	0	0	29	372	326	46
PCT7904	MV	678	289	0	0	25	264	212	52
PCT7904	ED	159	115	0	0	8	107	90	17
PCT7904	TO	837	404	0	0	33	371	302	69
PCT7905	MV	684	354	0	0	19	335	264	71
PCT7905	ED	191	183	0	0	8	175	151	24
PCT7905	TO	875	537	0	0	27	510	415	95
PCT7906	MV	599	276	0	0	19	257	217	40
PCT7906	ED	187	115	0	0	13	102	85	17
PCT7906	TO	786	391	0	0	32	359	302	57
PCT7907	MV	704	339	0	0	15	324	265	59
PCT7907	ED	238	163	0	0	15	148	127	21
PCT7907	TO	942	502	0	0	30	472	392	80
PCT7908	MV	752	359	0	0	24	335	283	52
PCT7908	ED	240	169	0	0	12	157	140	17
PCT7908	TO	992	528	0	0	36	492	423	69
PCT7909	MV	558	308	0	0	22	286	246	40
PCT7909	ED	185	140	0	0	7	133	117	16
PCT7909	TO	743	448	0	0	29	419	363	56
PCT7911	MV	666	315	0	0	26	289	229	60
PCT7911	ED	205	129	0	0	8	121	104	17
PCT7911	TO	871	444	0	0	34	410	333	77
PCT7912	MV	800	368	0	0	25	343	300	43
PCT7912	ED	259	176	0	0	19	157	143	14
PCT7912	TO	1059	544	0	0	44	500	443	57
PCT7913	MV	659	345	0	0	14	331	273	58
PCT7913	ED	264	212	0	0	5	207	171	36
PCT7913	TO	923	557	0	0	19	538	444	94
PCT7914	MV	715	381	0	0	28	353	293	60
PCT7914	ED	187	140	0	0	11	129	109	20
PCT7914	TO	902	521	0	0	39	482	402	80
PCT7915	MV	605	279	0	0	21	258	213	45
PCT7915	ED	238	181	0	0	5	176	147	29
PCT7915	TO	843	460	0	0	26	434	360	74
PCT7916	MV	639	321	0	0	19	302	252	50
PCT7916	ED	219	160	0	0	10	150	137	13
PCT7916	TO	858	481	0	0	29	452	389	63
PCT7917	MV	716	353	0	0	19	334	284	50
PCT7917	ED	271	187	0	0	8	179	157	22
PCT7917	TO	987	540	0	0	27	513	441	72
PCT7918	MV	597	296	0	0	13	283	241	42
PCT7918	ED	227	143	0	0	7	136	114	22
PCT7918	TO	824	439	0	0	20	419	355	64
PCT7919	MV	608	305	0	0	16	289	250	39
PCT7919	ED	258	175	0	0	9	166	147	19
PCT7919	TO	866	480	0	0	25	455	397	58
PCT7921	MV	682	302	0	0	18	284	238	46
PCT7921	ED	229	101	0	0	4	97	88	9
PCT7921	TO	911	403	0	0	22	381	326	55
PCT7922	MV	648	309	0	0	14	295	243	52
PCT7922	ED	210	155	0	0	13	142	118	24
PCT7922	TO	858	464	0	0	27	437	361	76
PCT7923	MV	666	331	0	0	14	317	240	77
PCT7923	ED	214	170	0	0	10	160	134	26
PCT7923	TO	880	501	0	0	24	477	374	103
PCT7924	MV	649	294	0	0	11	283	223	60
PCT7924	ED	202	124	0	0	10	114	92	22
PCT7924	TO	851	418	0	0	21	397	315	82
PCT7925	MV	434	222	0	0	15	207	162	45
PCT7925	ED	110	89	0	0	4	85	74	11
PCT7925	TO	544	311	0	0	19	292	236	56
PCT7926	MV	610	328	0	0	22	306	249	57
PCT7926	ED	178	150	0	0	6	144	115	29
PCT7926	TO	788	478	0	0	28	450	364	86
PCT7927	MV	580	325	0	0	26	299	245	54
PCT7927	ED	162	152	0	0	6	146	123	23
PCT7927	TO	742	477	0	0	32	445	368	77
PCT7928	MV	700	389	0	0	22	367	288	79
PCT7928	ED	217	208	0	0	4	204	164	40
PCT7928	TO	917	597	0	0	26	571	452	119
PCT7929	MV	678	419	0	0	21	398	326	72
PCT7929	ED	169	170	0	0	8	162	146	16
PCT7929	TO	847	589	0	0	29	560	472	88
PCT7931	MV	610	368	0	0	33	335	259	76
PCT7931	ED	141	149	0	0	6	143	118	25
PCT7931	TO	751	517	0	0	39	478	377	101
PCT7932	MV	443	276	0	0	21	255	178	77
PCT7932	ED	118	95	0	0	6	89	72	17
PCT7932	TO	561	371	0	0	27	344	250	94
PCT7933	MV	9	6	0	0	0	6	4	2
PCT7933	ED	-1	0	0	0	0	0	0	0
PCT7933	TO	8	6	0	0	0	6	4	2
PCT7934	MV	702	398	0	0	25	373	317	56
PCT7934	ED	182	154	0	0	10	144	120	24
PCT7934	TO	884	552	0	0	35	517	437	80
PCT7935	MV	715	429	0	0	26	403	320	83
PCT7935	ED	228	225	0	0	15	210	176	34
PCT7935	TO	943	654	0	0	41	613	496	117
PCT7936	MV	620	365	0	0	28	337	270	67
PCT7936	ED	236	220	0	0	10	210	170	40
PCT7936	TO	856	585	0	0	38	547	440	107
PCT7937	MV	698	404	0	0	23	381	298	83
PCT7937	ED	202	171	0	0	7	164	138	26
PCT7937	TO	900	575	0	0	30	545	436	109
PCT7938	MV	536	297	0	0	14	283	211	72
PCT7938	ED	215	120	0	0	7	113	97	16
PCT7938	TO	751	417	0	0	21	396	308	88
PCT7939	MV	481	279	0	0	14	265	220	45
PCT7939	ED	205	191	0	0	10	181	153	28
PCT7939	TO	686	470	0	0	24	446	373	73
PCT7941	MV	575	298	0	0	27	271	216	55
PCT7941	ED	197	170	0	0	10	160	123	37
PCT7941	TO	772	468	0	0	37	431	339	92
PCT7942	MV	658	324	0	0	19	305	240	65
PCT7942	ED	274	141	0	0	5	136	114	22
PCT7942	TO	932	465	0	0	24	441	354	87
PCT7943	MV	687	361	0	0	17	344	252	92
PCT7943	ED	213	156	0	0	11	145	105	40
PCT7943	TO	900	517	0	0	28	489	357	132
PCT7944	MV	584	332	0	0	23	309	240	69
PCT7944	ED	230	196	0	0	11	185	152	33
PCT7944	TO	814	528	0	0	34	494	392	102
PCT7945	MV	726	331	0	0	25	306	243	63
PCT7945	ED	228	82	0	0	6	76	69	7
PCT7945	TO	954	413	0	0	31	382	312	70
PCT7946	MV	779	361	0	1	20	340	192	148
PCT7946	ED	206	114	0	0	7	107	81	26
PCT7946	TO	985	475	0	1	27	447	273	174
PCT7947	MV	791	329	0	0	23	306	159	147
PCT7947	ED	195	93	0	0	2	91	69	22
PCT7947	TO	986	422	0	0	25	397	228	169
PCT7948	MV	730	364	0	0	23	341	189	152
PCT7948	ED	200	119	0	0	3	116	85	31
PCT7948	TO	930	483	0	0	26	457	274	183
PCT7949	MV	484	230	0	0	11	219	111	108
PCT7949	ED	106	56	0	0	7	49	35	14
PCT7949	TO	590	286	0	0	18	268	146	122
PCT7951	MV	730	363	0	0	25	338	178	160
PCT7951	ED	157	90	0	0	3	87	56	31
PCT7951	TO	887	453	0	0	28	425	234	191
PCT7952	MV	730	290	0	0	18	272	150	122
PCT7952	ED	182	86	0	0	6	80	51	29
PCT7952	TO	912	376	0	0	24	352	201	151
PCT7953	MV	669	327	0	0	17	310	173	137
PCT7953	ED	161	106	0	0	5	101	63	38
PCT7953	TO	830	433	0	0	22	411	236	175
PCT7954	MV	0	0	0	0	0	0	0	0
PCT7954	ED	0	0	0	0	0	0	0	0
PCT7954	TO	0	0	0	0	0	0	0	0
PCT7955	MV	774	341	0	0	18	323	199	124
PCT7955	ED	173	97	0	0	8	89	54	35
PCT7955	TO	947	438	0	0	26	412	253	159
PCT7956	MV	699	260	0	0	10	250	146	104
PCT7956	ED	170	39	0	0	2	37	30	7
PCT7956	TO	869	299	0	0	12	287	176	111
PCT7957	MV	538	256	0	0	15	241	162	79
PCT7957	ED	135	83	0	0	5	78	59	19
PCT7957	TO	673	339	0	0	20	319	221	98
PCT7958	MV	320	103	0	0	6	97	70	27
PCT7958	ED	-23	0	0	0	0	0	0	0
PCT7958	TO	297	103	0	0	6	97	70	27
PCT7959	MV	541	226	0	0	22	204	169	35
PCT7959	ED	145	65	0	0	5	60	56	4
PCT7959	TO	686	291	0	0	27	264	225	39
PCT9001	MV	314	99	0	0	1	98	78	20
PCT9001	ED	-30	0	0	0	0	0	0	0
PCT9001	TO	284	99	0	0	1	98	78	20
PCT9101	MV	712	372	0	0	23	349	236	113
PCT9101	ED	201	150	0	0	3	147	99	48
PCT9101	TO	913	522	0	0	26	496	335	161
PCT9102	MV	787	388	0	0	26	362	243	119
PCT9102	ED	205	126	0	0	7	119	91	28
PCT9102	TO	992	514	0	0	33	481	334	147
PCT9103	MV	718	377	0	0	31	346	247	99
PCT9103	ED	239	153	0	0	11	142	89	53
PCT9103	TO	957	530	0	0	42	488	336	152
PCT9104	MV	810	381	0	0	35	346	244	102
PCT9104	ED	220	152	0	0	11	141	110	31
PCT9104	TO	1030	533	0	0	46	487	354	133
PCT9105	MV	719	410	0	0	23	387	251	136
PCT9105	ED	199	173	0	0	16	157	109	48
PCT9105	TO	918	583	0	0	39	544	360	184
PCT9106	MV	746	384	0	0	27	357	249	108
PCT9106	ED	200	178	0	0	12	166	126	40
PCT9106	TO	946	562	0	0	39	523	375	148
PCT9107	MV	635	300	0	1	23	276	205	71
PCT9107	ED	209	118	0	0	9	109	86	23
PCT9107	TO	844	418	0	1	32	385	291	94
PCT9108	MV	610	332	0	0	30	302	226	76
PCT9108	ED	200	136	0	0	6	130	103	27
PCT9108	TO	810	468	0	0	36	432	329	103
PCT9109	MV	672	293	0	0	29	264	192	72
PCT9109	ED	211	162	0	0	6	156	118	38
PCT9109	TO	883	455	0	0	35	420	310	110
PCT9111	MV	638	315	0	0	25	290	192	98
PCT9111	ED	196	134	0	0	11	123	98	25
PCT9111	TO	834	449	0	0	36	413	290	123
PCT9112	MV	742	346	0	0	22	324	232	92
PCT9112	ED	219	160	0	0	10	150	116	34
PCT9112	TO	961	506	0	0	32	474	348	126
PCT9113	MV	795	365	0	0	31	334	246	88
PCT9113	ED	209	180	0	0	15	165	115	50
PCT9113	TO	1004	545	0	0	46	499	361	138
PCT9114	MV	659	289	0	0	19	270	197	73
PCT9114	ED	231	147	0	0	12	135	108	27
PCT9114	TO	890	436	0	0	31	405	305	100
PCT9115	MV	699	319	0	0	27	292	215	77
PCT9115	ED	182	155	0	0	19	136	117	19
PCT9115	TO	881	474	0	0	46	428	332	96
PCT9116	MV	782	342	0	0	20	322	226	96
PCT9116	ED	179	148	0	0	11	137	100	37
PCT9116	TO	961	490	0	0	31	459	326	133
PCT9117	MV	629	325	0	0	16	309	198	111
PCT9117	ED	171	158	0	0	10	148	99	49
PCT9117	TO	800	483	0	0	26	457	297	160
PCT9118	MV	738	338	0	0	23	315	197	118
PCT9118	ED	246	165	0	0	13	152	104	48
PCT9118	TO	984	503	0	0	36	467	301	166
PCT9119	MV	703	383	0	0	22	361	218	143
PCT9119	ED	197	120	0	0	12	108	86	22
PCT9119	TO	900	503	0	0	34	469	304	165
PCT9121	MV	734	326	0	0	19	307	202	105
PCT9121	ED	219	141	0	0	10	131	84	47
PCT9121	TO	953	467	0	0	29	438	286	152
PCT9122	MV	774	362	0	0	28	334	203	131
PCT9122	ED	193	122	0	0	11	111	83	28
PCT9122	TO	967	484	0	0	39	445	286	159
PCT9123	MV	661	319	0	0	18	301	204	97
PCT9123	ED	191	139	0	0	8	131	98	33
PCT9123	TO	852	458	0	0	26	432	302	130
PCT9124	MV	735	347	0	0	13	334	204	130
PCT9124	ED	168	118	0	0	6	112	80	32
PCT9124	TO	903	465	0	0	19	446	284	162
PCT9125	MV	680	350	0	0	19	331	223	108
PCT9125	ED	189	124	0	0	8	116	89	27
PCT9125	TO	869	474	0	0	27	447	312	135
PCT9126	MV	819	379	0	1	26	352	206	146
PCT9126	ED	194	152	0	0	11	141	106	35
PCT9126	TO	1013	531	0	1	37	493	312	181
PCT9127	MV	748	375	0	0	30	345	243	102
PCT9127	ED	223	184	0	0	8	176	129	47
PCT9127	TO	971	559	0	0	38	521	372	149
PCT9128	MV	628	330	0	0	25	305	197	108
PCT9128	ED	190	166	0	0	12	154	115	39
PCT9128	TO	818	496	0	0	37	459	312	147
PCT9129	MV	587	268	0	0	15	253	169	84
PCT9129	ED	151	129	0	0	6	123	97	26
PCT9129	TO	738	397	0	0	21	376	266	110
PCT9131	MV	596	280	0	0	13	267	176	91
PCT9131	ED	138	111	0	0	6	105	74	31
PCT9131	TO	734	391	0	0	19	372	250	122
PCT9132	MV	627	258	0	0	21	237	185	52
PCT9132	ED	194	130	0	0	10	120	97	23
PCT9132	TO	821	388	0	0	31	357	282	75
PCT9133	MV	808	373	0	0	21	352	258	94
PCT9133	ED	209	157	0	0	9	148	111	37
PCT9133	TO	1017	530	0	0	30	500	369	131
PCT9134	MV	736	254	0	0	19	235	139	96
PCT9134	ED	155	102	0	0	10	92	70	22
PCT9134	TO	891	356	0	0	29	327	209	118
PCT9135	MV	640	301	0	0	20	281	184	97
PCT9135	ED	182	125	0	0	7	118	72	46
PCT9135	TO	822	426	0	0	27	399	256	143
PCT9136	MV	706	360	0	0	33	327	219	108
PCT9136	ED	212	139	0	0	10	129	102	27
PCT9136	TO	918	499	0	0	43	456	321	135
PCT9137	MV	804	381	0	0	25	356	240	116
PCT9137	ED	211	133	0	0	4	129	96	33
PCT9137	TO	1015	514	0	0	29	485	336	149
PCT9138	MV	770	396	0	0	21	375	247	128
PCT9138	ED	175	119	0	0	7	112	85	27
PCT9138	TO	945	515	0	0	28	487	332	155
PCT9139	MV	828	415	0	0	29	386	247	139
PCT9139	ED	190	141	0	0	11	130	94	36
PCT9139	TO	1018	556	0	0	40	516	341	175
PCT9141	MV	789	413	0	0	33	380	235	145
PCT9141	ED	184	144	0	0	12	132	98	34
PCT9141	TO	973	557	0	0	45	512	333	179
PCT9142	MV	747	360	0	0	17	343	239	104
PCT9142	ED	239	162	0	0	12	150	113	37
PCT9142	TO	986	522	0	0	29	493	352	141
PCT9143	MV	705	357	0	0	23	334	202	132
PCT9143	ED	209	150	0	0	4	146	101	45
PCT9143	TO	914	507	0	0	27	480	303	177
PCT9144	MV	766	371	0	0	26	345	227	118
PCT9144	ED	204	177	0	0	8	169	131	38
PCT9144	TO	970	548	0	0	34	514	358	156
PCT9145	MV	681	329	0	0	15	314	235	79
PCT9145	ED	194	157	0	0	8	149	109	40
PCT9145	TO	875	486	0	0	23	463	344	119
PCT9146	MV	725	350	0	0	27	323	239	84
PCT9146	ED	160	143	0	0	10	133	103	30
PCT9146	TO	885	493	0	0	37	456	342	114
PCT9147	MV	765	368	0	0	31	337	244	93
PCT9147	ED	225	161	0	0	10	151	110	41
PCT9147	TO	990	529	0	0	41	488	354	134
PCT9148	MV	778	389	0	0	24	365	275	90
PCT9148	ED	236	177	0	0	14	163	135	28
PCT9148	TO	1014	566	0	0	38	528	410	118
PCT9149	MV	812	372	0	0	21	351	256	95
PCT9149	ED	179	240	0	0	11	229	176	53
PCT9149	TO	991	612	0	0	32	580	432	148
PCT9151	MV	693	342	0	0	30	312	231	81
PCT9151	ED	168	111	0	0	5	106	76	30
PCT9151	TO	861	453	0	0	35	418	307	111
PCT9152	MV	550	196	0	0	11	185	152	33
PCT9152	ED	187	124	0	0	10	114	96	18
PCT9152	TO	737	320	0	0	21	299	248	51
PCT9201	MV	784	347	0	0	29	318	268	50
PCT9201	ED	187	166	0	0	11	155	126	29
PCT9201	TO	971	513	0	0	40	473	394	79
PCT9202	MV	819	361	0	1	34	326	250	76
PCT9202	ED	177	164	0	0	13	151	113	38
PCT9202	TO	996	525	0	1	47	477	363	114
PCT9203	MV	847	366	0	0	52	314	186	128
PCT9203	ED	155	120	0	0	16	104	54	50
PCT9203	TO	1002	486	0	0	68	418	240	178
PCT9204	MV	686	302	0	0	35	267	150	117
PCT9204	ED	176	138	0	0	13	125	73	52
PCT9204	TO	862	440	0	0	48	392	223	169
PCT9205	MV	621	278	0	0	33	245	163	82
PCT9205	ED	115	92	0	0	13	79	49	30
PCT9205	TO	736	370	0	0	46	324	212	112
PCT9206	MV	741	349	0	0	30	319	179	140
PCT9206	ED	188	149	0	0	26	123	71	52
PCT9206	TO	929	498	0	0	56	442	250	192
PCT9207	MV	824	366	0	0	32	334	185	149
PCT9207	ED	165	130	0	0	7	123	77	46
PCT9207	TO	989	496	0	0	39	457	262	195
PCT9208	MV	808	348	0	0	32	316	190	126
PCT9208	ED	179	127	0	0	13	114	74	40
PCT9208	TO	987	475	0	0	45	430	264	166
PCT9209	MV	615	274	0	0	24	250	155	95
PCT9209	ED	156	119	0	0	13	106	61	45
PCT9209	TO	771	393	0	0	37	356	216	140
PCT9211	MV	730	308	0	1	34	273	160	113
PCT9211	ED	161	132	0	0	20	112	65	47
PCT9211	TO	891	440	0	1	54	385	225	160
PCT9212	MV	671	278	0	1	27	250	156	94
PCT9212	ED	137	114	0	0	14	100	62	38
PCT9212	TO	808	392	0	1	41	350	218	132
PCT9213	MV	776	342	0	0	35	307	187	120
PCT9213	ED	161	130	0	0	15	115	79	36
PCT9213	TO	937	472	0	0	50	422	266	156
PCT9214	MV	517	232	0	0	19	213	135	78
PCT9214	ED	110	103	0	0	16	87	52	35
PCT9214	TO	627	335	0	0	35	300	187	113
PCT9215	MV	524	240	0	1	14	225	130	95
PCT9215	ED	120	100	0	0	12	88	53	35
PCT9215	TO	644	340	0	1	26	313	183	130
PCT9216	MV	669	260	0	0	33	227	129	98
PCT9216	ED	155	125	0	0	10	115	79	36
PCT9216	TO	824	385	0	0	43	342	208	134
PCT9217	MV	587	263	0	0	13	250	151	99
PCT9217	ED	118	87	0	0	5	82	50	32
PCT9217	TO	705	350	0	0	18	332	201	131
PCT9218	MV	652	275	0	0	26	249	141	108
PCT9218	ED	164	112	0	0	9	103	72	31
PCT9218	TO	816	387	0	0	35	352	213	139
PCT9219	MV	646	285	0	0	34	251	174	77
PCT9219	ED	144	116	0	0	8	108	88	20
PCT9219	TO	790	401	0	0	42	359	262	97
PCT9221	MV	562	318	0	0	18	300	161	139
PCT9221	ED	89	99	0	0	8	91	65	26
PCT9221	TO	651	417	0	0	26	391	226	165
PCT9222	MV	773	365	0	0	31	334	198	136
PCT9222	ED	137	116	0	0	10	106	68	38
PCT9222	TO	910	481	0	0	41	440	266	174
PCT9223	MV	558	264	0	0	18	246	141	105
PCT9223	ED	109	59	0	0	6	53	30	23
PCT9223	TO	667	323	0	0	24	299	171	128
PCT9224	MV	768	376	0	0	31	345	224	121
PCT9224	ED	181	151	0	0	16	135	80	55
PCT9224	TO	949	527	0	0	47	480	304	176
PCT9225	MV	757	301	0	0	25	276	175	101
PCT9225	ED	169	156	0	0	21	135	91	44
PCT9225	TO	926	457	0	0	46	411	266	145
PCT9226	MV	741	350	0	0	43	307	204	103
PCT9226	ED	155	143	0	0	10	133	93	40
PCT9226	TO	896	493	0	0	53	440	297	143
PCT9227	MV	605	363	0	0	25	338	208	130
PCT9227	ED	124	114	0	0	4	110	71	39
PCT9227	TO	729	477	0	0	29	448	279	169
PCT9228	MV	577	306	0	0	21	285	163	122
PCT9228	ED	161	141	0	0	8	133	85	48
PCT9228	TO	738	447	0	0	29	418	248	170
PCT9229	MV	460	252	0	0	19	233	168	65
PCT9229	ED	119	106	0	0	3	103	67	36
PCT9229	TO	579	358	0	0	22	336	235	101
PCT9231	MV	726	340	0	0	22	318	226	92
PCT9231	ED	236	208	0	0	16	192	141	51
PCT9231	TO	962	548	0	0	38	510	367	143
PCT9232	MV	608	288	0	1	27	260	151	109
PCT9232	ED	126	140	0	0	13	127	77	50
PCT9232	TO	734	428	0	1	40	387	228	159
PCT9233	MV	668	317	0	0	28	289	166	123
PCT9233	ED	150	141	0	0	15	126	92	34
PCT9233	TO	818	458	0	0	43	415	258	157
PCT9234	MV	643	306	0	0	26	280	170	110
PCT9234	ED	91	112	0	0	14	98	64	34
PCT9234	TO	734	418	0	0	40	378	234	144
PCT9235	MV	703	356	0	0	28	328	185	143
PCT9235	ED	160	140	0	0	10	130	83	47
PCT9235	TO	863	496	0	0	38	458	268	190
PCT9236	MV	537	274	0	0	24	250	163	87
PCT9236	ED	136	101	0	0	10	91	65	26
PCT9236	TO	673	375	0	0	34	341	228	113
PCT9237	MV	779	388	0	0	35	353	230	123
PCT9237	ED	118	134	0	0	9	125	80	45
PCT9237	TO	897	522	0	0	44	478	310	168
PCT9238	MV	687	325	0	0	32	293	166	127
PCT9238	ED	118	118	0	0	16	102	69	33
PCT9238	TO	805	443	0	0	48	395	235	160
PCT9239	MV	740	383	0	0	42	341	223	118
PCT9239	ED	124	117	0	0	8	109	79	30
PCT9239	TO	864	500	0	0	50	450	302	148
PCT9241	MV	819	394	0	0	32	362	220	142
PCT9241	ED	141	139	0	0	12	127	89	38
PCT9241	TO	960	533	0	0	44	489	309	180
PCT9242	MV	771	341	0	1	39	301	209	92
PCT9242	ED	172	155	0	0	13	142	102	40
PCT9242	TO	943	496	0	1	52	443	311	132
PCT9243	MV	480	239	0	0	22	217	144	73
PCT9243	ED	123	113	0	0	16	97	73	24
PCT9243	TO	603	352	0	0	38	314	217	97
PCT9244	MV	755	390	0	0	48	342	254	88
PCT9244	ED	155	121	0	0	7	114	79	35
PCT9244	TO	910	511	0	0	55	456	333	123
PCT9245	MV	616	292	0	0	31	261	163	98
PCT9245	ED	98	91	0	0	7	84	63	21
PCT9245	TO	714	383	0	0	38	345	226	119
PCT9246	MV	815	425	0	0	35	390	254	136
PCT9246	ED	155	140	0	0	20	120	92	28
PCT9246	TO	970	565	0	0	55	510	346	164
PCT9247	MV	764	376	0	0	23	353	253	100
PCT9247	ED	148	156	0	0	21	135	94	41
PCT9247	TO	912	532	0	0	44	488	347	141
PCT9248	MV	757	354	0	0	35	319	242	77
PCT9248	ED	150	145	0	0	11	134	103	31
PCT9248	TO	907	499	0	0	46	453	345	108
PCT9249	MV	724	369	0	0	32	337	238	99
PCT9249	ED	191	171	0	0	17	154	106	48
PCT9249	TO	915	540	0	0	49	491	344	147
PCT9251	MV	792	389	0	0	31	358	233	125
PCT9251	ED	174	179	0	0	11	168	117	51
PCT9251	TO	966	568	0	0	42	526	350	176
PCT9252	MV	810	374	0	0	31	343	214	129
PCT9252	ED	143	127	0	0	9	118	85	33
PCT9252	TO	953	501	0	0	40	461	299	162
PCT9253	MV	599	295	0	0	17	278	186	92
PCT9253	ED	162	116	0	0	10	106	73	33
PCT9253	TO	761	411	0	0	27	384	259	125
PCT9254	MV	758	403	0	0	28	375	275	100
PCT9254	ED	163	155	0	0	23	132	84	48
PCT9254	TO	921	558	0	0	51	507	359	148
PCT9255	MV	436	194	0	0	23	171	112	59
PCT9255	ED	114	112	0	0	11	101	76	25
PCT9255	TO	550	306	0	0	34	272	188	84
PCT9256	MV	367	166	0	0	13	153	112	41
PCT9256	ED	95	74	0	0	7	67	45	22
PCT9256	TO	462	240	0	0	20	220	157	63
PCT9257	MV	359	157	0	0	15	142	121	21
PCT9257	ED	-39	0	0	0	0	0	0	0
PCT9257	TO	320	157	0	0	15	142	121	21
PCT9258	MV	583	301	0	0	28	273	186	87
PCT9258	ED	120	103	0	0	6	97	73	24
PCT9258	TO	703	404	0	0	34	370	259	111
PCT9401	MV	794	354	0	0	19	335	261	74
PCT9401	ED	244	176	0	0	9	167	137	30
PCT9401	TO	1038	530	0	0	28	502	398	104
PCT9402	MV	774	369	0	0	16	353	248	105
PCT9402	ED	243	159	0	0	11	148	119	29
PCT9402	TO	1017	528	0	0	27	501	367	134
PCT9403	MV	731	338	0	0	14	324	216	108
PCT9403	ED	190	123	0	0	6	117	99	18
PCT9403	TO	921	461	0	0	20	441	315	126
PCT9404	MV	752	344	0	0	17	327	210	117
PCT9404	ED	192	154	0	0	10	144	106	38
PCT9404	TO	944	498	0	0	27	471	316	155
PCT9405	MV	628	275	0	0	20	255	159	96
PCT9405	ED	152	104	0	0	4	100	65	35
PCT9405	TO	780	379	0	0	24	355	224	131
PCT9406	MV	694	323	0	0	19	304	196	108
PCT9406	ED	189	150	0	0	6	144	98	46
PCT9406	TO	883	473	0	0	25	448	294	154
PCT9407	MV	712	363	0	0	13	350	262	88
PCT9407	ED	201	131	0	0	13	118	90	28
PCT9407	TO	913	494	0	0	26	468	352	116
PCT9408	MV	709	310	0	0	24	286	226	60
PCT9408	ED	154	125	0	0	12	113	90	23
PCT9408	TO	863	435	0	0	36	399	316	83
PCT9409	MV	443	220	0	0	16	204	155	49
PCT9409	ED	158	127	0	0	5	122	101	21
PCT9409	TO	601	347	0	0	21	326	256	70
PCT9411	MV	816	364	0	0	23	341	250	91
PCT9411	ED	191	135	0	0	6	129	102	27
PCT9411	TO	1007	499	0	0	29	470	352	118
PCT9412	MV	668	335	0	0	20	315	197	118
PCT9412	ED	202	138	0	0	7	131	99	32
PCT9412	TO	870	473	0	0	27	446	296	150
PCT9413	MV	757	366	0	0	32	334	200	134
PCT9413	ED	179	127	0	0	7	120	88	32
PCT9413	TO	936	493	0	0	39	454	288	166
PCT9414	MV	734	358	0	0	21	337	209	128
PCT9414	ED	186	107	0	0	4	103	73	30
PCT9414	TO	920	465	0	0	25	440	282	158
PCT9415	MV	634	307	0	0	17	290	186	104
PCT9415	ED	154	96	0	0	4	92	66	26
PCT9415	TO	788	403	0	0	21	382	252	130
PCT9416	MV	768	382	0	0	34	348	219	129
PCT9416	ED	231	143	0	0	4	139	96	43
PCT9416	TO	999	525	0	0	38	487	315	172
PCT9417	MV	628	317	0	0	21	296	165	131
PCT9417	ED	146	110	0	0	3	107	75	32
PCT9417	TO	774	427	0	0	24	403	240	163
PCT9418	MV	627	304	0	0	22	282	156	126
PCT9418	ED	192	122	0	0	8	114	75	39
PCT9418	TO	819	426	0	0	30	396	231	165
PCT9419	MV	736	363	0	0	22	341	175	166
PCT9419	ED	173	107	0	0	8	99	58	41
PCT9419	TO	909	470	0	0	30	440	233	207
PCT9421	MV	752	330	0	0	25	305	155	150
PCT9421	ED	173	112	0	0	6	106	70	36
PCT9421	TO	925	442	0	0	31	411	225	186
PCT9422	MV	831	406	0	0	25	381	222	159
PCT9422	ED	270	145	0	0	10	135	97	38
PCT9422	TO	1101	551	0	0	35	516	319	197
PCT9423	MV	711	309	0	0	21	288	178	110
PCT9423	ED	193	121	0	0	7	114	84	30
PCT9423	TO	904	430	0	0	28	402	262	140
PCT9424	MV	797	379	0	1	21	357	201	156
PCT9424	ED	212	114	0	0	8	106	77	29
PCT9424	TO	1009	493	0	1	29	463	278	185
PCT9425	MV	789	339	0	0	24	315	184	131
PCT9425	ED	187	114	0	0	7	107	72	35
PCT9425	TO	976	453	0	0	31	422	256	166
PCT9426	MV	696	317	0	0	21	296	154	142
PCT9426	ED	157	104	0	0	12	92	59	33
PCT9426	TO	853	421	0	0	33	388	213	175
PCT9427	MV	797	377	0	1	20	356	185	171
PCT9427	ED	190	115	0	0	13	102	56	46
PCT9427	TO	987	492	0	1	33	458	241	217
PCT9428	MV	809	343	0	0	25	318	190	128
PCT9428	ED	181	113	0	0	8	105	78	27
PCT9428	TO	990	456	0	0	33	423	268	155
PCT9429	MV	707	339	0	0	20	319	172	147
PCT9429	ED	199	124	0	0	16	108	67	41
PCT9429	TO	906	463	0	0	36	427	239	188
PCT9431	MV	831	408	0	0	28	380	201	179
PCT9431	ED	205	125	0	0	4	121	82	39
PCT9431	TO	1036	533	0	0	32	501	283	218
PCT9432	MV	742	352	0	0	30	322	181	141
PCT9432	ED	216	117	0	0	8	109	77	32
PCT9432	TO	958	469	0	0	38	431	258	173
PCT9433	MV	792	372	0	0	28	344	185	159
PCT9433	ED	166	93	0	0	6	87	49	38
PCT9433	TO	958	465	0	0	34	431	234	197
PCT9434	MV	780	384	0	0	26	358	228	130
PCT9434	ED	232	162	0	0	17	145	107	38
PCT9434	TO	1012	546	0	0	43	503	335	168
PCT9435	MV	776	364	0	0	23	341	188	153
PCT9435	ED	228	157	0	0	7	150	98	52
PCT9435	TO	1004	521	0	0	30	491	286	205
PCT9436	MV	840	379	0	0	18	361	202	159
PCT9436	ED	228	129	0	0	9	120	79	41
PCT9436	TO	1068	508	0	0	27	481	281	200
PCT9437	MV	735	369	0	0	18	351	204	147
PCT9437	ED	192	130	0	0	2	128	83	45
PCT9437	TO	927	499	0	0	20	479	287	192
PCT9438	MV	836	410	0	0	22	388	213	175
PCT9438	ED	153	83	0	0	6	77	51	26
PCT9438	TO	989	493	0	0	28	465	264	201
PCT9439	MV	718	337	0	0	16	321	189	132
PCT9439	ED	199	111	0	0	12	99	64	35
PCT9439	TO	917	448	0	0	28	420	253	167
PCT9441	MV	773	390	0	0	28	362	218	144
PCT9441	ED	198	125	0	0	13	112	84	28
PCT9441	TO	971	515	0	0	41	474	302	172
PCT9442	MV	827	370	0	0	36	334	182	152
PCT9442	ED	213	156	0	0	10	146	108	38
PCT9442	TO	1040	526	0	0	46	480	290	190
PCT9443	MV	759	353	0	0	21	332	207	125
PCT9443	ED	196	109	0	0	4	105	72	33
PCT9443	TO	955	462	0	0	25	437	279	158
PCT9444	MV	764	332	0	0	12	320	170	150
PCT9444	ED	201	94	0	0	9	85	59	26
PCT9444	TO	965	426	0	0	21	405	229	176
PCT9445	MV	824	399	0	0	24	375	225	150
PCT9445	ED	172	113	0	0	6	107	69	38
PCT9445	TO	996	512	0	0	30	482	294	188
PCT9446	MV	900	461	0	0	27	434	242	192
PCT9446	ED	216	145	0	0	10	135	91	44
PCT9446	TO	1116	606	0	0	37	569	333	236
PCT9447	MV	728	387	0	0	17	370	208	162
PCT9447	ED	193	143	0	0	13	130	86	44
PCT9447	TO	921	530	0	0	30	500	294	206
PCT9448	MV	740	338	0	0	21	317	184	133
PCT9448	ED	200	127	0	0	6	121	93	28
PCT9448	TO	940	465	0	0	27	438	277	161
PCT9449	MV	717	337	0	0	20	317	151	166
PCT9449	ED	164	96	0	0	7	89	59	30
PCT9449	TO	881	433	0	0	27	406	210	196
PCT9451	MV	353	176	0	0	7	169	85	84
PCT9451	ED	88	54	0	0	2	52	37	15
PCT9451	TO	441	230	0	0	9	221	122	99
PCT9452	MV	647	327	0	0	22	305	165	140
PCT9452	ED	195	134	0	0	10	124	70	54
PCT9452	TO	842	461	0	0	32	429	235	194
PCT9453	MV	409	216	0	0	12	204	105	99
PCT9453	ED	115	70	0	0	7	63	37	26
PCT9453	TO	524	286	0	0	19	267	142	125
PCT9501	MV	158	92	0	0	11	81	58	23
PCT9501	ED	-8	0	0	0	0	0	0	0
PCT9501	TO	150	92	0	0	11	81	58	23
PCT9502	MV	294	133	0	0	12	121	88	33
PCT9502	ED	-43	0	0	0	0	0	0	0
PCT9502	TO	251	133	0	0	12	121	88	33
PCT9503	MV	550	259	0	0	28	231	202	29
PCT9503	ED	150	82	0	0	4	78	66	12
PCT9503	TO	700	341	0	0	32	309	268	41
PCT9505	MV	589	291	0	0	23	268	198	70
PCT9505	ED	176	110	0	0	6	104	85	19
PCT9505	TO	765	401	0	0	29	372	283	89
PCT9506	MV	547	229	0	0	17	212	171	41
PCT9506	ED	207	128	0	0	11	117	100	17
PCT9506	TO	754	357	0	0	28	329	271	58
PCT9507	MV	556	301	0	0	21	280	225	55
PCT9507	ED	160	152	0	0	17	135	111	24
PCT9507	TO	716	453	0	0	38	415	336	79
PCT9508	MV	632	306	0	0	18	288	238	50
PCT9508	ED	148	132	0	0	9	123	108	15
PCT9508	TO	780	438	0	0	27	411	346	65
PCT9509	MV	585	294	0	0	18	276	205	71
PCT9509	ED	142	121	0	0	8	113	96	17
PCT9509	TO	727	415	0	0	26	389	301	88
PCT9511	MV	457	235	0	0	18	217	177	40
PCT9511	ED	177	120	0	0	3	117	96	21
PCT9511	TO	634	355	0	0	21	334	273	61
PCT9512	MV	617	319	0	0	19	300	231	69
PCT9512	ED	160	132	0	0	8	124	107	17
PCT9512	TO	777	451	0	0	27	424	338	86
PCT9513	MV	686	323	0	0	20	303	264	39
PCT9513	ED	191	126	0	0	7	119	104	15
PCT9513	TO	877	449	0	0	27	422	368	54
PCT9514	MV	713	347	0	0	31	316	252	64
PCT9514	ED	183	167	0	0	14	153	133	20
PCT9514	TO	896	514	0	0	45	469	385	84
PCT9515	MV	542	293	0	0	20	273	212	61
PCT9515	ED	170	133	0	0	11	122	94	28
PCT9515	TO	712	426	0	0	31	395	306	89
PCT9516	MV	705	357	0	0	26	331	250	81
PCT9516	ED	184	157	0	0	8	149	106	43
PCT9516	TO	889	514	0	0	34	480	356	124
PCT9517	MV	625	333	0	0	28	305	247	58
PCT9517	ED	163	135	0	0	16	119	103	16
PCT9517	TO	788	468	0	0	44	424	350	74
PCT9518	MV	641	312	0	0	27	285	237	48
PCT9518	ED	147	146	0	0	5	141	107	34
PCT9518	TO	788	458	0	0	32	426	344	82
PCT9519	MV	693	361	0	0	25	336	262	74
PCT9519	ED	198	170	0	0	9	161	118	43
PCT9519	TO	891	531	0	0	34	497	380	117
PCT9521	MV	687	348	0	0	24	324	253	71
PCT9521	ED	214	190	0	0	14	176	149	27
PCT9521	TO	901	538	0	0	38	500	402	98
PCT9701	MV	498	266	0	0	19	247	180	67
PCT9701	ED	156	135	0	0	5	130	107	23
PCT9701	TO	654	401	0	0	24	377	287	90
PCT9702	MV	553	296	0	0	16	280	197	83
PCT9702	ED	167	143	0	0	6	137	117	20
PCT9702	TO	720	439	0	0	22	417	314	103
PCT9703	MV	808	398	0	0	38	360	209	151
PCT9703	ED	183	142	0	0	6	136	95	41
PCT9703	TO	991	540	0	0	44	496	304	192
PCT9704	MV	759	417	0	0	30	387	252	135
PCT9704	ED	200	196	0	0	10	186	141	45
PCT9704	TO	959	613	0	0	40	573	393	180
PCT9705	MV	753	403	0	0	27	376	269	107
PCT9705	ED	176	142	0	0	11	131	107	24
PCT9705	TO	929	545	0	0	38	507	376	131
PCT9706	MV	57	33	0	0	2	31	24	7
PCT9706	ED	-8	0	0	0	0	0	0	0
PCT9706	TO	49	33	0	0	2	31	24	7
PCT9707	MV	687	352	0	0	21	331	186	145
PCT9707	ED	139	101	0	0	8	93	61	32
PCT9707	TO	826	453	0	0	29	424	247	177
PCT9708	MV	786	425	0	1	36	388	277	111
PCT9708	ED	175	157	0	0	5	152	110	42
PCT9708	TO	961	582	0	1	41	540	387	153
PCT9709	MV	831	418	0	0	37	381	217	164
PCT9709	ED	209	178	0	0	7	171	110	61
PCT9709	TO	1040	596	0	0	44	552	327	225
PCT9711	MV	502	306	0	0	18	288	179	109
PCT9711	ED	144	138	0	0	6	132	85	47
PCT9711	TO	646	444	0	0	24	420	264	156
PCT9712	MV	534	327	0	0	21	306	174	132
PCT9712	ED	127	116	0	0	3	113	69	44
PCT9712	TO	661	443	0	0	24	419	243	176
PCT9713	MV	746	384	0	0	19	365	209	156
PCT9713	ED	204	137	0	0	6	131	85	46
PCT9713	TO	950	521	0	0	25	496	294	202
PCT9714	MV	795	436	0	0	31	405	234	171
PCT9714	ED	156	133	0	0	2	131	80	51
PCT9714	TO	951	569	0	0	33	536	314	222
PCT9715	MV	449	237	0	0	15	222	134	88
PCT9715	ED	130	134	0	0	3	131	89	42
PCT9715	TO	579	371	0	0	18	353	223	130
PCT9716	MV	744	394	0	0	30	364	217	147
PCT9716	ED	222	164	0	0	10	154	102	52
PCT9716	TO	966	558	0	0	40	518	319	199
PCT9717	MV	753	424	0	0	26	398	221	177
PCT9717	ED	224	144	0	0	13	131	80	51
PCT9717	TO	977	568	0	0	39	529	301	228
PCT9718	MV	742	443	0	0	27	416	255	161
PCT9718	ED	159	144	0	0	6	138	85	53
PCT9718	TO	901	587	0	0	33	554	340	214
PCT9719	MV	747	451	0	0	23	428	253	175
PCT9719	ED	173	150	0	0	8	142	86	56
PCT9719	TO	920	601	0	0	31	570	339	231
PCT9721	MV	498	284	0	0	18	266	140	126
PCT9721	ED	164	133	0	0	5	128	73	55
PCT9721	TO	662	417	0	0	23	394	213	181
PCT9722	MV	513	311	0	0	19	292	179	113
PCT9722	ED	84	76	0	0	5	71	45	26
PCT9722	TO	597	387	0	0	24	363	224	139
PCT9723	MV	434	219	0	0	9	210	74	136
PCT9723	ED	74	44	0	0	3	41	20	21
PCT9723	TO	508	263	0	0	12	251	94	157
PCT9724	MV	848	450	0	1	24	425	187	238
PCT9724	ED	172	99	0	0	4	95	54	41
PCT9724	TO	1020	549	0	1	28	520	241	279
PCT9725	MV	806	431	0	0	24	407	195	212
PCT9725	ED	165	95	0	0	10	85	35	50
PCT9725	TO	971	526	0	0	34	492	230	262
PCT9726	MV	565	214	0	0	18	196	152	44
PCT9726	ED	51	102	0	0	6	96	71	25
PCT9726	TO	616	316	0	0	24	292	223	69
PCT9727	MV	403	220	0	2	11	207	110	97
PCT9727	ED	57	33	0	0	2	31	19	12
PCT9727	TO	460	253	0	2	13	238	129	109
PCT9728	MV	750	441	0	0	24	417	212	205
PCT9728	ED	213	137	0	0	8	129	78	51
PCT9728	TO	963	578	0	0	32	546	290	256
PCT9729	MV	654	331	0	0	22	309	157	152
PCT9729	ED	164	128	0	0	3	125	78	47
PCT9729	TO	818	459	0	0	25	434	235	199
PCT9731	MV	436	238	0	0	15	223	116	107
PCT9731	ED	143	111	0	0	9	102	59	43
PCT9731	TO	579	349	0	0	24	325	175	150
PCT9732	MV	78	47	0	0	6	41	22	19
PCT9732	ED	-5	0	0	0	0	0	0	0
PCT9732	TO	73	47	0	0	6	41	22	19
PCT9733	MV	261	154	0	0	4	150	109	41
PCT9733	ED	-21	0	0	0	0	0	0	0
PCT9733	TO	240	154	0	0	4	150	109	41
PCT9734	MV	473	283	0	0	15	268	150	118
PCT9734	ED	131	109	0	0	3	106	66	40
PCT9734	TO	604	392	0	0	18	374	216	158
PCT9735	MV	650	384	0	0	20	364	211	153
PCT9735	ED	170	132	0	0	16	116	66	50
PCT9735	TO	820	516	0	0	36	480	277	203
PCT9736	MV	586	318	0	0	21	297	194	103
PCT9736	ED	150	151	0	0	10	141	94	47
PCT9736	TO	736	469	0	0	31	438	288	150
PCT9737	MV	636	383	0	0	22	361	203	158
PCT9737	ED	155	135	0	0	7	128	90	38
PCT9737	TO	791	518	0	0	29	489	293	196
PCT9738	MV	687	311	0	0	22	289	214	75
PCT9738	ED	151	64	0	0	5	59	41	18
PCT9738	TO	838	375	0	0	27	348	255	93
PCT9739	MV	639	263	0	0	10	253	207	46
PCT9739	ED	150	88	0	0	3	85	71	14
PCT9739	TO	789	351	0	0	13	338	278	60
PCT9741	MV	508	168	0	0	15	153	142	11
PCT9741	ED	-67	10	0	0	2	8	8	0
PCT9741	TO	441	178	0	0	17	161	150	11
PCT9742	MV	529	222	0	0	8	214	107	107
PCT9742	ED	166	98	0	0	6	92	48	44
PCT9742	TO	695	320	0	0	14	306	155	151
PCT9743	MV	898	393	0	0	21	372	276	96
PCT9743	ED	242	170	0	0	13	157	130	27
PCT9743	TO	1140	563	0	0	34	529	406	123
PCT9744	MV	752	328	0	0	22	306	243	63
PCT9744	ED	191	121	0	0	9	112	93	19
PCT9744	TO	943	449	0	0	31	418	336	82
PCT9745	MV	755	313	0	0	23	290	239	51
PCT9745	ED	237	128	0	0	11	117	104	13
PCT9745	TO	992	441	0	0	34	407	343	64
PCT9746	MV	712	365	0	0	13	352	211	141
PCT9746	ED	191	118	0	0	11	107	66	41
PCT9746	TO	903	483	0	0	24	459	277	182
PCT9747	MV	768	393	0	0	17	376	250	126
PCT9747	ED	208	145	0	0	10	135	103	32
PCT9747	TO	976	538	0	0	27	511	353	158
PCT9748	MV	746	420	0	1	21	398	266	132
PCT9748	ED	167	116	0	0	4	112	68	44
PCT9748	TO	913	536	0	1	25	510	334	176
PCT9749	MV	749	281	0	0	9	272	192	80
PCT9749	ED	189	108	0	0	2	106	82	24
PCT9749	TO	938	389	0	0	11	378	274	104
PCT9751	MV	856	463	0	1	27	435	268	167
PCT9751	ED	215	151	0	0	15	136	99	37
PCT9751	TO	1071	614	0	1	42	571	367	204
PCT9752	MV	563	323	0	0	20	303	180	123
PCT9752	ED	134	108	0	0	3	105	77	28
PCT9752	TO	697	431	0	0	23	408	257	151
PCT9753	MV	617	293	0	0	18	275	200	75
PCT9753	ED	145	123	0	0	2	121	98	23
PCT9753	TO	762	416	0	0	20	396	298	98
PCT9754	MV	544	316	0	0	15	301	227	74
PCT9754	ED	163	113	0	0	8	105	86	19
PCT9754	TO	707	429	0	0	23	406	313	93
PCT9755	MV	441	238	0	0	18	220	150	70
PCT9755	ED	139	99	0	0	2	97	71	26
PCT9755	TO	580	337	0	0	20	317	221	96
PCT9756	MV	801	362	0	0	23	339	192	147
PCT9756	ED	166	106	0	0	5	101	71	30
PCT9756	TO	967	468	0	0	28	440	263	177
PCT9801	MV	320	158	0	0	12	146	104	42
PCT9801	ED	88	52	0	0	3	49	41	8
PCT9801	TO	408	210	0	0	15	195	145	50
PCT9900	MV	0	0	0	0	0	0	0	0
PCT9900	ED	0	0	0	0	0	0	0	0
PCT9900	TO	0	0	0	0	0	0	0	0
PCT9901	MV	0	0	0	0	0	0	0	0
PCT9901	ED	0	0	0	0	0	0	0	0
PCT9901	TO	0	0	0	0	0	0	0	0
PCT9902	MV	0	0	0	0	0	0	0	0
PCT9902	ED	0	0	0	0	0	0	0	0
PCT9902	TO	0	0	0	0	0	0	0	0
CONG12	MV	355422	171399	0	28	12632	158739	112095	46644
CONG12	ED	90426	65251	0	9	4682	60560	46589	13971
CONG12	TO	445848	236650	0	37	17314	219299	158684	60615
CONG14	MV	46630	21987	0	10	1194	20783	12939	7844
CONG14	ED	11421	6926	0	0	404	6522	4620	1902
CONG14	TO	58051	28913	0	10	1598	27305	17559	9746
ASSM17	MV	232714	112342	0	17	8286	104039	76385	27654
ASSM17	ED	59708	41964	0	9	2980	38975	31035	7940
ASSM17	TO	292422	154306	0	26	11266	143014	107420	35594
ASSM19	MV	169338	81044	0	21	5540	75483	48649	26834
ASSM19	ED	42139	30213	0	0	2106	28107	20174	7933
ASSM19	TO	211477	111257	0	21	7646	103590	68823	34767
SUPV1	MV	33848	16279	0	2	1111	15166	10379	4787
SUPV1	ED	9268	6893	0	0	452	6441	4804	1637
SUPV1	TO	43116	23172	0	2	1563	21607	15183	6424
SUPV2	MV	41429	19608	0	7	1764	17837	11538	6299
SUPV2	ED	8617	7551	0	0	731	6820	4678	2142
SUPV2	TO	50046	27159	0	7	2495	24657	16216	8441
SUPV3	MV	31930	14092	0	4	1243	12845	8878	3967
SUPV3	ED	7447	5109	0	3	432	4674	3588	1086
SUPV3	TO	39377	19201	0	7	1675	17519	12466	5053
SUPV4	MV	34985	16592	0	2	1028	15562	9264	6298
SUPV4	ED	9109	5869	0	0	382	5487	3852	1635
SUPV4	TO	44094	22461	0	2	1410	21049	13116	7933
SUPV5	MV	41957	21096	0	1	1639	19456	15427	4029
SUPV5	ED	10943	8955	0	1	641	8313	6875	1438
SUPV5	TO	52900	30051	0	2	2280	27769	22302	5467
SUPV6	MV	35745	14963	0	2	1216	13745	10058	3687
SUPV6	ED	7950	4327	0	1	388	3938	3095	843
SUPV6	TO	43695	19290	0	3	1604	17683	13153	4530
SUPV7	MV	38328	20392	0	7	1254	19131	12019	7112
SUPV7	ED	9115	7178	0	0	394	6784	4669	2115
SUPV7	TO	47443	27570	0	7	1648	25915	16688	9227
SUPV8	MV	46363	26976	0	5	1922	25049	18909	6140
SUPV8	ED	11814	11078	0	4	733	10341	8270	2071
SUPV8	TO	58177	38054	0	9	2655	35390	27179	8211
SUPV9	MV	33157	16480	0	1	1021	15458	11797	3661
SUPV9	ED	10106	7052	0	0	395	6657	5514	1143
SUPV9	TO	43263	23532	0	1	1416	22115	17311	4804
SUPV10	MV	33748	13671	0	2	930	12739	8793	3946
SUPV10	ED	9365	4180	0	0	302	3878	3050	828
SUPV10	TO	43113	17851	0	2	1232	16617	11843	4774
SUPV11	MV	30562	13237	0	5	698	12534	7972	4562
SUPV11	ED	8113	3985	0	0	236	3749	2814	935
SUPV11	TO	38675	17222	0	5	934	16283	10786	5497
NEIG1	MV	15456	5842	0	1	394	5447	3708	1739
NEIG1	ED	5029	1543	0	0	89	1454	1159	295
NEIG1	TO	20485	7385	0	1	483	6901	4867	2034
NEIG2	MV	14025	6157	0	0	607	5550	3710	1840
NEIG2	ED	3242	2161	0	2	202	1957	1469	488
NEIG2	TO	17267	8318	0	2	809	7507	5179	2328
NEIG3	MV	22038	9268	0	4	778	8486	6495	1991
NEIG3	ED	5981	3247	0	1	254	2992	2412	580
NEIG3	TO	28019	12515	0	5	1032	11478	8907	2571
NEIG4	MV	5628	3436	0	0	223	3213	2251	962
NEIG4	ED	1432	1236	0	1	83	1152	832	320
NEIG4	TO	7060	4672	0	1	306	4365	3083	1282
NEIG5	MV	22668	9994	0	1	560	9433	5976	3457
NEIG5	ED	5925	2958	0	0	178	2780	2051	729
NEIG5	TO	28593	12952	0	1	738	12213	8027	4186
NEIG6	MV	11525	5835	0	1	422	5412	4368	1044
NEIG6	ED	2337	2735	0	1	190	2544	2139	405
NEIG6	TO	13862	8570	0	2	612	7956	6507	1449
NEIG7	MV	9764	4044	0	4	182	3858	2484	1374
NEIG7	ED	2631	1293	0	0	68	1225	957	268
NEIG7	TO	12395	5337	0	4	250	5083	3441	1642
NEIG8	MV	7624	3949	0	0	298	3651	2822	829
NEIG8	ED	2034	1820	0	0	122	1698	1359	339
NEIG8	TO	9658	5769	0	0	420	5349	4181	1168
NEIG9	MV	6892	3090	0	1	188	2901	1929	972
NEIG9	ED	1366	921	0	0	66	855	627	228
NEIG9	TO	8258	4011	0	1	254	3756	2556	1200
NEIG10	MV	8170	3814	0	0	294	3520	2465	1055
NEIG10	ED	1852	1658	0	0	125	1533	1155	378
NEIG10	TO	10022	5472	0	0	419	5053	3620	1433
NEIG11	MV	33505	15264	0	6	1427	13831	8961	4870
NEIG11	ED	5935	5701	0	0	586	5115	3532	1583
NEIG11	TO	39440	20965	0	6	2013	18946	12493	6453
NEIG12	MV	23568	11636	0	0	759	10877	8897	1980
NEIG12	ED	7437	5267	0	0	347	4920	4215	705
NEIG12	TO	31005	16903	0	0	1106	15797	13112	2685
NEIG14	MV	6790	3923	0	0	262	3661	2912	749
NEIG14	ED	1943	1783	0	0	82	1701	1416	285
NEIG14	TO	8733	5706	0	0	344	5362	4328	1034
NEIG15	MV	5778	2610	0	1	173	2436	1608	828
NEIG15	ED	1310	1007	0	1	79	927	712	215
NEIG15	TO	7088	3617	0	2	252	3363	2320	1043
NEIG13	MV	13551	7997	0	2	589	7406	5470	1936
NEIG13	ED	3437	3361	0	0	209	3152	2472	680
NEIG13	TO	16988	11358	0	2	798	10558	7942	2616
NEIG26	MV	7828	3472	0	1	200	3271	1886	1385
NEIG26	ED	1804	941	0	0	50	891	624	267
NEIG26	TO	9632	4413	0	1	250	4162	2510	1652
NEIG16	MV	14619	6688	0	1	551	6136	4420	1716
NEIG16	ED	2737	2400	0	0	209	2191	1738	453
NEIG16	TO	17356	9088	0	1	760	8327	6158	2169
NEIG17	MV	29430	14222	0	2	974	13246	9017	4229
NEIG17	ED	8195	5965	0	0	388	5577	4151	1426
NEIG17	TO	37625	20187	0	2	1362	18823	13168	5655
NEIG19	MV	7162	3939	0	1	242	3696	2834	862
NEIG19	ED	2409	1863	0	0	105	1758	1428	330
NEIG19	TO	9571	5802	0	1	347	5454	4262	1192
NEIG18	MV	6455	3322	0	1	246	3075	1937	1138
NEIG18	ED	1566	1453	0	0	111	1342	915	427
NEIG18	TO	8021	4775	0	1	357	4417	2852	1565
NEIG20	MV	20904	8767	0	1	696	8070	5733	2337
NEIG20	ED	4173	2417	0	0	223	2194	1666	528
NEIG20	TO	25077	11184	0	1	919	10264	7399	2865
NEIG21	MV	34542	16372	0	2	1012	15358	9109	6249
NEIG21	ED	8951	5742	0	0	377	5365	3751	1614
NEIG21	TO	43493	22114	0	2	1389	20723	12860	7863
NEIG22	MV	15378	9122	0	2	651	8469	6447	2022
NEIG22	ED	3515	3598	0	3	237	3358	2709	649
NEIG22	TO	18893	12720	0	5	888	11827	9156	2671
NEIG23	MV	6633	2470	0	0	132	2338	1431	907
NEIG23	ED	1855	598	0	0	48	550	403	147
NEIG23	TO	8488	3068	0	0	180	2888	1834	1054
NEIG24	MV	28412	15843	0	6	986	14851	9149	5702
NEIG24	ED	6962	5659	0	0	302	5357	3594	1763
NEIG24	TO	35374	21502	0	6	1288	20208	12743	7465
NEIG25	MV	23707	12310	0	0	980	11330	9015	2315
NEIG25	ED	7789	4850	0	0	356	4494	3723	771
NEIG25	TO	31496	17160	0	0	1336	15824	12738	3086
