area_id	subtotal_type	RSReg	RSCst	RSRej	RSOvr	RSUnd	RSTot	11:YES	12:NO
ALLPCTS	TO	503899	304940	0	59	32962	271919	151293	120626
ALLPCTS	ED	101263	107004	0	17	13703	93284	56353	36931
ALLPCTS	MV	402636	197936	0	42	19259	178635	94940	83695
PCT1101	MV	448	216	0	0	24	192	117	75
PCT1101	ED	114	93	0	0	13	80	52	28
PCT1101	TO	562	309	0	0	37	272	169	103
PCT1102	MV	774	370	0	0	26	344	166	178
PCT1102	ED	230	209	0	0	23	186	111	75
PCT1102	TO	1004	579	0	0	49	530	277	253
PCT1103	MV	749	373	0	0	22	351	198	153
PCT1103	ED	222	194	0	0	19	175	101	74
PCT1103	TO	971	567	0	0	41	526	299	227
PCT1104	MV	751	343	0	0	32	311	191	120
PCT1104	ED	267	169	0	0	16	153	101	52
PCT1104	TO	1018	512	0	0	48	464	292	172
PCT1106	MV	598	256	0	0	25	231	126	105
PCT1106	ED	173	149	0	0	13	136	78	58
PCT1106	TO	771	405	0	0	38	367	204	163
PCT1107	MV	612	288	0	0	21	267	136	131
PCT1107	ED	139	125	0	0	13	112	69	43
PCT1107	TO	751	413	0	0	34	379	205	174
PCT1108	MV	725	360	0	0	29	331	187	144
PCT1108	ED	198	159	0	0	23	136	90	46
PCT1108	TO	923	519	0	0	52	467	277	190
PCT1109	MV	653	285	0	0	21	264	140	124
PCT1109	ED	169	141	0	0	15	126	82	44
PCT1109	TO	822	426	0	0	36	390	222	168
PCT1111	MV	849	354	0	0	34	320	180	140
PCT1111	ED	197	189	0	0	20	169	115	54
PCT1111	TO	1046	543	0	0	54	489	295	194
PCT1112	MV	643	280	0	0	19	261	152	109
PCT1112	ED	159	119	0	0	10	109	82	27
PCT1112	TO	802	399	0	0	29	370	234	136
PCT1113	MV	675	287	0	0	26	261	144	117
PCT1113	ED	120	108	0	0	21	87	59	28
PCT1113	TO	795	395	0	0	47	348	203	145
PCT1114	MV	769	328	0	0	28	300	181	119
PCT1114	ED	222	167	0	0	27	140	101	39
PCT1114	TO	991	495	0	0	55	440	282	158
PCT1115	MV	743	296	0	0	24	272	156	116
PCT1115	ED	193	131	0	0	16	115	83	32
PCT1115	TO	936	427	0	0	40	387	239	148
PCT1116	MV	715	309	0	0	30	279	178	101
PCT1116	ED	216	197	0	0	23	174	127	47
PCT1116	TO	931	506	0	0	53	453	305	148
PCT1117	MV	665	259	0	0	23	236	144	92
PCT1117	ED	181	152	0	0	15	137	105	32
PCT1117	TO	846	411	0	0	38	373	249	124
PCT1118	MV	846	366	0	0	19	347	198	149
PCT1118	ED	219	164	0	0	22	142	97	45
PCT1118	TO	1065	530	0	0	41	489	295	194
PCT1119	MV	659	305	0	0	20	285	167	118
PCT1119	ED	138	117	0	0	13	104	78	26
PCT1119	TO	797	422	0	0	33	389	245	144
PCT1121	MV	556	269	0	0	32	237	135	102
PCT1121	ED	149	123	0	0	11	112	71	41
PCT1121	TO	705	392	0	0	43	349	206	143
PCT1122	MV	519	247	0	0	24	223	114	109
PCT1122	ED	118	97	0	0	11	86	47	39
PCT1122	TO	637	344	0	0	35	309	161	148
PCT1123	MV	730	258	0	0	23	235	137	98
PCT1123	ED	208	151	0	0	14	137	110	27
PCT1123	TO	938	409	0	0	37	372	247	125
PCT1124	MV	631	246	0	0	10	236	145	91
PCT1124	ED	198	125	0	0	10	115	89	26
PCT1124	TO	829	371	0	0	20	351	234	117
PCT1125	MV	919	365	0	1	44	320	194	126
PCT1125	ED	178	115	0	0	16	99	78	21
PCT1125	TO	1097	480	0	1	60	419	272	147
PCT1126	MV	812	308	0	0	26	282	165	117
PCT1126	ED	200	108	0	0	8	100	69	31
PCT1126	TO	1012	416	0	0	34	382	234	148
PCT1127	MV	743	296	0	0	19	277	139	138
PCT1127	ED	222	148	0	0	15	133	83	50
PCT1127	TO	965	444	0	0	34	410	222	188
PCT1128	MV	734	287	0	0	27	260	144	116
PCT1128	ED	145	108	0	0	14	94	65	29
PCT1128	TO	879	395	0	0	41	354	209	145
PCT1129	MV	790	314	0	1	27	286	175	111
PCT1129	ED	246	146	0	0	20	126	88	38
PCT1129	TO	1036	460	0	1	47	412	263	149
PCT1131	MV	694	280	0	1	35	244	112	132
PCT1131	ED	166	111	0	0	16	95	56	39
PCT1131	TO	860	391	0	1	51	339	168	171
PCT1132	MV	838	370	0	0	32	338	180	158
PCT1132	ED	194	103	0	0	10	93	54	39
PCT1132	TO	1032	473	0	0	42	431	234	197
PCT1133	MV	716	336	0	0	20	316	154	162
PCT1133	ED	159	113	0	0	10	103	54	49
PCT1133	TO	875	449	0	0	30	419	208	211
PCT1134	MV	585	293	0	0	21	272	129	143
PCT1134	ED	182	127	0	0	16	111	81	30
PCT1134	TO	767	420	0	0	37	383	210	173
PCT1135	MV	465	220	0	0	15	205	107	98
PCT1135	ED	91	61	0	0	4	57	32	25
PCT1135	TO	556	281	0	0	19	262	139	123
PCT1136	MV	710	342	0	0	19	323	186	137
PCT1136	ED	157	117	0	0	8	109	70	39
PCT1136	TO	867	459	0	0	27	432	256	176
PCT1141	MV	836	394	0	0	31	363	199	164
PCT1141	ED	220	185	0	0	16	169	111	58
PCT1141	TO	1056	579	0	0	47	532	310	222
PCT1142	MV	721	330	0	0	39	291	179	112
PCT1142	ED	175	119	0	0	9	110	72	38
PCT1142	TO	896	449	0	0	48	401	251	150
PCT1143	MV	824	360	0	0	39	321	202	119
PCT1143	ED	225	189	0	0	23	166	125	41
PCT1143	TO	1049	549	0	0	62	487	327	160
PCT1144	MV	727	327	0	0	24	303	172	131
PCT1144	ED	220	165	0	0	21	144	87	57
PCT1144	TO	947	492	0	0	45	447	259	188
PCT1145	MV	753	411	0	0	34	377	207	170
PCT1145	ED	152	152	0	1	16	135	96	39
PCT1145	TO	905	563	0	1	50	512	303	209
PCT1146	MV	839	364	0	0	26	338	206	132
PCT1146	ED	215	160	0	0	14	146	104	42
PCT1146	TO	1054	524	0	0	40	484	310	174
PCT1147	MV	673	310	0	0	19	291	174	117
PCT1147	ED	212	159	0	0	21	138	91	47
PCT1147	TO	885	469	0	0	40	429	265	164
PCT1148	MV	804	370	0	0	32	338	190	148
PCT1148	ED	224	158	0	0	22	136	93	43
PCT1148	TO	1028	528	0	0	54	474	283	191
PCT1149	MV	710	320	0	0	37	283	144	139
PCT1149	ED	229	161	0	0	15	146	104	42
PCT1149	TO	939	481	0	0	52	429	248	181
PCT1151	MV	0	0	0	0	0	0	0	0
PCT1151	ED	0	0	0	0	0	0	0	0
PCT1151	TO	0	0	0	0	0	0	0	0
PCT1152	MV	710	315	0	0	32	283	172	111
PCT1152	ED	180	137	0	0	11	126	78	48
PCT1152	TO	890	452	0	0	43	409	250	159
PCT1153	MV	730	285	0	0	36	249	151	98
PCT1153	ED	210	181	0	0	17	164	93	71
PCT1153	TO	940	466	0	0	53	413	244	169
PCT1154	MV	0	0	0	0	0	0	0	0
PCT1154	ED	0	0	0	0	0	0	0	0
PCT1154	TO	0	0	0	0	0	0	0	0
PCT7001	MV	632	331	0	0	25	306	155	151
PCT7001	ED	141	149	0	0	14	135	84	51
PCT7001	TO	773	480	0	0	39	441	239	202
PCT7002	MV	598	271	0	0	33	238	131	107
PCT7002	ED	116	142	0	0	16	126	81	45
PCT7002	TO	714	413	0	0	49	364	212	152
PCT7003	MV	759	436	0	0	45	391	211	180
PCT7003	ED	147	193	0	0	24	169	99	70
PCT7003	TO	906	629	0	0	69	560	310	250
PCT7004	MV	764	419	0	1	35	383	189	194
PCT7004	ED	149	225	0	0	29	196	108	88
PCT7004	TO	913	644	0	1	64	579	297	282
PCT7005	MV	698	351	0	0	32	319	169	150
PCT7005	ED	161	230	0	0	37	193	119	74
PCT7005	TO	859	581	0	0	69	512	288	224
PCT7006	MV	729	361	0	0	41	320	197	123
PCT7006	ED	203	240	0	0	28	212	150	62
PCT7006	TO	932	601	0	0	69	532	347	185
PCT7007	MV	777	438	0	0	41	397	205	192
PCT7007	ED	180	242	0	0	28	214	126	88
PCT7007	TO	957	680	0	0	69	611	331	280
PCT7008	MV	732	369	0	0	42	327	170	157
PCT7008	ED	177	254	0	0	33	221	129	92
PCT7008	TO	909	623	0	0	75	548	299	249
PCT7009	MV	752	391	0	0	30	361	202	159
PCT7009	ED	119	160	0	0	19	141	82	59
PCT7009	TO	871	551	0	0	49	502	284	218
PCT7011	MV	704	231	0	0	21	210	103	107
PCT7011	ED	269	142	0	0	13	129	81	48
PCT7011	TO	973	373	0	0	34	339	184	155
PCT7012	MV	999	489	0	0	48	441	251	190
PCT7012	ED	227	308	0	0	43	265	154	111
PCT7012	TO	1226	797	0	0	91	706	405	301
PCT7013	MV	984	431	0	0	39	392	226	166
PCT7013	ED	155	259	0	0	40	219	127	92
PCT7013	TO	1139	690	0	0	79	611	353	258
PCT7014	MV	610	305	0	1	31	273	128	145
PCT7014	ED	109	182	0	0	33	149	87	62
PCT7014	TO	719	487	0	1	64	422	215	207
PCT7015	MV	110	41	0	0	7	34	23	11
PCT7015	ED	0	5	0	0	1	4	1	3
PCT7015	TO	110	46	0	0	8	38	24	14
PCT7016	MV	655	239	0	0	23	216	112	104
PCT7016	ED	277	124	0	0	9	115	77	38
PCT7016	TO	932	363	0	0	32	331	189	142
PCT7017	MV	543	182	0	0	27	155	93	62
PCT7017	ED	238	92	0	0	19	73	44	29
PCT7017	TO	781	274	0	0	46	228	137	91
PCT7018	MV	847	358	0	0	36	322	166	156
PCT7018	ED	200	103	0	0	10	93	59	34
PCT7018	TO	1047	461	0	0	46	415	225	190
PCT7019	MV	734	356	0	0	29	327	169	158
PCT7019	ED	166	112	0	0	12	100	63	37
PCT7019	TO	900	468	0	0	41	427	232	195
PCT7021	MV	679	271	0	0	32	239	150	89
PCT7021	ED	288	159	0	0	23	136	88	48
PCT7021	TO	967	430	0	0	55	375	238	137
PCT7022	MV	770	340	0	0	39	301	177	124
PCT7022	ED	193	93	0	0	8	85	62	23
PCT7022	TO	963	433	0	0	47	386	239	147
PCT7023	MV	687	331	0	0	30	301	172	129
PCT7023	ED	233	118	0	0	11	107	69	38
PCT7023	TO	920	449	0	0	41	408	241	167
PCT7024	MV	251	51	0	0	4	47	26	21
PCT7024	ED	190	35	0	0	5	30	25	5
PCT7024	TO	441	86	0	0	9	77	51	26
PCT7025	MV	316	97	0	0	7	90	49	41
PCT7025	ED	167	66	0	0	3	63	35	28
PCT7025	TO	483	163	0	0	10	153	84	69
PCT7026	MV	819	338	0	0	29	309	165	144
PCT7026	ED	191	125	0	0	21	104	64	40
PCT7026	TO	1010	463	0	0	50	413	229	184
PCT7027	MV	677	272	0	0	31	241	141	100
PCT7027	ED	219	143	0	0	16	127	76	51
PCT7027	TO	896	415	0	0	47	368	217	151
PCT7028	MV	586	221	0	0	19	202	125	77
PCT7028	ED	270	151	0	0	17	134	87	47
PCT7028	TO	856	372	0	0	36	336	212	124
PCT7029	MV	643	209	0	0	30	179	101	78
PCT7029	ED	266	82	0	0	4	78	38	40
PCT7029	TO	909	291	0	0	34	257	139	118
PCT7030	MV	654	274	0	0	19	255	127	128
PCT7030	ED	141	80	0	0	4	76	46	30
PCT7030	TO	795	354	0	0	23	331	173	158
PCT7031	MV	622	266	0	0	25	241	144	97
PCT7031	ED	72	78	0	0	11	67	38	29
PCT7031	TO	694	344	0	0	36	308	182	126
PCT7032	MV	643	266	0	0	26	240	130	110
PCT7032	ED	238	105	0	0	11	94	60	34
PCT7032	TO	881	371	0	0	37	334	190	144
PCT7033	MV	549	214	0	0	21	193	111	82
PCT7033	ED	229	136	0	0	14	122	78	44
PCT7033	TO	778	350	0	0	35	315	189	126
PCT7034	MV	620	142	0	0	22	120	74	46
PCT7034	ED	318	111	0	0	10	101	71	30
PCT7034	TO	938	253	0	0	32	221	145	76
PCT7035	MV	567	238	0	0	24	214	104	110
PCT7035	ED	152	101	0	0	12	89	61	28
PCT7035	TO	719	339	0	0	36	303	165	138
PCT7036	MV	781	267	0	0	31	236	126	110
PCT7036	ED	193	79	0	0	7	72	50	22
PCT7036	TO	974	346	0	0	38	308	176	132
PCT7037	MV	434	64	0	0	4	60	39	21
PCT7037	ED	312	65	0	0	15	50	36	14
PCT7037	TO	746	129	0	0	19	110	75	35
PCT7038	MV	758	308	0	0	29	279	143	136
PCT7038	ED	203	105	0	0	14	91	47	44
PCT7038	TO	961	413	0	0	43	370	190	180
PCT7039	MV	636	244	0	0	28	216	100	116
PCT7039	ED	201	146	0	0	5	141	86	55
PCT7039	TO	837	390	0	0	33	357	186	171
PCT7041	MV	66	29	0	0	7	22	13	9
PCT7041	ED	0	2	0	0	0	2	1	1
PCT7041	TO	66	31	0	0	7	24	14	10
PCT7042	MV	514	224	0	0	18	206	118	88
PCT7042	ED	146	96	0	0	3	93	62	31
PCT7042	TO	660	320	0	0	21	299	180	119
PCT7043	MV	754	295	0	0	27	268	172	96
PCT7043	ED	224	122	0	0	18	104	70	34
PCT7043	TO	978	417	0	0	45	372	242	130
PCT7044	MV	586	150	0	0	6	144	76	68
PCT7044	ED	266	95	0	0	13	82	58	24
PCT7044	TO	852	245	0	0	19	226	134	92
PCT7045	MV	632	268	0	0	28	240	140	100
PCT7045	ED	154	80	0	0	15	65	35	30
PCT7045	TO	786	348	0	0	43	305	175	130
PCT7046	MV	334	134	0	0	14	120	65	55
PCT7046	ED	96	76	0	0	6	70	44	26
PCT7046	TO	430	210	0	0	20	190	109	81
PCT7047	MV	733	315	0	0	27	288	152	136
PCT7047	ED	150	100	0	0	16	84	53	31
PCT7047	TO	883	415	0	0	43	372	205	167
PCT7048	MV	685	267	0	0	21	246	148	98
PCT7048	ED	196	80	0	0	8	72	45	27
PCT7048	TO	881	347	0	0	29	318	193	125
PCT7049	MV	616	248	0	0	24	224	121	103
PCT7049	ED	210	104	0	0	12	92	52	40
PCT7049	TO	826	352	0	0	36	316	173	143
PCT7051	MV	715	311	0	0	24	287	145	142
PCT7051	ED	165	105	0	0	11	94	61	33
PCT7051	TO	880	416	0	0	35	381	206	175
PCT7052	MV	722	298	0	0	14	284	143	141
PCT7052	ED	184	135	0	0	16	119	61	58
PCT7052	TO	906	433	0	0	30	403	204	199
PCT7053	MV	542	227	0	0	38	189	88	101
PCT7053	ED	43	70	0	0	7	63	35	28
PCT7053	TO	585	297	0	0	45	252	123	129
PCT7054	MV	863	310	0	1	31	278	158	120
PCT7054	ED	273	170	0	0	14	156	93	63
PCT7054	TO	1136	480	0	1	45	434	251	183
PCT7055	MV	732	292	0	0	23	269	151	118
PCT7055	ED	94	150	0	0	22	128	75	53
PCT7055	TO	826	442	0	0	45	397	226	171
PCT7056	MV	619	277	0	1	29	247	117	130
PCT7056	ED	86	179	0	0	26	153	94	59
PCT7056	TO	705	456	0	1	55	400	211	189
PCT7101	MV	147	99	0	0	8	91	49	42
PCT7101	ED	0	9	0	0	4	5	4	1
PCT7101	TO	147	108	0	0	12	96	53	43
PCT7201	MV	789	384	0	0	41	343	151	192
PCT7201	ED	146	195	0	0	32	163	85	78
PCT7201	TO	935	579	0	0	73	506	236	270
PCT7202	MV	708	309	0	0	30	279	122	157
PCT7202	ED	143	188	0	0	24	164	86	78
PCT7202	TO	851	497	0	0	54	443	208	235
PCT7203	MV	693	321	0	0	46	275	125	150
PCT7203	ED	186	217	0	0	37	180	93	87
PCT7203	TO	879	538	0	0	83	455	218	237
PCT7204	MV	773	425	0	0	55	370	155	215
PCT7204	ED	126	206	0	0	45	161	77	84
PCT7204	TO	899	631	0	0	100	531	232	299
PCT7205	MV	724	360	0	0	33	327	152	175
PCT7205	ED	147	203	0	0	27	176	83	93
PCT7205	TO	871	563	0	0	60	503	235	268
PCT7206	MV	299	129	0	0	12	117	56	61
PCT7206	ED	78	130	0	0	20	110	62	48
PCT7206	TO	377	259	0	0	32	227	118	109
PCT7207	MV	744	333	0	0	32	301	157	144
PCT7207	ED	123	177	0	0	25	152	98	54
PCT7207	TO	867	510	0	0	57	453	255	198
PCT7208	MV	492	254	0	0	35	219	102	117
PCT7208	ED	78	110	0	0	19	91	54	37
PCT7208	TO	570	364	0	0	54	310	156	154
PCT7209	MV	595	343	0	0	45	298	105	193
PCT7209	ED	52	82	0	0	11	71	33	38
PCT7209	TO	647	425	0	0	56	369	138	231
PCT7301	MV	813	319	0	0	31	288	169	119
PCT7301	ED	201	154	0	0	17	137	84	53
PCT7301	TO	1014	473	0	0	48	425	253	172
PCT7302	MV	713	352	0	0	37	315	158	157
PCT7302	ED	136	153	0	0	20	133	73	60
PCT7302	TO	849	505	0	0	57	448	231	217
PCT7303	MV	869	376	0	0	35	341	190	151
PCT7303	ED	199	255	0	1	53	201	113	88
PCT7303	TO	1068	631	0	1	88	542	303	239
PCT7304	MV	803	368	0	0	41	327	143	184
PCT7304	ED	198	239	0	0	21	218	127	91
PCT7304	TO	1001	607	0	0	62	545	270	275
PCT7305	MV	714	390	0	0	38	352	150	202
PCT7305	ED	153	206	0	0	27	179	96	83
PCT7305	TO	867	596	0	0	65	531	246	285
PCT7306	MV	801	375	0	0	54	321	146	175
PCT7306	ED	243	222	0	1	45	176	104	72
PCT7306	TO	1044	597	0	1	99	497	250	247
PCT7307	MV	605	276	0	0	20	256	132	124
PCT7307	ED	169	155	0	0	26	129	74	55
PCT7307	TO	774	431	0	0	46	385	206	179
PCT7308	MV	520	257	0	0	17	240	113	127
PCT7308	ED	105	175	0	0	28	147	72	75
PCT7308	TO	625	432	0	0	45	387	185	202
PCT7309	MV	691	324	0	0	40	284	133	151
PCT7309	ED	167	214	0	0	38	176	105	71
PCT7309	TO	858	538	0	0	78	460	238	222
PCT7311	MV	698	336	0	0	25	311	136	175
PCT7311	ED	208	250	0	0	38	212	119	93
PCT7311	TO	906	586	0	0	63	523	255	268
PCT7312	MV	700	397	0	0	45	352	149	203
PCT7312	ED	110	176	0	0	23	153	69	84
PCT7312	TO	810	573	0	0	68	505	218	287
PCT7313	MV	819	375	0	0	33	342	188	154
PCT7313	ED	184	181	0	0	33	148	93	55
PCT7313	TO	1003	556	0	0	66	490	281	209
PCT7314	MV	612	226	0	0	28	198	131	67
PCT7314	ED	147	89	0	0	13	76	50	26
PCT7314	TO	759	315	0	0	41	274	181	93
PCT7315	MV	570	207	0	0	20	187	98	89
PCT7315	ED	195	181	0	0	27	154	96	58
PCT7315	TO	765	388	0	0	47	341	194	147
PCT7316	MV	654	261	0	0	31	230	134	96
PCT7316	ED	178	161	0	0	24	137	90	47
PCT7316	TO	832	422	0	0	55	367	224	143
PCT7317	MV	744	350	0	0	31	319	153	166
PCT7317	ED	146	162	0	0	30	132	82	50
PCT7317	TO	890	512	0	0	61	451	235	216
PCT7318	MV	605	294	0	0	36	258	135	123
PCT7318	ED	118	150	0	0	30	120	62	58
PCT7318	TO	723	444	0	0	66	378	197	181
PCT7319	MV	861	346	0	0	38	308	153	155
PCT7319	ED	188	208	0	0	39	169	88	81
PCT7319	TO	1049	554	0	0	77	477	241	236
PCT7321	MV	557	202	0	0	25	177	87	90
PCT7321	ED	102	106	0	0	17	89	48	41
PCT7321	TO	659	308	0	0	42	266	135	131
PCT7322	MV	742	296	0	1	45	250	161	89
PCT7322	ED	146	56	0	0	7	49	39	10
PCT7322	TO	888	352	0	1	52	299	200	99
PCT7323	MV	790	369	0	0	51	318	144	174
PCT7323	ED	166	180	0	0	27	153	84	69
PCT7323	TO	956	549	0	0	78	471	228	243
PCT7324	MV	587	260	0	0	35	225	124	101
PCT7324	ED	150	136	0	0	25	111	57	54
PCT7324	TO	737	396	0	0	60	336	181	155
PCT7325	MV	714	328	0	0	39	289	156	133
PCT7325	ED	172	183	0	0	31	152	91	61
PCT7325	TO	886	511	0	0	70	441	247	194
PCT7326	MV	685	304	0	0	35	269	152	117
PCT7326	ED	174	187	0	0	34	153	83	70
PCT7326	TO	859	491	0	0	69	422	235	187
PCT7327	MV	561	230	0	0	33	197	119	78
PCT7327	ED	126	59	0	0	8	51	27	24
PCT7327	TO	687	289	0	0	41	248	146	102
PCT7328	MV	829	334	0	0	64	270	171	99
PCT7328	ED	173	85	0	0	22	63	45	18
PCT7328	TO	1002	419	0	0	86	333	216	117
PCT7329	MV	556	228	0	0	25	203	80	123
PCT7329	ED	95	105	0	0	19	86	41	45
PCT7329	TO	651	333	0	0	44	289	121	168
PCT7331	MV	710	363	0	0	41	322	132	190
PCT7331	ED	160	170	0	0	29	141	66	75
PCT7331	TO	870	533	0	0	70	463	198	265
PCT7332	MV	654	265	0	0	31	234	141	93
PCT7332	ED	136	173	0	0	20	153	108	45
PCT7332	TO	790	438	0	0	51	387	249	138
PCT7333	MV	822	392	0	0	35	357	203	154
PCT7333	ED	193	241	0	0	34	207	129	78
PCT7333	TO	1015	633	0	0	69	564	332	232
PCT7334	MV	688	308	0	0	23	285	171	114
PCT7334	ED	131	170	0	0	17	153	106	47
PCT7334	TO	819	478	0	0	40	438	277	161
PCT7335	MV	788	390	0	0	43	347	170	177
PCT7335	ED	146	217	0	0	32	185	110	75
PCT7335	TO	934	607	0	0	75	532	280	252
PCT7336	MV	779	405	0	0	39	366	177	189
PCT7336	ED	175	189	0	0	33	156	91	65
PCT7336	TO	954	594	0	0	72	522	268	254
PCT7337	MV	772	387	0	0	47	340	147	193
PCT7337	ED	125	143	0	0	16	127	71	56
PCT7337	TO	897	530	0	0	63	467	218	249
PCT7338	MV	770	360	0	0	38	322	184	138
PCT7338	ED	125	104	0	0	15	89	62	27
PCT7338	TO	895	464	0	0	53	411	246	165
PCT7339	MV	605	270	0	0	24	246	141	105
PCT7339	ED	150	149	0	0	14	135	83	52
PCT7339	TO	755	419	0	0	38	381	224	157
PCT7341	MV	675	292	0	1	33	258	164	94
PCT7341	ED	178	183	0	1	20	162	114	48
PCT7341	TO	853	475	0	2	53	420	278	142
PCT7342	MV	674	326	0	0	26	300	177	123
PCT7342	ED	230	269	0	0	29	240	153	87
PCT7342	TO	904	595	0	0	55	540	330	210
PCT7343	MV	554	253	0	0	22	231	142	89
PCT7343	ED	150	176	0	0	24	152	105	47
PCT7343	TO	704	429	0	0	46	383	247	136
PCT7344	MV	863	393	0	0	29	364	184	180
PCT7344	ED	201	238	0	0	36	202	127	75
PCT7344	TO	1064	631	0	0	65	566	311	255
PCT7345	MV	904	434	0	0	36	398	235	163
PCT7345	ED	210	253	0	0	36	217	137	80
PCT7345	TO	1114	687	0	0	72	615	372	243
PCT7346	MV	681	288	0	0	29	259	182	77
PCT7346	ED	208	209	0	0	31	178	128	50
PCT7346	TO	889	497	0	0	60	437	310	127
PCT7347	MV	833	371	0	0	37	334	235	99
PCT7347	ED	170	192	0	0	25	167	112	55
PCT7347	TO	1003	563	0	0	62	501	347	154
PCT7348	MV	650	279	0	0	26	253	162	91
PCT7348	ED	193	159	0	0	22	137	89	48
PCT7348	TO	843	438	0	0	48	390	251	139
PCT7349	MV	710	319	0	1	27	291	160	131
PCT7349	ED	202	178	0	0	27	151	98	53
PCT7349	TO	912	497	0	1	54	442	258	184
PCT7501	MV	456	248	0	0	36	212	83	129
PCT7501	ED	95	127	0	0	17	110	55	55
PCT7501	TO	551	375	0	0	53	322	138	184
PCT7502	MV	669	318	0	0	35	283	145	138
PCT7502	ED	120	167	0	0	29	138	84	54
PCT7502	TO	789	485	0	0	64	421	229	192
PCT7503	MV	614	286	0	0	32	254	155	99
PCT7503	ED	148	163	0	0	28	135	78	57
PCT7503	TO	762	449	0	0	60	389	233	156
PCT7504	MV	404	175	0	0	17	158	90	68
PCT7504	ED	84	92	0	0	16	76	49	27
PCT7504	TO	488	267	0	0	33	234	139	95
PCT7505	MV	729	406	0	0	46	360	158	202
PCT7505	ED	133	143	0	0	17	126	57	69
PCT7505	TO	862	549	0	0	63	486	215	271
PCT7506	MV	842	365	0	0	40	325	197	128
PCT7506	ED	158	206	0	0	33	173	129	44
PCT7506	TO	1000	571	0	0	73	498	326	172
PCT7507	MV	694	291	0	0	23	268	178	90
PCT7507	ED	262	156	0	0	15	141	95	46
PCT7507	TO	956	447	0	0	38	409	273	136
PCT7508	MV	618	375	0	0	39	336	195	141
PCT7508	ED	126	131	0	0	16	115	72	43
PCT7508	TO	744	506	0	0	55	451	267	184
PCT7509	MV	756	399	0	0	33	366	216	150
PCT7509	ED	173	184	0	0	23	161	101	60
PCT7509	TO	929	583	0	0	56	527	317	210
PCT7512	MV	476	248	0	0	28	220	111	109
PCT7512	ED	124	120	0	0	17	103	61	42
PCT7512	TO	600	368	0	0	45	323	172	151
PCT7513	MV	575	248	0	0	34	214	143	71
PCT7513	ED	231	159	0	0	27	132	99	33
PCT7513	TO	806	407	0	0	61	346	242	104
PCT7514	MV	709	242	0	0	40	202	138	64
PCT7514	ED	207	100	0	0	22	78	48	30
PCT7514	TO	916	342	0	0	62	280	186	94
PCT7515	MV	664	323	0	1	25	297	184	113
PCT7515	ED	200	131	0	0	24	107	71	36
PCT7515	TO	864	454	0	1	49	404	255	149
PCT7516	MV	773	424	0	0	35	389	214	175
PCT7516	ED	147	152	0	0	13	139	68	71
PCT7516	TO	920	576	0	0	48	528	282	246
PCT7517	MV	645	362	0	0	45	317	203	114
PCT7517	ED	223	266	0	0	36	230	149	81
PCT7517	TO	868	628	0	0	81	547	352	195
PCT7518	MV	708	396	0	0	41	355	202	153
PCT7518	ED	218	273	0	0	33	240	163	77
PCT7518	TO	926	669	0	0	74	595	365	230
PCT7519	MV	543	261	0	0	27	234	143	91
PCT7519	ED	172	194	0	0	23	171	120	51
PCT7519	TO	715	455	0	0	50	405	263	142
PCT7521	MV	597	323	0	0	26	297	185	112
PCT7521	ED	182	222	0	0	21	201	126	75
PCT7521	TO	779	545	0	0	47	498	311	187
PCT7522	MV	588	302	0	1	28	273	155	118
PCT7522	ED	171	221	0	0	38	183	117	66
PCT7522	TO	759	523	0	1	66	456	272	184
PCT7523	MV	564	285	0	0	34	251	152	99
PCT7523	ED	180	247	0	0	24	223	148	75
PCT7523	TO	744	532	0	0	58	474	300	174
PCT7524	MV	481	228	0	0	23	205	144	61
PCT7524	ED	143	154	0	0	20	134	84	50
PCT7524	TO	624	382	0	0	43	339	228	111
PCT7525	MV	594	247	0	0	35	212	134	78
PCT7525	ED	170	159	0	0	26	133	84	49
PCT7525	TO	764	406	0	0	61	345	218	127
PCT7526	MV	825	397	0	0	45	352	191	161
PCT7526	ED	163	258	0	0	35	223	141	82
PCT7526	TO	988	655	0	0	80	575	332	243
PCT7527	MV	538	296	0	0	26	270	172	98
PCT7527	ED	172	157	0	0	16	141	89	52
PCT7527	TO	710	453	0	0	42	411	261	150
PCT7529	MV	749	367	0	0	33	334	201	133
PCT7529	ED	154	261	0	0	29	232	157	75
PCT7529	TO	903	628	0	0	62	566	358	208
PCT7531	MV	714	336	0	0	24	312	205	107
PCT7531	ED	159	211	0	0	19	192	126	66
PCT7531	TO	873	547	0	0	43	504	331	173
PCT7532	MV	668	330	0	0	29	301	167	134
PCT7532	ED	167	225	0	0	27	198	139	59
PCT7532	TO	835	555	0	0	56	499	306	193
PCT7533	MV	777	405	0	0	42	363	240	123
PCT7533	ED	193	286	0	0	32	254	181	73
PCT7533	TO	970	691	0	0	74	617	421	196
PCT7534	MV	670	377	0	1	36	340	204	136
PCT7534	ED	233	259	0	0	34	225	165	60
PCT7534	TO	903	636	0	1	70	565	369	196
PCT7535	MV	606	303	0	0	35	268	177	91
PCT7535	ED	139	218	0	0	35	183	128	55
PCT7535	TO	745	521	0	0	70	451	305	146
PCT7536	MV	670	347	0	0	25	322	207	115
PCT7536	ED	163	231	0	0	26	205	115	90
PCT7536	TO	833	578	0	0	51	527	322	205
PCT7537	MV	619	302	0	0	28	274	149	125
PCT7537	ED	126	221	0	0	21	200	130	70
PCT7537	TO	745	523	0	0	49	474	279	195
PCT7538	MV	562	324	0	0	35	289	162	127
PCT7538	ED	189	233	0	0	35	198	136	62
PCT7538	TO	751	557	0	0	70	487	298	189
PCT7539	MV	696	376	0	0	33	343	179	164
PCT7539	ED	225	277	0	0	34	243	180	63
PCT7539	TO	921	653	0	0	67	586	359	227
PCT7541	MV	601	296	0	0	36	260	148	112
PCT7541	ED	169	236	0	0	34	202	138	64
PCT7541	TO	770	532	0	0	70	462	286	176
PCT7542	MV	632	325	0	0	26	299	197	102
PCT7542	ED	192	222	0	0	18	204	146	58
PCT7542	TO	824	547	0	0	44	503	343	160
PCT7543	MV	694	373	0	0	31	342	211	131
PCT7543	ED	230	191	0	0	32	159	115	44
PCT7543	TO	924	564	0	0	63	501	326	175
PCT7544	MV	731	389	0	0	46	343	202	141
PCT7544	ED	168	232	0	0	26	206	134	72
PCT7544	TO	899	621	0	0	72	549	336	213
PCT7545	MV	723	386	0	0	38	348	190	158
PCT7545	ED	172	211	0	0	31	180	119	61
PCT7545	TO	895	597	0	0	69	528	309	219
PCT7546	MV	770	419	0	0	41	378	233	145
PCT7546	ED	183	277	0	0	33	244	148	96
PCT7546	TO	953	696	0	0	74	622	381	241
PCT7547	MV	799	428	0	0	38	390	269	121
PCT7547	ED	182	270	0	0	33	237	169	68
PCT7547	TO	981	698	0	0	71	627	438	189
PCT7548	MV	803	450	0	0	33	417	239	178
PCT7548	ED	248	281	0	1	32	248	166	82
PCT7548	TO	1051	731	0	1	65	665	405	260
PCT7549	MV	660	359	0	0	40	319	194	125
PCT7549	ED	146	200	0	0	29	171	110	61
PCT7549	TO	806	559	0	0	69	490	304	186
PCT7551	MV	587	304	0	0	22	282	158	124
PCT7551	ED	136	233	0	0	31	202	117	85
PCT7551	TO	723	537	0	0	53	484	275	209
PCT7552	MV	561	289	0	0	38	251	133	118
PCT7552	ED	124	185	0	0	33	152	85	67
PCT7552	TO	685	474	0	0	71	403	218	185
PCT7553	MV	191	96	0	0	10	86	48	38
PCT7553	ED	0	19	0	0	3	16	10	6
PCT7553	TO	191	115	0	0	13	102	58	44
PCT7554	MV	653	382	0	0	38	344	162	182
PCT7554	ED	168	226	0	0	23	203	95	108
PCT7554	TO	821	608	0	0	61	547	257	290
PCT7555	MV	662	418	0	0	52	366	198	168
PCT7555	ED	210	258	0	0	29	229	126	103
PCT7555	TO	872	676	0	0	81	595	324	271
PCT7556	MV	812	514	0	0	42	472	225	247
PCT7556	ED	154	236	0	0	35	201	104	97
PCT7556	TO	966	750	0	0	77	673	329	344
PCT7601	MV	485	207	0	0	21	186	124	62
PCT7601	ED	192	125	0	0	20	105	78	27
PCT7601	TO	677	332	0	0	41	291	202	89
PCT7602	MV	654	277	0	0	25	252	169	83
PCT7602	ED	232	150	0	0	16	134	98	36
PCT7602	TO	886	427	0	0	41	386	267	119
PCT7603	MV	615	296	0	0	31	265	187	78
PCT7603	ED	200	208	0	0	20	188	144	44
PCT7603	TO	815	504	0	0	51	453	331	122
PCT7604	MV	685	270	0	0	20	250	192	58
PCT7604	ED	259	187	0	0	33	154	116	38
PCT7604	TO	944	457	0	0	53	404	308	96
PCT7605	MV	469	192	0	0	24	168	111	57
PCT7605	ED	192	98	0	0	12	86	66	20
PCT7605	TO	661	290	0	0	36	254	177	77
PCT7606	MV	673	267	0	0	34	233	157	76
PCT7606	ED	210	123	0	0	16	107	82	25
PCT7606	TO	883	390	0	0	50	340	239	101
PCT7607	MV	712	288	0	0	21	267	178	89
PCT7607	ED	207	143	0	0	16	127	88	39
PCT7607	TO	919	431	0	0	37	394	266	128
PCT7608	MV	279	96	0	0	11	85	57	28
PCT7608	ED	101	28	0	0	1	27	21	6
PCT7608	TO	380	124	0	0	12	112	78	34
PCT7609	MV	699	287	0	0	38	249	177	72
PCT7609	ED	185	76	0	0	11	65	53	12
PCT7609	TO	884	363	0	0	49	314	230	84
PCT7611	MV	586	236	0	0	21	215	165	50
PCT7611	ED	202	70	0	0	7	63	51	12
PCT7611	TO	788	306	0	0	28	278	216	62
PCT7612	MV	452	216	0	1	16	199	120	79
PCT7612	ED	105	61	0	0	9	52	31	21
PCT7612	TO	557	277	0	1	25	251	151	100
PCT7613	MV	634	244	0	0	23	221	154	67
PCT7613	ED	249	123	0	0	15	108	87	21
PCT7613	TO	883	367	0	0	38	329	241	88
PCT7614	MV	713	255	0	0	30	225	150	75
PCT7614	ED	203	133	0	0	12	121	86	35
PCT7614	TO	916	388	0	0	42	346	236	110
PCT7615	MV	510	165	0	0	17	148	103	45
PCT7615	ED	240	91	0	0	11	80	67	13
PCT7615	TO	750	256	0	0	28	228	170	58
PCT7616	MV	754	332	0	1	42	289	114	175
PCT7616	ED	82	191	0	0	34	157	86	71
PCT7616	TO	836	523	0	1	76	446	200	246
PCT7617	MV	583	222	0	0	32	190	137	53
PCT7617	ED	169	78	0	0	14	64	46	18
PCT7617	TO	752	300	0	0	46	254	183	71
PCT7618	MV	763	365	0	0	22	343	196	147
PCT7618	ED	151	141	0	0	20	121	72	49
PCT7618	TO	914	506	0	0	42	464	268	196
PCT7619	MV	938	439	0	0	38	401	217	184
PCT7619	ED	169	207	0	0	32	175	105	70
PCT7619	TO	1107	646	0	0	70	576	322	254
PCT7621	MV	1006	443	0	0	36	407	222	185
PCT7621	ED	149	185	0	0	32	153	97	56
PCT7621	TO	1155	628	0	0	68	560	319	241
PCT7622	MV	697	216	0	0	16	200	128	72
PCT7622	ED	263	127	0	0	20	107	78	29
PCT7622	TO	960	343	0	0	36	307	206	101
PCT7623	MV	767	256	0	1	25	230	156	74
PCT7623	ED	237	167	0	0	25	142	106	36
PCT7623	TO	1004	423	0	1	50	372	262	110
PCT7624	MV	652	210	0	0	21	189	117	72
PCT7624	ED	223	114	0	0	18	96	71	25
PCT7624	TO	875	324	0	0	39	285	188	97
PCT7625	MV	749	396	0	0	64	332	214	118
PCT7625	ED	73	51	0	0	4	47	33	14
PCT7625	TO	822	447	0	0	68	379	247	132
PCT7626	MV	945	404	0	0	49	355	129	226
PCT7626	ED	128	164	0	0	23	141	70	71
PCT7626	TO	1073	568	0	0	72	496	199	297
PCT7627	MV	457	196	0	0	20	176	59	117
PCT7627	ED	67	80	0	0	15	65	29	36
PCT7627	TO	524	276	0	0	35	241	88	153
PCT7628	MV	718	333	0	0	24	309	195	114
PCT7628	ED	220	185	0	0	21	164	105	59
PCT7628	TO	938	518	0	0	45	473	300	173
PCT7629	MV	691	277	0	0	26	251	155	96
PCT7629	ED	162	159	0	0	22	137	89	48
PCT7629	TO	853	436	0	0	48	388	244	144
PCT7631	MV	1009	442	0	1	40	401	212	189
PCT7631	ED	210	213	0	0	29	184	113	71
PCT7631	TO	1219	655	0	1	69	585	325	260
PCT7632	MV	1002	414	0	1	29	384	223	161
PCT7632	ED	169	237	0	0	25	212	137	75
PCT7632	TO	1171	651	0	1	54	596	360	236
PCT7633	MV	609	278	0	0	26	252	145	107
PCT7633	ED	126	124	0	0	19	105	60	45
PCT7633	TO	735	402	0	0	45	357	205	152
PCT7634	MV	704	344	0	0	48	296	179	117
PCT7634	ED	186	155	0	0	31	124	79	45
PCT7634	TO	890	499	0	0	79	420	258	162
PCT7635	MV	665	274	0	0	19	255	116	139
PCT7635	ED	188	145	0	0	15	130	71	59
PCT7635	TO	853	419	0	0	34	385	187	198
PCT7636	MV	798	331	0	0	31	300	142	158
PCT7636	ED	161	188	0	0	32	156	84	72
PCT7636	TO	959	519	0	0	63	456	226	230
PCT7637	MV	747	344	0	0	40	304	111	193
PCT7637	ED	121	169	0	0	30	139	65	74
PCT7637	TO	868	513	0	0	70	443	176	267
PCT7638	MV	806	374	0	0	49	325	121	204
PCT7638	ED	83	148	0	0	19	129	42	87
PCT7638	TO	889	522	0	0	68	454	163	291
PCT7639	MV	889	397	0	0	40	357	145	212
PCT7639	ED	133	175	0	0	46	129	59	70
PCT7639	TO	1022	572	0	0	86	486	204	282
PCT7641	MV	817	401	0	0	29	372	160	212
PCT7641	ED	134	158	0	0	17	141	69	72
PCT7641	TO	951	559	0	0	46	513	229	284
PCT7642	MV	647	314	0	0	44	270	147	123
PCT7642	ED	118	157	0	1	34	122	80	42
PCT7642	TO	765	471	0	1	78	392	227	165
PCT7643	MV	810	434	0	0	34	400	225	175
PCT7643	ED	131	135	0	0	26	109	58	51
PCT7643	TO	941	569	0	0	60	509	283	226
PCT7644	MV	1014	404	0	0	48	356	160	196
PCT7644	ED	162	234	0	0	31	203	141	62
PCT7644	TO	1176	638	0	0	79	559	301	258
PCT7645	MV	595	286	0	0	26	260	97	163
PCT7645	ED	61	112	0	0	18	94	50	44
PCT7645	TO	656	398	0	0	44	354	147	207
PCT7646	MV	1032	485	0	0	54	431	193	238
PCT7646	ED	121	251	0	0	64	187	126	61
PCT7646	TO	1153	736	0	0	118	618	319	299
PCT7647	MV	724	212	0	0	9	203	153	50
PCT7647	ED	263	148	0	0	15	133	102	31
PCT7647	TO	987	360	0	0	24	336	255	81
PCT7648	MV	2	1	0	0	1	0	0	0
PCT7648	ED	0	0	0	0	0	0	0	0
PCT7648	TO	2	1	0	0	1	0	0	0
PCT7649	MV	724	286	0	0	18	268	142	126
PCT7649	ED	176	152	0	0	20	132	93	39
PCT7649	TO	900	438	0	0	38	400	235	165
PCT7651	MV	834	334	0	0	37	297	128	169
PCT7651	ED	113	169	0	0	29	140	61	79
PCT7651	TO	947	503	0	0	66	437	189	248
PCT7652	MV	535	209	0	0	23	186	89	97
PCT7652	ED	100	122	0	0	13	109	64	45
PCT7652	TO	635	331	0	0	36	295	153	142
PCT7653	MV	750	337	0	0	48	289	134	155
PCT7653	ED	89	146	0	1	22	123	57	66
PCT7653	TO	839	483	0	1	70	412	191	221
PCT7654	MV	413	191	0	0	13	178	92	86
PCT7654	ED	53	106	0	0	19	87	54	33
PCT7654	TO	466	297	0	0	32	265	146	119
PCT7655	MV	583	216	0	0	19	197	89	108
PCT7655	ED	96	127	0	0	23	104	51	53
PCT7655	TO	679	343	0	0	42	301	140	161
PCT7656	MV	603	309	0	0	37	272	65	207
PCT7656	ED	35	81	0	0	19	62	15	47
PCT7656	TO	638	390	0	0	56	334	80	254
PCT7657	MV	561	270	0	1	31	238	77	161
PCT7657	ED	37	109	0	0	18	91	46	45
PCT7657	TO	598	379	0	1	49	329	123	206
PCT7701	MV	869	482	0	0	55	427	247	180
PCT7701	ED	195	251	0	0	37	214	131	83
PCT7701	TO	1064	733	0	0	92	641	378	263
PCT7702	MV	623	378	0	0	29	349	149	200
PCT7702	ED	133	146	0	0	19	127	69	58
PCT7702	TO	756	524	0	0	48	476	218	258
PCT7703	MV	174	71	0	0	7	64	51	13
PCT7703	ED	0	1	0	0	1	0	0	0
PCT7703	TO	174	72	0	0	8	64	51	13
PCT7704	MV	798	491	0	0	48	443	186	257
PCT7704	ED	204	221	0	0	19	202	81	121
PCT7704	TO	1002	712	0	0	67	645	267	378
PCT7705	MV	470	286	0	0	20	266	108	158
PCT7705	ED	125	148	0	0	19	129	54	75
PCT7705	TO	595	434	0	0	39	395	162	233
PCT7706	MV	687	451	0	0	41	410	198	212
PCT7706	ED	179	198	0	0	19	179	73	106
PCT7706	TO	866	649	0	0	60	589	271	318
PCT7707	MV	683	432	0	0	40	392	185	207
PCT7707	ED	189	226	0	0	20	206	97	109
PCT7707	TO	872	658	0	0	60	598	282	316
PCT7708	MV	710	462	0	0	52	410	187	223
PCT7708	ED	165	192	0	0	26	166	86	80
PCT7708	TO	875	654	0	0	78	576	273	303
PCT7709	MV	324	194	0	0	13	181	99	82
PCT7709	ED	82	107	0	0	12	95	59	36
PCT7709	TO	406	301	0	0	25	276	158	118
PCT7711	MV	658	382	0	0	40	342	169	173
PCT7711	ED	153	163	0	0	15	148	90	58
PCT7711	TO	811	545	0	0	55	490	259	231
PCT7712	MV	425	259	0	0	17	242	138	104
PCT7712	ED	107	135	0	0	14	121	72	49
PCT7712	TO	532	394	0	0	31	363	210	153
PCT7801	MV	824	487	0	0	43	444	220	224
PCT7801	ED	150	249	0	0	27	222	113	109
PCT7801	TO	974	736	0	0	70	666	333	333
PCT7802	MV	647	402	0	0	37	365	191	174
PCT7802	ED	151	212	0	0	29	183	111	72
PCT7802	TO	798	614	0	0	66	548	302	246
PCT7803	MV	718	477	0	0	41	436	207	229
PCT7803	ED	113	160	0	0	24	136	78	58
PCT7803	TO	831	637	0	0	65	572	285	287
PCT7804	MV	734	463	0	0	60	403	208	195
PCT7804	ED	151	246	0	0	37	209	100	109
PCT7804	TO	885	709	0	0	97	612	308	304
PCT7805	MV	644	402	0	0	43	359	191	168
PCT7805	ED	156	216	0	0	25	191	131	60
PCT7805	TO	800	618	0	0	68	550	322	228
PCT7806	MV	602	362	0	1	37	324	169	155
PCT7806	ED	153	208	0	0	29	179	111	68
PCT7806	TO	755	570	0	1	66	503	280	223
PCT7807	MV	642	363	0	0	29	334	194	140
PCT7807	ED	185	247	0	0	32	215	148	67
PCT7807	TO	827	610	0	0	61	549	342	207
PCT7808	MV	525	297	0	0	31	266	157	109
PCT7808	ED	129	170	0	0	26	144	86	58
PCT7808	TO	654	467	0	0	57	410	243	167
PCT7809	MV	624	352	0	0	26	326	209	117
PCT7809	ED	140	184	0	0	20	164	110	54
PCT7809	TO	764	536	0	0	46	490	319	171
PCT7811	MV	582	311	0	0	30	281	173	108
PCT7811	ED	176	218	0	0	20	198	130	68
PCT7811	TO	758	529	0	0	50	479	303	176
PCT7812	MV	680	371	0	0	38	333	184	149
PCT7812	ED	217	232	0	0	37	195	125	70
PCT7812	TO	897	603	0	0	75	528	309	219
PCT7813	MV	843	486	0	0	30	456	294	162
PCT7813	ED	225	300	0	0	36	264	184	80
PCT7813	TO	1068	786	0	0	66	720	478	242
PCT7814	MV	660	281	0	0	24	257	177	80
PCT7814	ED	241	191	0	0	28	163	122	41
PCT7814	TO	901	472	0	0	52	420	299	121
PCT7815	MV	749	465	0	0	54	411	223	188
PCT7815	ED	168	231	0	0	31	200	127	73
PCT7815	TO	917	696	0	0	85	611	350	261
PCT7816	MV	724	475	0	0	43	432	224	208
PCT7816	ED	148	213	0	0	22	191	99	92
PCT7816	TO	872	688	0	0	65	623	323	300
PCT7817	MV	652	396	0	0	26	370	211	159
PCT7817	ED	186	237	0	0	22	215	134	81
PCT7817	TO	838	633	0	0	48	585	345	240
PCT7818	MV	668	393	0	0	26	367	206	161
PCT7818	ED	171	205	0	0	23	182	116	66
PCT7818	TO	839	598	0	0	49	549	322	227
PCT7819	MV	635	353	0	0	31	322	192	130
PCT7819	ED	139	183	0	0	22	161	108	53
PCT7819	TO	774	536	0	0	53	483	300	183
PCT7821	MV	806	520	0	0	37	483	259	224
PCT7821	ED	170	249	0	0	21	228	118	110
PCT7821	TO	976	769	0	0	58	711	377	334
PCT7822	MV	673	396	0	0	34	362	205	157
PCT7822	ED	219	258	0	0	34	224	135	89
PCT7822	TO	892	654	0	0	68	586	340	246
PCT7823	MV	706	411	0	0	35	376	210	166
PCT7823	ED	177	275	0	0	25	250	177	73
PCT7823	TO	883	686	0	0	60	626	387	239
PCT7824	MV	615	338	0	0	37	301	157	144
PCT7824	ED	153	219	0	0	32	187	118	69
PCT7824	TO	768	557	0	0	69	488	275	213
PCT7825	MV	457	252	0	0	22	230	138	92
PCT7825	ED	151	186	0	0	12	174	117	57
PCT7825	TO	608	438	0	0	34	404	255	149
PCT7826	MV	486	263	0	0	17	246	142	104
PCT7826	ED	204	227	0	0	29	198	130	68
PCT7826	TO	690	490	0	0	46	444	272	172
PCT7827	MV	609	320	0	0	28	292	178	114
PCT7827	ED	217	222	0	0	31	191	143	48
PCT7827	TO	826	542	0	0	59	483	321	162
PCT7828	MV	857	479	0	1	46	432	246	186
PCT7828	ED	171	251	0	0	36	215	130	85
PCT7828	TO	1028	730	0	1	82	647	376	271
PCT7829	MV	742	468	0	0	44	424	227	197
PCT7829	ED	149	204	0	0	19	185	113	72
PCT7829	TO	891	672	0	0	63	609	340	269
PCT7831	MV	763	486	0	0	52	434	210	224
PCT7831	ED	139	205	0	0	21	184	109	75
PCT7831	TO	902	691	0	0	73	618	319	299
PCT7832	MV	663	415	0	0	41	374	207	167
PCT7832	ED	118	170	0	0	19	151	89	62
PCT7832	TO	781	585	0	0	60	525	296	229
PCT7833	MV	587	345	0	0	28	317	177	140
PCT7833	ED	146	191	0	0	26	165	96	69
PCT7833	TO	733	536	0	0	54	482	273	209
PCT7834	MV	700	377	0	0	40	337	186	151
PCT7834	ED	194	258	0	0	42	216	145	71
PCT7834	TO	894	635	0	0	82	553	331	222
PCT7835	MV	721	430	0	0	31	399	222	177
PCT7835	ED	142	202	0	0	23	179	114	65
PCT7835	TO	863	632	0	0	54	578	336	242
PCT7836	MV	850	507	0	0	41	466	281	185
PCT7836	ED	193	232	0	0	16	216	128	88
PCT7836	TO	1043	739	0	0	57	682	409	273
PCT7837	MV	718	425	0	0	57	368	161	207
PCT7837	ED	205	264	0	0	36	228	124	104
PCT7837	TO	923	689	0	0	93	596	285	311
PCT7838	MV	752	494	0	0	48	446	220	226
PCT7838	ED	143	210	0	0	31	179	107	72
PCT7838	TO	895	704	0	0	79	625	327	298
PCT7839	MV	731	459	0	0	45	414	199	215
PCT7839	ED	130	201	0	0	28	173	92	81
PCT7839	TO	861	660	0	0	73	587	291	296
PCT7841	MV	752	459	0	0	42	417	226	191
PCT7841	ED	198	264	0	0	23	241	132	109
PCT7841	TO	950	723	0	0	65	658	358	300
PCT7842	MV	702	396	0	0	36	360	226	134
PCT7842	ED	177	243	0	0	23	220	138	82
PCT7842	TO	879	639	0	0	59	580	364	216
PCT7843	MV	546	296	0	0	22	274	163	111
PCT7843	ED	183	220	0	0	24	196	127	69
PCT7843	TO	729	516	0	0	46	470	290	180
PCT7844	MV	499	282	0	0	22	260	159	101
PCT7844	ED	152	187	0	0	18	169	120	49
PCT7844	TO	651	469	0	0	40	429	279	150
PCT7845	MV	676	405	0	0	38	367	191	176
PCT7845	ED	204	225	0	0	25	200	103	97
PCT7845	TO	880	630	0	0	63	567	294	273
PCT7846	MV	736	467	0	0	51	416	191	225
PCT7846	ED	172	234	0	0	37	197	104	93
PCT7846	TO	908	701	0	0	88	613	295	318
PCT7847	MV	698	432	0	0	60	372	216	156
PCT7847	ED	193	231	0	0	20	211	119	92
PCT7847	TO	891	663	0	0	80	583	335	248
PCT7848	MV	665	438	0	0	32	406	199	207
PCT7848	ED	182	226	0	0	36	190	98	92
PCT7848	TO	847	664	0	0	68	596	297	299
PCT7849	MV	729	443	0	1	39	403	200	203
PCT7849	ED	172	260	0	0	38	222	133	89
PCT7849	TO	901	703	0	1	77	625	333	292
PCT7851	MV	414	272	0	0	28	244	84	160
PCT7851	ED	112	118	0	0	20	98	24	74
PCT7851	TO	526	390	0	0	48	342	108	234
PCT7852	MV	533	351	0	0	42	309	156	153
PCT7852	ED	111	133	0	0	16	117	60	57
PCT7852	TO	644	484	0	0	58	426	216	210
PCT7853	MV	694	395	0	0	41	354	177	177
PCT7853	ED	161	196	0	0	24	172	84	88
PCT7853	TO	855	591	0	0	65	526	261	265
PCT7854	MV	703	430	0	1	46	383	183	200
PCT7854	ED	175	221	0	0	27	194	104	90
PCT7854	TO	878	651	0	1	73	577	287	290
PCT7855	MV	763	451	0	0	49	402	192	210
PCT7855	ED	211	264	0	0	36	228	126	102
PCT7855	TO	974	715	0	0	85	630	318	312
PCT7856	MV	643	378	0	0	28	350	182	168
PCT7856	ED	204	250	0	0	31	219	129	90
PCT7856	TO	847	628	0	0	59	569	311	258
PCT7857	MV	748	438	0	1	40	397	203	194
PCT7857	ED	158	220	0	0	25	195	117	78
PCT7857	TO	906	658	0	1	65	592	320	272
PCT7858	MV	622	351	0	0	35	316	191	125
PCT7858	ED	157	206	0	0	24	182	126	56
PCT7858	TO	779	557	0	0	59	498	317	181
PCT7859	MV	747	465	0	0	45	420	202	218
PCT7859	ED	152	224	0	0	34	190	111	79
PCT7859	TO	899	689	0	0	79	610	313	297
PCT7861	MV	699	435	0	1	36	398	202	196
PCT7861	ED	164	217	0	0	16	201	129	72
PCT7861	TO	863	652	0	1	52	599	331	268
PCT7862	MV	669	404	0	0	33	371	178	193
PCT7862	ED	195	241	0	0	23	218	117	101
PCT7862	TO	864	645	0	0	56	589	295	294
PCT7863	MV	693	376	0	0	36	340	205	135
PCT7863	ED	208	273	0	0	29	244	139	105
PCT7863	TO	901	649	0	0	65	584	344	240
PCT7864	MV	661	376	0	0	48	328	171	157
PCT7864	ED	153	208	0	0	28	180	111	69
PCT7864	TO	814	584	0	0	76	508	282	226
PCT7865	MV	677	410	0	1	48	361	196	165
PCT7865	ED	163	201	0	0	25	176	114	62
PCT7865	TO	840	611	0	1	73	537	310	227
PCT7866	MV	690	447	0	0	41	406	204	202
PCT7866	ED	158	192	0	0	19	173	83	90
PCT7866	TO	848	639	0	0	60	579	287	292
PCT7867	MV	766	475	0	0	42	433	235	198
PCT7867	ED	212	235	0	0	33	202	120	82
PCT7867	TO	978	710	0	0	75	635	355	280
PCT7868	MV	659	376	0	0	30	346	174	172
PCT7868	ED	217	219	0	0	28	191	118	73
PCT7868	TO	876	595	0	0	58	537	292	245
PCT7869	MV	683	445	0	0	32	413	213	200
PCT7869	ED	178	225	0	0	31	194	120	74
PCT7869	TO	861	670	0	0	63	607	333	274
PCT7871	MV	702	466	0	0	49	417	221	196
PCT7871	ED	200	199	0	0	23	176	83	93
PCT7871	TO	902	665	0	0	72	593	304	289
PCT7872	MV	675	423	0	0	37	386	186	200
PCT7872	ED	199	232	0	0	28	204	98	106
PCT7872	TO	874	655	0	0	65	590	284	306
PCT7873	MV	689	445	0	0	37	408	228	180
PCT7873	ED	202	256	0	0	27	229	132	97
PCT7873	TO	891	701	0	0	64	637	360	277
PCT7874	MV	370	191	0	0	17	174	102	72
PCT7874	ED	119	131	0	0	17	114	66	48
PCT7874	TO	489	322	0	0	34	288	168	120
PCT7875	MV	500	253	0	0	22	231	143	88
PCT7875	ED	147	158	0	0	16	142	92	50
PCT7875	TO	647	411	0	0	38	373	235	138
PCT7876	MV	462	258	0	0	32	226	132	94
PCT7876	ED	106	129	0	0	19	110	64	46
PCT7876	TO	568	387	0	0	51	336	196	140
PCT7901	MV	399	192	0	0	14	178	120	58
PCT7901	ED	150	104	0	0	8	96	68	28
PCT7901	TO	549	296	0	0	22	274	188	86
PCT7902	MV	680	291	0	0	17	274	172	102
PCT7902	ED	232	208	0	1	22	185	133	52
PCT7902	TO	912	499	0	1	39	459	305	154
PCT7903	MV	623	286	0	0	24	262	178	84
PCT7903	ED	229	196	0	0	20	176	132	44
PCT7903	TO	852	482	0	0	44	438	310	128
PCT7904	MV	680	299	0	0	24	275	181	94
PCT7904	ED	157	187	0	1	17	169	115	54
PCT7904	TO	837	486	0	1	41	444	296	148
PCT7905	MV	684	356	0	0	24	332	192	140
PCT7905	ED	191	226	0	0	18	208	140	68
PCT7905	TO	875	582	0	0	42	540	332	208
PCT7906	MV	599	283	0	0	17	266	160	106
PCT7906	ED	187	206	0	0	27	179	139	40
PCT7906	TO	786	489	0	0	44	445	299	146
PCT7907	MV	704	345	0	0	22	323	217	106
PCT7907	ED	238	251	0	0	27	224	153	71
PCT7907	TO	942	596	0	0	49	547	370	177
PCT7908	MV	752	366	0	0	28	338	211	127
PCT7908	ED	240	250	0	0	30	220	155	65
PCT7908	TO	992	616	0	0	58	558	366	192
PCT7909	MV	558	311	0	0	22	289	189	100
PCT7909	ED	185	179	0	0	14	165	110	55
PCT7909	TO	743	490	0	0	36	454	299	155
PCT7911	MV	666	323	0	0	28	295	179	116
PCT7911	ED	205	207	0	0	21	186	126	60
PCT7911	TO	871	530	0	0	49	481	305	176
PCT7912	MV	800	370	0	0	27	343	214	129
PCT7912	ED	259	263	0	0	38	225	156	69
PCT7912	TO	1059	633	0	0	65	568	370	198
PCT7913	MV	661	352	0	0	15	337	212	125
PCT7913	ED	262	303	0	0	19	284	189	95
PCT7913	TO	923	655	0	0	34	621	401	220
PCT7914	MV	716	391	0	0	39	352	227	125
PCT7914	ED	186	217	0	0	29	188	134	54
PCT7914	TO	902	608	0	0	68	540	361	179
PCT7915	MV	605	290	0	0	20	270	167	103
PCT7915	ED	238	249	0	0	20	229	173	56
PCT7915	TO	843	539	0	0	40	499	340	159
PCT7916	MV	639	338	0	0	26	312	190	122
PCT7916	ED	219	231	0	0	22	209	145	64
PCT7916	TO	858	569	0	0	48	521	335	186
PCT7917	MV	716	358	0	0	27	331	215	116
PCT7917	ED	271	262	0	0	15	247	192	55
PCT7917	TO	987	620	0	0	42	578	407	171
PCT7918	MV	597	297	0	0	20	277	175	102
PCT7918	ED	227	202	0	0	20	182	124	58
PCT7918	TO	824	499	0	0	40	459	299	160
PCT7919	MV	609	309	0	0	24	285	188	97
PCT7919	ED	257	251	0	0	25	226	168	58
PCT7919	TO	866	560	0	0	49	511	356	155
PCT7921	MV	682	310	0	0	18	292	192	100
PCT7921	ED	229	181	0	0	20	161	105	56
PCT7921	TO	911	491	0	0	38	453	297	156
PCT7922	MV	648	314	0	0	17	297	197	100
PCT7922	ED	210	247	0	0	26	221	165	56
PCT7922	TO	858	561	0	0	43	518	362	156
PCT7923	MV	666	338	0	1	19	318	199	119
PCT7923	ED	214	261	0	0	27	234	178	56
PCT7923	TO	880	599	0	1	46	552	377	175
PCT7924	MV	650	305	0	0	12	293	189	104
PCT7924	ED	201	191	0	0	18	173	120	53
PCT7924	TO	851	496	0	0	30	466	309	157
PCT7925	MV	434	227	0	0	19	208	123	85
PCT7925	ED	110	127	0	0	7	120	87	33
PCT7925	TO	544	354	0	0	26	328	210	118
PCT7926	MV	610	341	0	1	27	313	193	120
PCT7926	ED	178	199	0	0	24	175	109	66
PCT7926	TO	788	540	0	1	51	488	302	186
PCT7927	MV	580	337	0	0	33	304	179	125
PCT7927	ED	162	217	0	1	23	193	120	73
PCT7927	TO	742	554	0	1	56	497	299	198
PCT7928	MV	700	397	0	0	28	369	234	135
PCT7928	ED	217	276	0	0	24	252	167	85
PCT7928	TO	917	673	0	0	52	621	401	220
PCT7929	MV	678	424	0	0	35	389	221	168
PCT7929	ED	169	225	0	0	29	196	122	74
PCT7929	TO	847	649	0	0	64	585	343	242
PCT7931	MV	610	378	0	0	45	333	188	145
PCT7931	ED	141	187	0	0	25	162	94	68
PCT7931	TO	751	565	0	0	70	495	282	213
PCT7932	MV	443	277	0	0	27	250	136	114
PCT7932	ED	118	117	0	0	18	99	60	39
PCT7932	TO	561	394	0	0	45	349	196	153
PCT7933	MV	8	6	0	0	0	6	4	2
PCT7933	ED	0	0	0	0	0	0	0	0
PCT7933	TO	8	6	0	0	0	6	4	2
PCT7934	MV	702	413	0	0	37	376	250	126
PCT7934	ED	182	202	0	0	28	174	133	41
PCT7934	TO	884	615	0	0	65	550	383	167
PCT7935	MV	716	441	0	0	38	403	245	158
PCT7935	ED	227	277	0	0	33	244	168	76
PCT7935	TO	943	718	0	0	71	647	413	234
PCT7936	MV	620	374	0	1	34	339	214	125
PCT7936	ED	236	271	0	0	26	245	157	88
PCT7936	TO	856	645	0	1	60	584	371	213
PCT7937	MV	698	406	0	0	41	365	239	126
PCT7937	ED	202	218	0	0	24	194	147	47
PCT7937	TO	900	624	0	0	65	559	386	173
PCT7938	MV	536	301	0	0	18	283	170	113
PCT7938	ED	215	153	0	0	18	135	96	39
PCT7938	TO	751	454	0	0	36	418	266	152
PCT7939	MV	481	292	0	0	23	269	173	96
PCT7939	ED	205	239	0	0	23	216	142	74
PCT7939	TO	686	531	0	0	46	485	315	170
PCT7941	MV	576	305	0	0	29	276	194	82
PCT7941	ED	196	202	0	0	19	183	101	82
PCT7941	TO	772	507	0	0	48	459	295	164
PCT7942	MV	658	333	0	0	26	307	194	113
PCT7942	ED	274	191	0	0	17	174	119	55
PCT7942	TO	932	524	0	0	43	481	313	168
PCT7943	MV	686	370	0	0	27	343	207	136
PCT7943	ED	214	241	0	0	31	210	129	81
PCT7943	TO	900	611	0	0	58	553	336	217
PCT7944	MV	584	343	0	0	40	303	185	118
PCT7944	ED	230	241	0	0	25	216	135	81
PCT7944	TO	814	584	0	0	65	519	320	199
PCT7945	MV	726	339	0	0	32	307	180	127
PCT7945	ED	228	139	0	0	15	124	84	40
PCT7945	TO	954	478	0	0	47	431	264	167
PCT7946	MV	779	369	0	0	25	344	179	165
PCT7946	ED	206	145	0	0	18	127	87	40
PCT7946	TO	985	514	0	0	43	471	266	205
PCT7947	MV	792	333	0	0	30	303	176	127
PCT7947	ED	194	150	0	0	16	134	87	47
PCT7947	TO	986	483	0	0	46	437	263	174
PCT7948	MV	730	375	0	0	34	341	187	154
PCT7948	ED	200	161	0	0	16	145	89	56
PCT7948	TO	930	536	0	0	50	486	276	210
PCT7949	MV	484	234	0	0	18	216	86	130
PCT7949	ED	106	84	0	0	15	69	43	26
PCT7949	TO	590	318	0	0	33	285	129	156
PCT7951	MV	731	366	0	0	31	335	154	181
PCT7951	ED	156	116	0	0	15	101	60	41
PCT7951	TO	887	482	0	0	46	436	214	222
PCT7952	MV	730	294	0	0	24	270	144	126
PCT7952	ED	182	132	0	0	17	115	69	46
PCT7952	TO	912	426	0	0	41	385	213	172
PCT7953	MV	669	331	0	0	33	298	134	164
PCT7953	ED	161	140	0	0	10	130	76	54
PCT7953	TO	830	471	0	0	43	428	210	218
PCT7954	MV	0	0	0	0	0	0	0	0
PCT7954	ED	0	0	0	0	0	0	0	0
PCT7954	TO	0	0	0	0	0	0	0	0
PCT7955	MV	774	351	0	0	35	316	161	155
PCT7955	ED	173	142	0	0	23	119	68	51
PCT7955	TO	947	493	0	0	58	435	229	206
PCT7956	MV	699	267	0	0	21	246	146	100
PCT7956	ED	170	84	0	0	7	77	54	23
PCT7956	TO	869	351	0	0	28	323	200	123
PCT7957	MV	538	261	0	1	22	238	151	87
PCT7957	ED	135	120	0	0	15	105	69	36
PCT7957	TO	673	381	0	1	37	343	220	123
PCT7958	MV	297	108	0	0	6	102	61	41
PCT7958	ED	0	14	0	0	4	10	8	2
PCT7958	TO	297	122	0	0	10	112	69	43
PCT7959	MV	541	230	0	0	24	206	131	75
PCT7959	ED	145	162	0	0	22	140	91	49
PCT7959	TO	686	392	0	0	46	346	222	124
PCT9001	MV	284	101	0	0	3	98	59	39
PCT9001	ED	0	7	0	0	1	6	5	1
PCT9001	TO	284	108	0	0	4	104	64	40
PCT9101	MV	712	380	0	0	31	349	199	150
PCT9101	ED	201	210	0	0	27	183	111	72
PCT9101	TO	913	590	0	0	58	532	310	222
PCT9102	MV	788	395	0	0	37	358	202	156
PCT9102	ED	204	201	0	0	25	176	103	73
PCT9102	TO	992	596	0	0	62	534	305	229
PCT9103	MV	719	382	0	0	40	342	182	160
PCT9103	ED	238	226	0	0	30	196	112	84
PCT9103	TO	957	608	0	0	70	538	294	244
PCT9104	MV	810	383	0	0	40	343	199	144
PCT9104	ED	220	205	0	0	28	177	120	57
PCT9104	TO	1030	588	0	0	68	520	319	201
PCT9105	MV	719	413	0	0	33	380	192	188
PCT9105	ED	199	241	0	0	30	211	123	88
PCT9105	TO	918	654	0	0	63	591	315	276
PCT9106	MV	748	399	0	0	48	351	172	179
PCT9106	ED	198	268	0	0	37	231	138	93
PCT9106	TO	946	667	0	0	85	582	310	272
PCT9107	MV	636	306	0	0	35	271	172	99
PCT9107	ED	208	187	0	0	25	162	110	52
PCT9107	TO	844	493	0	0	60	433	282	151
PCT9108	MV	610	338	0	0	44	294	174	120
PCT9108	ED	200	197	0	0	22	175	118	57
PCT9108	TO	810	535	0	0	66	469	292	177
PCT9109	MV	672	300	0	0	33	267	143	124
PCT9109	ED	211	213	0	0	22	191	100	91
PCT9109	TO	883	513	0	0	55	458	243	215
PCT9111	MV	639	318	0	0	30	288	173	115
PCT9111	ED	195	196	0	0	33	163	106	57
PCT9111	TO	834	514	0	0	63	451	279	172
PCT9112	MV	742	352	0	0	44	308	180	128
PCT9112	ED	219	218	0	0	25	193	115	78
PCT9112	TO	961	570	0	0	69	501	295	206
PCT9113	MV	797	373	0	0	39	334	182	152
PCT9113	ED	207	264	0	0	34	230	129	101
PCT9113	TO	1004	637	0	0	73	564	311	253
PCT9114	MV	659	294	0	0	27	267	166	101
PCT9114	ED	231	202	0	0	34	168	118	50
PCT9114	TO	890	496	0	0	61	435	284	151
PCT9115	MV	699	326	0	0	32	294	186	108
PCT9115	ED	182	198	0	0	30	168	121	47
PCT9115	TO	881	524	0	0	62	462	307	155
PCT9116	MV	782	347	0	0	25	322	187	135
PCT9116	ED	179	225	0	0	32	193	125	68
PCT9116	TO	961	572	0	0	57	515	312	203
PCT9117	MV	629	328	0	0	33	295	148	147
PCT9117	ED	171	207	0	0	21	186	100	86
PCT9117	TO	800	535	0	0	54	481	248	233
PCT9118	MV	742	341	0	0	35	306	168	138
PCT9118	ED	242	256	0	0	33	223	152	71
PCT9118	TO	984	597	0	0	68	529	320	209
PCT9119	MV	703	389	0	0	33	356	180	176
PCT9119	ED	197	171	0	0	22	149	90	59
PCT9119	TO	900	560	0	0	55	505	270	235
PCT9121	MV	735	337	0	0	33	304	151	153
PCT9121	ED	218	207	0	0	25	182	114	68
PCT9121	TO	953	544	0	0	58	486	265	221
PCT9122	MV	775	365	0	0	33	332	181	151
PCT9122	ED	192	184	0	0	32	152	91	61
PCT9122	TO	967	549	0	0	65	484	272	212
PCT9123	MV	661	319	0	0	23	296	160	136
PCT9123	ED	191	206	0	0	34	172	104	68
PCT9123	TO	852	525	0	0	57	468	264	204
PCT9124	MV	736	354	0	0	21	333	183	150
PCT9124	ED	167	175	0	0	14	161	114	47
PCT9124	TO	903	529	0	0	35	494	297	197
PCT9125	MV	681	360	0	0	29	331	185	146
PCT9125	ED	188	188	0	0	27	161	92	69
PCT9125	TO	869	548	0	0	56	492	277	215
PCT9126	MV	819	386	0	0	47	339	165	174
PCT9126	ED	194	224	0	0	26	198	115	83
PCT9126	TO	1013	610	0	0	73	537	280	257
PCT9127	MV	748	384	0	0	54	330	172	158
PCT9127	ED	223	241	0	0	25	216	123	93
PCT9127	TO	971	625	0	0	79	546	295	251
PCT9128	MV	628	336	0	0	32	304	134	170
PCT9128	ED	190	211	0	0	25	186	108	78
PCT9128	TO	818	547	0	0	57	490	242	248
PCT9129	MV	587	273	0	0	23	250	151	99
PCT9129	ED	151	170	0	0	14	156	101	55
PCT9129	TO	738	443	0	0	37	406	252	154
PCT9131	MV	596	288	0	0	24	264	129	135
PCT9131	ED	138	176	0	0	22	154	99	55
PCT9131	TO	734	464	0	0	46	418	228	190
PCT9132	MV	627	263	0	0	37	226	144	82
PCT9132	ED	194	197	0	0	24	173	115	58
PCT9132	TO	821	460	0	0	61	399	259	140
PCT9133	MV	808	383	0	0	41	342	190	152
PCT9133	ED	209	250	0	0	25	225	133	92
PCT9133	TO	1017	633	0	0	66	567	323	244
PCT9134	MV	736	328	0	0	27	301	161	140
PCT9134	ED	155	187	0	0	26	161	102	59
PCT9134	TO	891	515	0	0	53	462	263	199
PCT9135	MV	640	305	0	0	27	278	160	118
PCT9135	ED	182	173	0	0	21	152	74	78
PCT9135	TO	822	478	0	0	48	430	234	196
PCT9136	MV	706	368	0	0	47	321	184	137
PCT9136	ED	212	206	0	0	27	179	117	62
PCT9136	TO	918	574	0	0	74	500	301	199
PCT9137	MV	806	389	0	0	41	348	205	143
PCT9137	ED	209	210	0	0	24	186	128	58
PCT9137	TO	1015	599	0	0	65	534	333	201
PCT9138	MV	770	401	0	0	33	368	196	172
PCT9138	ED	175	171	0	0	20	151	104	47
PCT9138	TO	945	572	0	0	53	519	300	219
PCT9139	MV	828	424	0	0	36	388	179	209
PCT9139	ED	190	207	0	0	28	179	101	78
PCT9139	TO	1018	631	0	0	64	567	280	287
PCT9141	MV	789	419	0	0	57	362	203	159
PCT9141	ED	184	189	0	0	19	170	100	70
PCT9141	TO	973	608	0	0	76	532	303	229
PCT9142	MV	747	366	0	0	30	336	207	129
PCT9142	ED	239	236	0	0	26	210	127	83
PCT9142	TO	986	602	0	0	56	546	334	212
PCT9143	MV	706	362	0	0	32	330	164	166
PCT9143	ED	208	202	0	0	17	185	99	86
PCT9143	TO	914	564	0	0	49	515	263	252
PCT9144	MV	767	376	0	0	35	341	193	148
PCT9144	ED	203	238	0	0	25	213	138	75
PCT9144	TO	970	614	0	0	60	554	331	223
PCT9145	MV	681	335	0	0	27	308	158	150
PCT9145	ED	194	216	0	0	21	195	107	88
PCT9145	TO	875	551	0	0	48	503	265	238
PCT9146	MV	725	354	0	0	39	315	196	119
PCT9146	ED	160	215	0	0	34	181	116	65
PCT9146	TO	885	569	0	0	73	496	312	184
PCT9147	MV	765	373	0	0	30	343	188	155
PCT9147	ED	225	227	0	0	25	202	131	71
PCT9147	TO	990	600	0	0	55	545	319	226
PCT9148	MV	779	398	0	0	35	363	192	171
PCT9148	ED	235	256	0	0	35	221	126	95
PCT9148	TO	1014	654	0	0	70	584	318	266
PCT9149	MV	813	388	0	0	33	355	195	160
PCT9149	ED	178	292	0	0	34	258	169	89
PCT9149	TO	991	680	0	0	67	613	364	249
PCT9151	MV	693	352	0	0	43	309	183	126
PCT9151	ED	168	228	0	0	32	196	119	77
PCT9151	TO	861	580	0	0	75	505	302	203
PCT9152	MV	550	198	0	0	18	180	114	66
PCT9152	ED	187	356	0	1	36	319	250	69
PCT9152	TO	737	554	0	1	54	499	364	135
PCT9201	MV	785	358	0	0	43	315	211	104
PCT9201	ED	186	252	0	0	24	228	159	69
PCT9201	TO	971	610	0	0	67	543	370	173
PCT9202	MV	819	368	0	1	54	313	160	153
PCT9202	ED	177	253	0	0	31	222	114	108
PCT9202	TO	996	621	0	1	85	535	274	261
PCT9203	MV	847	374	0	0	63	311	108	203
PCT9203	ED	155	208	0	0	35	173	77	96
PCT9203	TO	1002	582	0	0	98	484	185	299
PCT9204	MV	686	309	0	0	44	265	82	183
PCT9204	ED	176	219	0	1	38	180	69	111
PCT9204	TO	862	528	0	1	82	445	151	294
PCT9205	MV	622	289	0	0	42	247	105	142
PCT9205	ED	114	171	0	0	32	139	65	74
PCT9205	TO	736	460	0	0	74	386	170	216
PCT9206	MV	741	355	0	0	42	313	106	207
PCT9206	ED	188	208	0	0	44	164	64	100
PCT9206	TO	929	563	0	0	86	477	170	307
PCT9207	MV	824	370	0	0	38	332	148	184
PCT9207	ED	165	208	0	0	35	173	70	103
PCT9207	TO	989	578	0	0	73	505	218	287
PCT9208	MV	808	359	0	1	47	311	127	184
PCT9208	ED	179	199	0	0	29	170	76	94
PCT9208	TO	987	558	0	1	76	481	203	278
PCT9209	MV	615	276	0	0	31	245	90	155
PCT9209	ED	156	190	0	1	40	149	66	83
PCT9209	TO	771	466	0	1	71	394	156	238
PCT9211	MV	730	314	0	0	42	272	123	149
PCT9211	ED	161	191	0	0	37	154	58	96
PCT9211	TO	891	505	0	0	79	426	181	245
PCT9212	MV	671	285	0	1	35	249	100	149
PCT9212	ED	137	192	0	0	44	148	67	81
PCT9212	TO	808	477	0	1	79	397	167	230
PCT9213	MV	776	350	0	0	42	308	146	162
PCT9213	ED	161	212	0	0	38	174	90	84
PCT9213	TO	937	562	0	0	80	482	236	246
PCT9214	MV	517	236	0	0	22	214	97	117
PCT9214	ED	110	157	0	0	34	123	39	84
PCT9214	TO	627	393	0	0	56	337	136	201
PCT9215	MV	524	246	0	0	23	223	93	130
PCT9215	ED	120	152	0	0	28	124	43	81
PCT9215	TO	644	398	0	0	51	347	136	211
PCT9216	MV	669	266	0	0	42	224	86	138
PCT9216	ED	155	223	0	0	33	190	92	98
PCT9216	TO	824	489	0	0	75	414	178	236
PCT9217	MV	588	269	0	0	22	247	110	137
PCT9217	ED	117	160	0	0	18	142	71	71
PCT9217	TO	705	429	0	0	40	389	181	208
PCT9218	MV	652	278	0	0	34	244	111	133
PCT9218	ED	164	188	0	0	28	160	73	87
PCT9218	TO	816	466	0	0	62	404	184	220
PCT9219	MV	646	292	0	0	43	249	129	120
PCT9219	ED	144	204	0	0	34	170	100	70
PCT9219	TO	790	496	0	0	77	419	229	190
PCT9221	MV	562	325	0	0	27	298	86	212
PCT9221	ED	89	145	0	0	26	119	31	88
PCT9221	TO	651	470	0	0	53	417	117	300
PCT9222	MV	773	374	0	0	41	333	110	223
PCT9222	ED	137	210	0	0	40	170	69	101
PCT9222	TO	910	584	0	0	81	503	179	324
PCT9223	MV	558	268	0	0	29	239	79	160
PCT9223	ED	109	127	0	0	20	107	42	65
PCT9223	TO	667	395	0	0	49	346	121	225
PCT9224	MV	768	380	0	0	35	345	135	210
PCT9224	ED	181	220	0	0	41	179	76	103
PCT9224	TO	949	600	0	0	76	524	211	313
PCT9225	MV	757	304	0	0	39	265	121	144
PCT9225	ED	169	234	0	0	36	198	93	105
PCT9225	TO	926	538	0	0	75	463	214	249
PCT9226	MV	741	357	0	0	48	309	113	196
PCT9226	ED	155	239	0	0	42	197	100	97
PCT9226	TO	896	596	0	0	90	506	213	293
PCT9227	MV	605	373	0	0	43	330	112	218
PCT9227	ED	124	156	0	0	12	144	58	86
PCT9227	TO	729	529	0	0	55	474	170	304
PCT9228	MV	578	314	0	0	27	287	93	194
PCT9228	ED	160	188	0	0	30	158	61	97
PCT9228	TO	738	502	0	0	57	445	154	291
PCT9229	MV	460	257	0	0	33	224	90	134
PCT9229	ED	119	147	0	0	22	125	49	76
PCT9229	TO	579	404	0	0	55	349	139	210
PCT9231	MV	726	354	0	0	35	319	140	179
PCT9231	ED	236	282	0	0	39	243	134	109
PCT9231	TO	962	636	0	0	74	562	274	288
PCT9232	MV	608	295	0	0	35	260	93	167
PCT9232	ED	126	183	0	0	26	157	68	89
PCT9232	TO	734	478	0	0	61	417	161	256
PCT9233	MV	668	332	0	0	45	287	83	204
PCT9233	ED	150	201	0	0	35	166	60	106
PCT9233	TO	818	533	0	0	80	453	143	310
PCT9234	MV	643	322	0	0	29	293	124	169
PCT9234	ED	91	155	0	0	31	124	49	75
PCT9234	TO	734	477	0	0	60	417	173	244
PCT9235	MV	703	368	0	1	39	328	95	233
PCT9235	ED	160	212	0	0	26	186	74	112
PCT9235	TO	863	580	0	1	65	514	169	345
PCT9236	MV	537	283	0	0	27	256	109	147
PCT9236	ED	136	148	0	0	26	122	47	75
PCT9236	TO	673	431	0	0	53	378	156	222
PCT9237	MV	779	396	0	2	42	352	127	225
PCT9237	ED	118	206	0	0	35	171	83	88
PCT9237	TO	897	602	0	2	77	523	210	313
PCT9238	MV	687	330	0	0	41	289	101	188
PCT9238	ED	118	192	0	0	32	160	72	88
PCT9238	TO	805	522	0	0	73	449	173	276
PCT9239	MV	740	391	0	0	58	333	126	207
PCT9239	ED	124	174	0	0	32	142	63	79
PCT9239	TO	864	565	0	0	90	475	189	286
PCT9241	MV	819	404	0	0	42	362	146	216
PCT9241	ED	141	211	0	0	30	181	76	105
PCT9241	TO	960	615	0	0	72	543	222	321
PCT9242	MV	771	350	0	0	46	304	132	172
PCT9242	ED	172	238	0	0	45	193	103	90
PCT9242	TO	943	588	0	0	91	497	235	262
PCT9243	MV	480	242	0	0	31	211	89	122
PCT9243	ED	123	154	0	0	26	128	69	59
PCT9243	TO	603	396	0	0	57	339	158	181
PCT9244	MV	756	399	0	0	60	339	145	194
PCT9244	ED	154	206	0	0	26	180	99	81
PCT9244	TO	910	605	0	0	86	519	244	275
PCT9245	MV	616	301	0	0	43	258	115	143
PCT9245	ED	98	145	0	0	20	125	61	64
PCT9245	TO	714	446	0	0	63	383	176	207
PCT9246	MV	815	434	0	0	43	391	172	219
PCT9246	ED	155	214	0	0	38	176	80	96
PCT9246	TO	970	648	0	0	81	567	252	315
PCT9247	MV	764	381	0	0	37	344	159	185
PCT9247	ED	148	225	0	0	39	186	97	89
PCT9247	TO	912	606	0	0	76	530	256	274
PCT9248	MV	757	360	0	0	41	319	165	154
PCT9248	ED	150	211	0	0	32	179	108	71
PCT9248	TO	907	571	0	0	73	498	273	225
PCT9249	MV	724	380	0	0	46	334	160	174
PCT9249	ED	191	235	0	0	29	206	103	103
PCT9249	TO	915	615	0	0	75	540	263	277
PCT9251	MV	792	393	0	0	49	344	162	182
PCT9251	ED	174	248	0	0	33	215	106	109
PCT9251	TO	966	641	0	0	82	559	268	291
PCT9252	MV	811	384	0	0	44	340	166	174
PCT9252	ED	142	211	0	0	20	191	101	90
PCT9252	TO	953	595	0	0	64	531	267	264
PCT9253	MV	599	300	0	0	28	272	113	159
PCT9253	ED	162	170	0	0	21	149	95	54
PCT9253	TO	761	470	0	0	49	421	208	213
PCT9254	MV	758	415	0	0	38	377	170	207
PCT9254	ED	163	229	0	0	39	190	104	86
PCT9254	TO	921	644	0	0	77	567	274	293
PCT9255	MV	437	196	0	0	32	164	87	77
PCT9255	ED	113	155	0	0	27	128	73	55
PCT9255	TO	550	351	0	0	59	292	160	132
PCT9256	MV	367	169	0	0	17	152	75	77
PCT9256	ED	95	134	0	0	17	117	65	52
PCT9256	TO	462	303	0	0	34	269	140	129
PCT9257	MV	320	165	0	0	22	143	99	44
PCT9257	ED	0	23	0	0	4	19	12	7
PCT9257	TO	320	188	0	0	26	162	111	51
PCT9258	MV	583	307	0	0	33	274	137	137
PCT9258	ED	120	162	0	0	24	138	80	58
PCT9258	TO	703	469	0	0	57	412	217	195
PCT9401	MV	796	359	0	0	27	332	222	110
PCT9401	ED	242	259	0	0	32	227	175	52
PCT9401	TO	1038	618	0	0	59	559	397	162
PCT9402	MV	775	378	0	0	37	341	213	128
PCT9402	ED	242	226	0	0	25	201	138	63
PCT9402	TO	1017	604	0	0	62	542	351	191
PCT9403	MV	731	349	0	0	21	328	193	135
PCT9403	ED	190	183	0	0	20	163	113	50
PCT9403	TO	921	532	0	0	41	491	306	185
PCT9404	MV	753	345	0	0	28	317	172	145
PCT9404	ED	191	209	0	0	30	179	115	64
PCT9404	TO	944	554	0	0	58	496	287	209
PCT9405	MV	629	278	0	1	34	243	129	114
PCT9405	ED	151	145	0	0	7	138	86	52
PCT9405	TO	780	423	0	1	41	381	215	166
PCT9406	MV	695	332	0	0	32	300	169	131
PCT9406	ED	188	198	0	0	20	178	98	80
PCT9406	TO	883	530	0	0	52	478	267	211
PCT9407	MV	712	369	0	0	32	337	183	154
PCT9407	ED	201	195	0	0	34	161	101	60
PCT9407	TO	913	564	0	0	66	498	284	214
PCT9408	MV	711	324	0	0	36	288	187	101
PCT9408	ED	152	195	0	0	20	175	122	53
PCT9408	TO	863	519	0	0	56	463	309	154
PCT9409	MV	443	227	0	0	25	202	119	83
PCT9409	ED	158	172	0	0	12	160	116	44
PCT9409	TO	601	399	0	0	37	362	235	127
PCT9411	MV	816	378	0	0	37	341	227	114
PCT9411	ED	191	239	0	0	28	211	152	59
PCT9411	TO	1007	617	0	0	65	552	379	173
PCT9412	MV	668	340	0	0	31	309	163	146
PCT9412	ED	202	199	0	0	23	176	103	73
PCT9412	TO	870	539	0	0	54	485	266	219
PCT9413	MV	757	379	0	0	54	325	180	145
PCT9413	ED	179	185	0	0	24	161	105	56
PCT9413	TO	936	564	0	0	78	486	285	201
PCT9414	MV	734	361	0	0	44	317	164	153
PCT9414	ED	186	162	0	0	17	145	83	62
PCT9414	TO	920	523	0	0	61	462	247	215
PCT9415	MV	634	315	0	0	24	291	144	147
PCT9415	ED	154	138	0	0	9	129	86	43
PCT9415	TO	788	453	0	0	33	420	230	190
PCT9416	MV	769	391	0	0	55	336	166	170
PCT9416	ED	230	206	0	0	19	187	109	78
PCT9416	TO	999	597	0	0	74	523	275	248
PCT9417	MV	629	322	0	0	35	287	147	140
PCT9417	ED	145	153	0	0	16	137	74	63
PCT9417	TO	774	475	0	0	51	424	221	203
PCT9418	MV	631	310	0	0	34	276	122	154
PCT9418	ED	188	161	0	0	17	144	92	52
PCT9418	TO	819	471	0	0	51	420	214	206
PCT9419	MV	736	371	0	0	38	333	137	196
PCT9419	ED	173	148	0	0	14	134	62	72
PCT9419	TO	909	519	0	0	52	467	199	268
PCT9421	MV	752	342	0	0	34	308	141	167
PCT9421	ED	173	172	0	0	17	155	88	67
PCT9421	TO	925	514	0	0	51	463	229	234
PCT9422	MV	831	413	0	0	43	370	194	176
PCT9422	ED	270	222	0	0	30	192	117	75
PCT9422	TO	1101	635	0	0	73	562	311	251
PCT9423	MV	714	318	0	0	33	285	144	141
PCT9423	ED	190	187	0	0	23	164	99	65
PCT9423	TO	904	505	0	0	56	449	243	206
PCT9424	MV	799	386	0	0	39	347	172	175
PCT9424	ED	210	171	0	0	24	147	89	58
PCT9424	TO	1009	557	0	0	63	494	261	233
PCT9425	MV	789	348	0	0	48	300	159	141
PCT9425	ED	187	183	0	0	24	159	102	57
PCT9425	TO	976	531	0	0	72	459	261	198
PCT9426	MV	697	326	0	0	31	295	141	154
PCT9426	ED	156	159	0	0	24	135	71	64
PCT9426	TO	853	485	0	0	55	430	212	218
PCT9427	MV	799	386	0	0	34	352	153	199
PCT9427	ED	188	171	0	0	30	141	78	63
PCT9427	TO	987	557	0	0	64	493	231	262
PCT9428	MV	811	353	0	0	36	317	161	156
PCT9428	ED	179	163	0	0	22	141	87	54
PCT9428	TO	990	516	0	0	58	458	248	210
PCT9429	MV	709	344	0	0	35	309	141	168
PCT9429	ED	197	175	0	0	26	149	79	70
PCT9429	TO	906	519	0	0	61	458	220	238
PCT9431	MV	832	413	0	0	45	368	151	217
PCT9431	ED	204	189	0	0	18	171	97	74
PCT9431	TO	1036	602	0	0	63	539	248	291
PCT9432	MV	743	361	0	0	46	315	160	155
PCT9432	ED	215	156	0	0	22	134	71	63
PCT9432	TO	958	517	0	0	68	449	231	218
PCT9433	MV	794	374	0	0	45	329	157	172
PCT9433	ED	164	137	0	0	11	126	62	64
PCT9433	TO	958	511	0	0	56	455	219	236
PCT9434	MV	785	387	0	0	40	347	172	175
PCT9434	ED	227	240	0	1	34	205	128	77
PCT9434	TO	1012	627	0	1	74	552	300	252
PCT9435	MV	779	366	0	0	39	327	155	172
PCT9435	ED	225	218	0	0	19	199	128	71
PCT9435	TO	1004	584	0	0	58	526	283	243
PCT9436	MV	842	387	0	0	29	358	153	205
PCT9436	ED	226	176	0	0	25	151	76	75
PCT9436	TO	1068	563	0	0	54	509	229	280
PCT9437	MV	736	376	0	0	33	343	159	184
PCT9437	ED	191	173	0	0	20	153	99	54
PCT9437	TO	927	549	0	0	53	496	258	238
PCT9438	MV	837	421	0	0	38	383	171	212
PCT9438	ED	152	129	0	0	14	115	68	47
PCT9438	TO	989	550	0	0	52	498	239	259
PCT9439	MV	718	344	0	0	26	318	135	183
PCT9439	ED	199	150	0	0	27	123	70	53
PCT9439	TO	917	494	0	0	53	441	205	236
PCT9441	MV	778	396	0	0	43	353	207	146
PCT9441	ED	193	188	0	0	25	163	109	54
PCT9441	TO	971	584	0	0	68	516	316	200
PCT9442	MV	830	382	0	0	45	337	189	148
PCT9442	ED	210	232	0	0	29	203	120	83
PCT9442	TO	1040	614	0	0	74	540	309	231
PCT9443	MV	760	363	0	0	35	328	179	149
PCT9443	ED	195	173	0	1	24	148	91	57
PCT9443	TO	955	536	0	1	59	476	270	206
PCT9444	MV	768	343	0	0	23	320	151	169
PCT9444	ED	197	154	0	0	21	133	88	45
PCT9444	TO	965	497	0	0	44	453	239	214
PCT9445	MV	830	407	0	0	41	366	176	190
PCT9445	ED	166	181	0	0	22	159	95	64
PCT9445	TO	996	588	0	0	63	525	271	254
PCT9446	MV	900	467	0	0	51	416	199	217
PCT9446	ED	216	185	0	0	23	162	87	75
PCT9446	TO	1116	652	0	0	74	578	286	292
PCT9447	MV	729	395	0	0	28	367	165	202
PCT9447	ED	192	203	0	0	24	179	98	81
PCT9447	TO	921	598	0	0	52	546	263	283
PCT9448	MV	742	347	0	0	32	315	156	159
PCT9448	ED	198	185	0	0	21	164	110	54
PCT9448	TO	940	532	0	0	53	479	266	213
PCT9449	MV	719	342	0	1	37	304	147	157
PCT9449	ED	162	129	0	1	13	115	60	55
PCT9449	TO	881	471	0	2	50	419	207	212
PCT9451	MV	353	178	0	0	17	161	74	87
PCT9451	ED	88	71	0	0	8	63	39	24
PCT9451	TO	441	249	0	0	25	224	113	111
PCT9452	MV	647	336	0	0	32	304	149	155
PCT9452	ED	195	199	0	0	24	175	87	88
PCT9452	TO	842	535	0	0	56	479	236	243
PCT9453	MV	409	220	0	0	20	200	85	115
PCT9453	ED	115	88	0	0	11	77	32	45
PCT9453	TO	524	308	0	0	31	277	117	160
PCT9501	MV	150	92	0	1	12	79	49	30
PCT9501	ED	0	5	0	0	2	3	2	1
PCT9501	TO	150	97	0	1	14	82	51	31
PCT9502	MV	251	136	0	0	19	117	70	47
PCT9502	ED	0	12	0	0	2	10	8	2
PCT9502	TO	251	148	0	0	21	127	78	49
PCT9503	MV	550	263	0	0	38	225	126	99
PCT9503	ED	150	139	0	0	22	117	74	43
PCT9503	TO	700	402	0	0	60	342	200	142
PCT9505	MV	589	296	0	0	34	262	177	85
PCT9505	ED	176	147	0	0	20	127	70	57
PCT9505	TO	765	443	0	0	54	389	247	142
PCT9506	MV	547	233	0	0	18	215	118	97
PCT9506	ED	207	147	0	0	19	128	94	34
PCT9506	TO	754	380	0	0	37	343	212	131
PCT9507	MV	556	306	0	1	29	276	163	113
PCT9507	ED	160	206	0	0	31	175	106	69
PCT9507	TO	716	512	0	1	60	451	269	182
PCT9508	MV	632	320	0	0	25	295	197	98
PCT9508	ED	148	212	0	0	32	180	113	67
PCT9508	TO	780	532	0	0	57	475	310	165
PCT9509	MV	585	297	0	0	23	274	147	127
PCT9509	ED	142	196	0	0	25	171	121	50
PCT9509	TO	727	493	0	0	48	445	268	177
PCT9511	MV	458	242	0	0	18	224	130	94
PCT9511	ED	176	179	0	0	23	156	100	56
PCT9511	TO	634	421	0	0	41	380	230	150
PCT9512	MV	617	328	0	0	34	294	181	113
PCT9512	ED	160	209	0	0	26	183	118	65
PCT9512	TO	777	537	0	0	60	477	299	178
PCT9513	MV	686	335	0	0	37	298	190	108
PCT9513	ED	191	202	0	0	22	180	125	55
PCT9513	TO	877	537	0	0	59	478	315	163
PCT9514	MV	713	353	0	0	41	312	176	136
PCT9514	ED	183	247	0	0	26	221	155	66
PCT9514	TO	896	600	0	0	67	533	331	202
PCT9515	MV	543	306	0	0	31	275	146	129
PCT9515	ED	169	192	0	0	28	164	98	66
PCT9515	TO	712	498	0	0	59	439	244	195
PCT9516	MV	705	367	0	0	31	336	205	131
PCT9516	ED	184	221	0	0	31	190	110	80
PCT9516	TO	889	588	0	0	62	526	315	211
PCT9517	MV	626	335	0	0	23	312	180	132
PCT9517	ED	162	200	0	0	33	167	124	43
PCT9517	TO	788	535	0	0	56	479	304	175
PCT9518	MV	642	319	0	0	30	289	183	106
PCT9518	ED	146	218	0	0	27	191	133	58
PCT9518	TO	788	537	0	0	57	480	316	164
PCT9519	MV	693	370	0	0	31	339	205	134
PCT9519	ED	198	260	0	0	30	230	144	86
PCT9519	TO	891	630	0	0	61	569	349	220
PCT9521	MV	687	352	0	0	28	324	187	137
PCT9521	ED	214	256	0	0	35	221	144	77
PCT9521	TO	901	608	0	0	63	545	331	214
PCT9701	MV	498	271	0	0	26	245	144	101
PCT9701	ED	156	163	0	0	15	148	92	56
PCT9701	TO	654	434	0	0	41	393	236	157
PCT9702	MV	554	309	0	0	25	284	147	137
PCT9702	ED	166	196	0	0	19	177	111	66
PCT9702	TO	720	505	0	0	44	461	258	203
PCT9703	MV	809	403	0	0	47	356	185	171
PCT9703	ED	182	200	0	0	24	176	98	78
PCT9703	TO	991	603	0	0	71	532	283	249
PCT9704	MV	760	426	0	0	46	380	173	207
PCT9704	ED	199	244	0	0	32	212	125	87
PCT9704	TO	959	670	0	0	78	592	298	294
PCT9705	MV	754	421	0	0	42	379	190	189
PCT9705	ED	175	203	0	0	25	178	111	67
PCT9705	TO	929	624	0	0	67	557	301	256
PCT9706	MV	49	35	0	0	2	33	17	16
PCT9706	ED	0	1	0	0	0	1	0	1
PCT9706	TO	49	36	0	0	2	34	17	17
PCT9707	MV	687	359	0	0	25	334	140	194
PCT9707	ED	139	146	0	0	22	124	56	68
PCT9707	TO	826	505	0	0	47	458	196	262
PCT9708	MV	786	432	0	0	56	376	206	170
PCT9708	ED	175	216	0	0	25	191	119	72
PCT9708	TO	961	648	0	0	81	567	325	242
PCT9709	MV	831	429	0	0	47	382	165	217
PCT9709	ED	209	230	0	0	24	206	120	86
PCT9709	TO	1040	659	0	0	71	588	285	303
PCT9711	MV	502	307	0	0	34	273	133	140
PCT9711	ED	144	168	0	0	19	149	66	83
PCT9711	TO	646	475	0	0	53	422	199	223
PCT9712	MV	534	337	0	0	33	304	118	186
PCT9712	ED	127	138	0	0	10	128	63	65
PCT9712	TO	661	475	0	0	43	432	181	251
PCT9713	MV	747	391	0	0	31	360	161	199
PCT9713	ED	203	182	0	0	23	159	89	70
PCT9713	TO	950	573	0	0	54	519	250	269
PCT9714	MV	795	447	0	0	41	406	153	253
PCT9714	ED	156	178	0	0	12	166	75	91
PCT9714	TO	951	625	0	0	53	572	228	344
PCT9715	MV	449	242	0	0	28	214	66	148
PCT9715	ED	130	157	0	0	13	144	49	95
PCT9715	TO	579	399	0	0	41	358	115	243
PCT9716	MV	745	401	0	0	40	361	158	203
PCT9716	ED	221	217	0	0	30	187	94	93
PCT9716	TO	966	618	0	0	70	548	252	296
PCT9717	MV	753	439	0	0	38	401	153	248
PCT9717	ED	224	194	0	0	22	172	80	92
PCT9717	TO	977	633	0	0	60	573	233	340
PCT9718	MV	749	451	0	0	36	415	181	234
PCT9718	ED	152	185	0	0	18	167	78	89
PCT9718	TO	901	636	0	0	54	582	259	323
PCT9719	MV	747	465	0	0	41	424	160	264
PCT9719	ED	173	191	0	0	18	173	77	96
PCT9719	TO	920	656	0	0	59	597	237	360
PCT9721	MV	498	291	0	0	31	260	95	165
PCT9721	ED	164	174	0	0	11	163	66	97
PCT9721	TO	662	465	0	0	42	423	161	262
PCT9722	MV	513	315	0	0	25	290	126	164
PCT9722	ED	84	101	0	0	17	84	36	48
PCT9722	TO	597	416	0	0	42	374	162	212
PCT9723	MV	436	225	0	0	16	209	57	152
PCT9723	ED	72	66	0	0	6	60	18	42
PCT9723	TO	508	291	0	0	22	269	75	194
PCT9724	MV	851	458	0	0	38	420	127	293
PCT9724	ED	169	145	0	0	14	131	57	74
PCT9724	TO	1020	603	0	0	52	551	184	367
PCT9725	MV	814	439	0	0	35	404	163	241
PCT9725	ED	157	166	0	0	21	145	62	83
PCT9725	TO	971	605	0	0	56	549	225	324
PCT9726	MV	630	218	0	0	27	191	126	65
PCT9726	ED	-14	280	0	0	41	239	176	63
PCT9726	TO	616	498	0	0	68	430	302	128
PCT9727	MV	404	227	0	2	19	206	75	131
PCT9727	ED	56	64	0	0	10	54	20	34
PCT9727	TO	460	291	0	2	29	260	95	165
PCT9728	MV	751	448	0	0	35	413	117	296
PCT9728	ED	212	184	0	0	20	164	61	103
PCT9728	TO	963	632	0	0	55	577	178	399
PCT9729	MV	654	338	0	0	28	310	83	227
PCT9729	ED	164	174	0	0	13	161	57	104
PCT9729	TO	818	512	0	0	41	471	140	331
PCT9731	MV	436	246	0	0	24	222	75	147
PCT9731	ED	143	145	0	0	15	130	44	86
PCT9731	TO	579	391	0	0	39	352	119	233
PCT9732	MV	73	47	0	0	4	43	17	26
PCT9732	ED	0	3	0	0	2	1	1	0
PCT9732	TO	73	50	0	0	6	44	18	26
PCT9733	MV	240	162	0	0	7	155	82	73
PCT9733	ED	0	12	0	0	4	8	6	2
PCT9733	TO	240	174	0	0	11	163	88	75
PCT9734	MV	473	290	0	0	23	267	99	168
PCT9734	ED	131	131	0	0	11	120	43	77
PCT9734	TO	604	421	0	0	34	387	142	245
PCT9735	MV	650	390	0	0	32	358	142	216
PCT9735	ED	170	187	0	0	29	158	65	93
PCT9735	TO	820	577	0	0	61	516	207	309
PCT9736	MV	586	329	0	0	27	302	120	182
PCT9736	ED	150	187	0	0	19	168	77	91
PCT9736	TO	736	516	0	0	46	470	197	273
PCT9737	MV	637	390	0	0	37	353	166	187
PCT9737	ED	154	164	0	1	14	149	81	68
PCT9737	TO	791	554	0	1	51	502	247	255
PCT9738	MV	688	320	0	0	33	287	181	106
PCT9738	ED	150	118	0	0	12	106	62	44
PCT9738	TO	838	438	0	0	45	393	243	150
PCT9739	MV	674	273	0	0	15	258	183	75
PCT9739	ED	115	249	0	0	31	218	184	34
PCT9739	TO	789	522	0	0	46	476	367	109
PCT9741	MV	843	174	0	0	22	152	129	23
PCT9741	ED	-402	454	0	0	76	378	289	89
PCT9741	TO	441	628	0	0	98	530	418	112
PCT9742	MV	530	229	0	0	15	214	80	134
PCT9742	ED	165	163	0	0	16	147	79	68
PCT9742	TO	695	392	0	0	31	361	159	202
PCT9743	MV	913	405	0	0	32	373	224	149
PCT9743	ED	227	261	0	0	30	231	174	57
PCT9743	TO	1140	666	0	0	62	604	398	206
PCT9744	MV	783	334	0	0	40	294	191	103
PCT9744	ED	160	262	0	0	50	212	163	49
PCT9744	TO	943	596	0	0	90	506	354	152
PCT9745	MV	791	321	0	0	35	286	198	88
PCT9745	ED	201	237	0	0	25	212	153	59
PCT9745	TO	992	558	0	0	60	498	351	147
PCT9746	MV	714	374	0	0	18	356	148	208
PCT9746	ED	189	154	0	0	14	140	64	76
PCT9746	TO	903	528	0	0	32	496	212	284
PCT9747	MV	772	401	0	0	37	364	191	173
PCT9747	ED	204	193	0	0	18	175	97	78
PCT9747	TO	976	594	0	0	55	539	288	251
PCT9748	MV	746	425	0	0	39	386	179	207
PCT9748	ED	167	164	0	0	15	149	84	65
PCT9748	TO	913	589	0	0	54	535	263	272
PCT9749	MV	750	289	0	0	18	271	171	100
PCT9749	ED	188	170	0	0	17	153	103	50
PCT9749	TO	938	459	0	0	35	424	274	150
PCT9751	MV	857	475	0	0	48	427	195	232
PCT9751	ED	214	205	0	0	31	174	93	81
PCT9751	TO	1071	680	0	0	79	601	288	313
PCT9752	MV	563	330	0	0	25	305	141	164
PCT9752	ED	134	156	0	0	15	141	71	70
PCT9752	TO	697	486	0	0	40	446	212	234
PCT9753	MV	617	300	0	0	22	278	156	122
PCT9753	ED	145	168	0	0	10	158	87	71
PCT9753	TO	762	468	0	0	32	436	243	193
PCT9754	MV	545	317	0	0	25	292	181	111
PCT9754	ED	162	149	0	0	14	135	81	54
PCT9754	TO	707	466	0	0	39	427	262	165
PCT9755	MV	441	240	0	0	25	215	119	96
PCT9755	ED	139	134	0	0	11	123	63	60
PCT9755	TO	580	374	0	0	36	338	182	156
PCT9756	MV	805	365	0	0	33	332	168	164
PCT9756	ED	162	153	0	0	17	136	86	50
PCT9756	TO	967	518	0	0	50	468	254	214
PCT9801	MV	320	163	0	0	17	146	84	62
PCT9801	ED	88	68	0	0	7	61	30	31
PCT9801	TO	408	231	0	0	24	207	114	93
PCT9900	MV	0	0	0	0	0	0	0	0
PCT9900	ED	0	0	0	0	0	0	0	0
PCT9900	TO	0	0	0	0	0	0	0	0
PCT9901	MV	0	0	0	0	0	0	0	0
PCT9901	ED	0	0	0	0	0	0	0	0
PCT9901	TO	0	0	0	0	0	0	0	0
PCT9902	MV	0	0	0	0	0	0	0	0
PCT9902	ED	0	0	0	0	0	0	0	0
PCT9902	TO	0	0	0	0	0	0	0	0
CONG12	MV	355626	175466	0	37	17357	158072	84569	73503
CONG12	ED	90222	96086	0	16	12481	83589	50564	33025
CONG12	TO	445848	271552	0	53	29838	241661	135133	106528
CONG14	MV	47259	22470	0	5	1902	20563	10371	10192
CONG14	ED	10792	10918	0	1	1222	9695	5789	3906
CONG14	TO	58051	33388	0	6	3124	30258	16160	14098
ASSM17	MV	232813	115072	0	27	11050	103995	57513	46482
ASSM17	ED	59609	61731	0	10	7878	53843	33478	20365
ASSM17	TO	292422	176803	0	37	18928	157838	90991	66847
ASSM19	MV	170072	82864	0	15	8209	74640	37427	37213
ASSM19	ED	41405	45273	0	7	5825	39441	22875	16566
ASSM19	TO	211477	128137	0	22	14034	114081	60302	53779
SUPV1	MV	33870	16647	0	0	1634	15013	8277	6736
SUPV1	ED	9246	10132	0	1	1257	8874	5512	3362
SUPV1	TO	43116	26779	0	1	2891	23887	13789	10098
SUPV2	MV	41438	20055	0	6	2363	17686	7486	10200
SUPV2	ED	8608	11685	0	2	1863	9820	4725	5095
SUPV2	TO	50046	31740	0	8	4226	27506	12211	15295
SUPV3	MV	31945	14475	0	3	1538	12934	6912	6022
SUPV3	ED	7432	7841	0	3	1182	6656	4001	2655
SUPV3	TO	39377	22316	0	6	2720	19590	10913	8677
SUPV4	MV	35051	16949	0	2	1702	15245	7733	7512
SUPV4	ED	9043	8532	0	3	1022	7507	4555	2952
SUPV4	TO	44094	25481	0	5	2724	22752	12288	10464
SUPV5	MV	41974	21590	0	5	2146	19439	11416	8023
SUPV5	ED	10926	13129	0	1	1717	11411	7366	4045
SUPV5	TO	52900	34719	0	6	3863	30850	18782	12068
SUPV6	MV	35759	15272	0	6	1540	13726	7428	6298
SUPV6	ED	7936	7226	0	2	1093	6131	3832	2299
SUPV6	TO	43695	22498	0	8	2633	19857	11260	8597
SUPV7	MV	38895	20838	0	2	1890	18946	8872	10074
SUPV7	ED	8548	10570	0	1	1201	9368	5118	4250
SUPV7	TO	47443	31408	0	3	3091	28314	13990	14324
SUPV8	MV	46374	27613	0	7	2585	25021	13470	11551
SUPV8	ED	11803	15032	0	0	1821	13211	7889	5322
SUPV8	TO	58177	42645	0	7	4406	38232	21359	16873
SUPV9	MV	33168	16847	0	4	1346	15497	9403	6094
SUPV9	ED	10095	10044	0	3	1070	8971	6091	2880
SUPV9	TO	43263	26891	0	7	2416	24468	15494	8974
SUPV10	MV	33768	14158	0	4	1369	12785	6970	5815
SUPV10	ED	9345	6711	0	0	807	5904	3632	2272
SUPV10	TO	43113	20869	0	4	2176	18689	10602	8087
SUPV11	MV	30643	13492	0	3	1146	12343	6973	5370
SUPV11	ED	8032	6102	0	1	670	5431	3632	1799
SUPV11	TO	38675	19594	0	4	1816	17774	10605	7169
NEIG1	MV	15466	5992	0	1	596	5395	3000	2395
NEIG1	ED	5019	2611	0	0	289	2322	1459	863
NEIG1	TO	20485	8603	0	1	885	7717	4459	3258
NEIG2	MV	14029	6299	0	1	738	5560	2866	2694
NEIG2	ED	3238	3340	0	1	541	2798	1615	1183
NEIG2	TO	17267	9639	0	2	1279	8358	4481	3877
NEIG3	MV	22051	9529	0	4	969	8556	5225	3331
NEIG3	ED	5968	4993	0	1	685	4307	2919	1388
NEIG3	TO	28019	14522	0	5	1654	12863	8144	4719
NEIG4	MV	5630	3506	0	0	335	3171	1591	1580
NEIG4	ED	1430	1651	0	0	211	1440	755	685
NEIG4	TO	7060	5157	0	0	546	4611	2346	2265
NEIG5	MV	22699	10158	0	3	898	9257	5179	4078
NEIG5	ED	5894	4404	0	1	487	3916	2543	1373
NEIG5	TO	28593	14562	0	4	1385	13173	7722	5451
NEIG6	MV	11529	5997	0	1	579	5417	3214	2203
NEIG6	ED	2333	3919	0	1	491	3427	2196	1231
NEIG6	TO	13862	9916	0	2	1070	8844	5410	3434
NEIG7	MV	9819	4151	0	0	316	3835	2217	1618
NEIG7	ED	2576	2089	0	0	224	1865	1308	557
NEIG7	TO	12395	6240	0	0	540	5700	3525	2175
NEIG8	MV	7629	4046	0	0	379	3667	2096	1571
NEIG8	ED	2029	2570	0	0	311	2259	1442	817
NEIG8	TO	9658	6616	0	0	690	5926	3538	2388
NEIG9	MV	7423	3167	0	0	293	2874	1579	1295
NEIG9	ED	835	2238	0	0	306	1932	1338	594
NEIG9	TO	8258	5405	0	0	599	4806	2917	1889
NEIG10	MV	8173	3965	0	1	424	3540	1858	1682
NEIG10	ED	1849	2658	0	1	340	2317	1433	884
NEIG10	TO	10022	6623	0	2	764	5857	3291	2566
NEIG11	MV	33512	15583	0	5	1871	13707	5870	7837
NEIG11	ED	5928	9051	0	2	1502	7547	3650	3897
NEIG11	TO	39440	24634	0	7	3373	21254	9520	11734
NEIG12	MV	23578	11896	0	1	906	10989	6794	4195
NEIG12	ED	7427	7902	0	2	863	7037	4877	2160
NEIG12	TO	31005	19798	0	3	1769	18026	11671	6355
NEIG14	MV	6791	4015	0	2	364	3649	2222	1427
NEIG14	ED	1942	2316	0	1	261	2054	1364	690
NEIG14	TO	8733	6331	0	3	625	5703	3586	2117
NEIG15	MV	5781	2688	0	0	250	2438	1208	1230
NEIG15	ED	1307	1499	0	1	222	1276	721	555
NEIG15	TO	7088	4187	0	1	472	3714	1929	1785
NEIG13	MV	13553	8198	0	5	803	7390	3819	3571
NEIG13	ED	3435	4443	0	0	525	3918	2248	1670
NEIG13	TO	16988	12641	0	5	1328	11308	6067	5241
NEIG26	MV	7830	3542	0	1	304	3237	1710	1527
NEIG26	ED	1802	1386	0	0	159	1227	773	454
NEIG26	TO	9632	4928	0	1	463	4464	2483	1981
NEIG16	MV	14624	6991	0	4	705	6282	3239	3043
NEIG16	ED	2732	3781	0	1	552	3228	1940	1288
NEIG16	TO	17356	10772	0	5	1257	9510	5179	4331
NEIG17	MV	29449	14470	0	0	1424	13046	7211	5835
NEIG17	ED	8176	8551	0	0	1058	7493	4607	2886
NEIG17	TO	37625	23021	0	0	2482	20539	11818	8721
NEIG19	MV	7164	4040	0	0	340	3700	2175	1525
NEIG19	ED	2407	2408	0	0	267	2141	1314	827
NEIG19	TO	9571	6448	0	0	607	5841	3489	2352
NEIG18	MV	6458	3427	0	1	367	3059	1194	1865
NEIG18	ED	1563	2033	0	0	288	1745	814	931
NEIG18	TO	8021	5460	0	1	655	4804	2008	2796
NEIG20	MV	20913	8936	0	3	884	8049	4056	3993
NEIG20	ED	4164	4219	0	1	646	3572	2078	1494
NEIG20	TO	25077	13155	0	4	1530	11621	6134	5487
NEIG21	MV	34608	16722	0	2	1677	15043	7614	7429
NEIG21	ED	8885	8360	0	3	1010	7347	4439	2908
NEIG21	TO	43493	25082	0	5	2687	22390	12053	10337
NEIG22	MV	15383	9330	0	1	856	8473	4584	3889
NEIG22	ED	3510	4904	0	0	581	4323	2625	1698
NEIG22	TO	18893	14234	0	1	1437	12796	7209	5587
NEIG23	MV	6638	2527	0	0	233	2294	1238	1056
NEIG23	ED	1850	947	0	0	110	837	514	323
NEIG23	TO	8488	3474	0	0	343	3131	1752	1379
NEIG24	MV	28440	16178	0	2	1478	14698	6525	8173
NEIG24	ED	6934	7515	0	1	813	6701	3316	3385
NEIG24	TO	35374	23693	0	3	2291	21399	9841	11558
NEIG25	MV	23715	12583	0	4	1270	11309	6656	4653
NEIG25	ED	7781	7216	0	0	961	6255	4065	2190
NEIG25	TO	31496	19799	0	4	2231	17564	10721	6843
