area_id	subtotal_type	RSReg	RSCst	RSRej	RSOvr	RSUnd	RSTot	3:YES	4:NO
ALLPCTS	TO	503899	275013	0	48	20193	254772	182432	72340
ALLPCTS	ED	101053	78221	0	10	5968	72243	55043	17200
ALLPCTS	MV	402846	196792	0	38	14225	182529	127389	55140
PCT1101	MV	448	214	0	0	15	199	127	72
PCT1101	ED	114	60	0	0	3	57	45	12
PCT1101	TO	562	274	0	0	18	256	172	84
PCT1102	MV	774	368	0	0	19	349	228	121
PCT1102	ED	230	159	0	0	10	149	107	42
PCT1102	TO	1004	527	0	0	29	498	335	163
PCT1103	MV	749	371	0	0	19	352	238	114
PCT1103	ED	222	142	0	0	6	136	103	33
PCT1103	TO	971	513	0	0	25	488	341	147
PCT1104	MV	751	343	0	0	13	330	237	93
PCT1104	ED	267	120	0	0	5	115	85	30
PCT1104	TO	1018	463	0	0	18	445	322	123
PCT1106	MV	598	255	0	0	12	243	134	109
PCT1106	ED	173	96	0	0	5	91	68	23
PCT1106	TO	771	351	0	0	17	334	202	132
PCT1107	MV	612	287	0	0	17	270	171	99
PCT1107	ED	139	76	0	0	5	71	53	18
PCT1107	TO	751	363	0	0	22	341	224	117
PCT1108	MV	725	360	0	0	21	339	234	105
PCT1108	ED	198	115	0	0	12	103	73	30
PCT1108	TO	923	475	0	0	33	442	307	135
PCT1109	MV	653	284	0	0	14	270	158	112
PCT1109	ED	169	97	0	0	4	93	71	22
PCT1109	TO	822	381	0	0	18	363	229	134
PCT1111	MV	849	354	0	0	18	336	201	135
PCT1111	ED	197	118	0	0	4	114	91	23
PCT1111	TO	1046	472	0	0	22	450	292	158
PCT1112	MV	643	276	0	0	15	261	176	85
PCT1112	ED	159	77	0	0	4	73	58	15
PCT1112	TO	802	353	0	0	19	334	234	100
PCT1113	MV	675	286	0	0	13	273	174	99
PCT1113	ED	120	65	0	0	6	59	44	15
PCT1113	TO	795	351	0	0	19	332	218	114
PCT1114	MV	769	328	0	0	22	306	224	82
PCT1114	ED	222	97	0	0	10	87	72	15
PCT1114	TO	991	425	0	0	32	393	296	97
PCT1115	MV	743	295	0	0	15	280	177	103
PCT1115	ED	193	86	0	0	3	83	68	15
PCT1115	TO	936	381	0	0	18	363	245	118
PCT1116	MV	715	308	0	0	17	291	185	106
PCT1116	ED	216	118	0	0	6	112	95	17
PCT1116	TO	931	426	0	0	23	403	280	123
PCT1117	MV	665	257	0	0	14	243	163	80
PCT1117	ED	181	71	0	0	2	69	53	16
PCT1117	TO	846	328	0	0	16	312	216	96
PCT1118	MV	846	356	0	1	10	345	219	126
PCT1118	ED	219	104	0	0	9	95	67	28
PCT1118	TO	1065	460	0	1	19	440	286	154
PCT1119	MV	659	303	0	0	11	292	203	89
PCT1119	ED	138	74	0	0	4	70	59	11
PCT1119	TO	797	377	0	0	15	362	262	100
PCT1121	MV	556	268	0	0	21	247	139	108
PCT1121	ED	149	82	0	0	6	76	48	28
PCT1121	TO	705	350	0	0	27	323	187	136
PCT1122	MV	519	245	0	0	18	227	117	110
PCT1122	ED	118	71	0	0	4	67	51	16
PCT1122	TO	637	316	0	0	22	294	168	126
PCT1123	MV	730	257	0	1	10	246	169	77
PCT1123	ED	208	89	0	0	6	83	66	17
PCT1123	TO	938	346	0	1	16	329	235	94
PCT1124	MV	630	246	0	2	7	237	146	91
PCT1124	ED	199	73	0	0	3	70	59	11
PCT1124	TO	829	319	0	2	10	307	205	102
PCT1125	MV	919	364	0	1	27	336	193	143
PCT1125	ED	178	67	0	0	7	60	49	11
PCT1125	TO	1097	431	0	1	34	396	242	154
PCT1126	MV	812	308	0	0	15	293	210	83
PCT1126	ED	200	68	0	0	3	65	49	16
PCT1126	TO	1012	376	0	0	18	358	259	99
PCT1127	MV	743	293	0	0	10	283	153	130
PCT1127	ED	222	100	0	0	3	97	69	28
PCT1127	TO	965	393	0	0	13	380	222	158
PCT1128	MV	734	286	0	0	12	274	152	122
PCT1128	ED	145	59	0	0	4	55	41	14
PCT1128	TO	879	345	0	0	16	329	193	136
PCT1129	MV	790	314	0	0	21	293	173	120
PCT1129	ED	246	108	0	0	13	95	68	27
PCT1129	TO	1036	422	0	0	34	388	241	147
PCT1131	MV	694	279	0	0	25	254	141	113
PCT1131	ED	166	60	0	0	4	56	46	10
PCT1131	TO	860	339	0	0	29	310	187	123
PCT1132	MV	839	370	0	0	27	343	214	129
PCT1132	ED	193	59	0	0	0	59	29	30
PCT1132	TO	1032	429	0	0	27	402	243	159
PCT1133	MV	716	334	0	0	9	325	208	117
PCT1133	ED	159	74	0	0	3	71	48	23
PCT1133	TO	875	408	0	0	12	396	256	140
PCT1134	MV	585	292	0	0	9	283	153	130
PCT1134	ED	182	80	0	0	8	72	61	11
PCT1134	TO	767	372	0	0	17	355	214	141
PCT1135	MV	465	218	0	0	6	212	129	83
PCT1135	ED	91	51	0	0	1	50	33	17
PCT1135	TO	556	269	0	0	7	262	162	100
PCT1136	MV	710	340	0	0	15	325	199	126
PCT1136	ED	157	77	0	0	9	68	51	17
PCT1136	TO	867	417	0	0	24	393	250	143
PCT1141	MV	836	392	0	0	21	371	237	134
PCT1141	ED	220	123	0	0	3	120	87	33
PCT1141	TO	1056	515	0	0	24	491	324	167
PCT1142	MV	721	324	0	0	27	297	201	96
PCT1142	ED	175	87	0	0	3	84	72	12
PCT1142	TO	896	411	0	0	30	381	273	108
PCT1143	MV	824	360	0	0	26	334	226	108
PCT1143	ED	225	114	0	0	6	108	89	19
PCT1143	TO	1049	474	0	0	32	442	315	127
PCT1144	MV	727	326	0	0	12	314	201	113
PCT1144	ED	220	121	0	0	10	111	80	31
PCT1144	TO	947	447	0	0	22	425	281	144
PCT1145	MV	753	411	0	0	25	386	251	135
PCT1145	ED	152	114	0	0	5	109	79	30
PCT1145	TO	905	525	0	0	30	495	330	165
PCT1146	MV	839	364	0	0	17	347	243	104
PCT1146	ED	215	110	0	0	6	104	80	24
PCT1146	TO	1054	474	0	0	23	451	323	128
PCT1147	MV	673	309	0	0	13	296	198	98
PCT1147	ED	212	107	0	0	5	102	76	26
PCT1147	TO	885	416	0	0	18	398	274	124
PCT1148	MV	804	367	0	0	18	349	210	139
PCT1148	ED	224	116	0	0	6	110	82	28
PCT1148	TO	1028	483	0	0	24	459	292	167
PCT1149	MV	710	319	0	0	23	296	191	105
PCT1149	ED	229	118	0	0	9	109	80	29
PCT1149	TO	939	437	0	0	32	405	271	134
PCT1151	MV	0	0	0	0	0	0	0	0
PCT1151	ED	0	0	0	0	0	0	0	0
PCT1151	TO	0	0	0	0	0	0	0	0
PCT1152	MV	710	312	0	0	19	293	208	85
PCT1152	ED	180	85	0	0	6	79	58	21
PCT1152	TO	890	397	0	0	25	372	266	106
PCT1153	MV	730	285	0	0	18	267	185	82
PCT1153	ED	210	117	0	0	7	110	64	46
PCT1153	TO	940	402	0	0	25	377	249	128
PCT1154	MV	0	0	0	0	0	0	0	0
PCT1154	ED	0	0	0	0	0	0	0	0
PCT1154	TO	0	0	0	0	0	0	0	0
PCT7001	MV	632	328	0	0	21	307	229	78
PCT7001	ED	141	103	0	0	7	96	82	14
PCT7001	TO	773	431	0	0	28	403	311	92
PCT7002	MV	598	267	0	1	23	243	177	66
PCT7002	ED	116	88	0	0	5	83	68	15
PCT7002	TO	714	355	0	1	28	326	245	81
PCT7003	MV	759	430	0	0	29	401	298	103
PCT7003	ED	147	144	0	0	12	132	99	33
PCT7003	TO	906	574	0	0	41	533	397	136
PCT7004	MV	764	416	0	0	30	386	288	98
PCT7004	ED	149	143	0	0	12	131	104	27
PCT7004	TO	913	559	0	0	42	517	392	125
PCT7005	MV	698	350	0	0	26	324	252	72
PCT7005	ED	161	162	0	0	20	142	116	26
PCT7005	TO	859	512	0	0	46	466	368	98
PCT7006	MV	729	359	0	0	27	332	258	74
PCT7006	ED	203	149	0	0	7	142	113	29
PCT7006	TO	932	508	0	0	34	474	371	103
PCT7007	MV	777	437	0	0	36	401	285	116
PCT7007	ED	180	169	0	0	14	155	126	29
PCT7007	TO	957	606	0	0	50	556	411	145
PCT7008	MV	732	367	0	0	42	325	235	90
PCT7008	ED	177	192	0	0	12	180	139	41
PCT7008	TO	909	559	0	0	54	505	374	131
PCT7009	MV	752	389	0	0	23	366	266	100
PCT7009	ED	119	91	0	0	4	87	58	29
PCT7009	TO	871	480	0	0	27	453	324	129
PCT7011	MV	704	231	0	0	16	215	160	55
PCT7011	ED	269	87	0	0	4	83	67	16
PCT7011	TO	973	318	0	0	20	298	227	71
PCT7012	MV	999	487	0	0	35	452	339	113
PCT7012	ED	227	206	0	0	17	189	152	37
PCT7012	TO	1226	693	0	0	52	641	491	150
PCT7013	MV	984	280	0	0	19	261	197	64
PCT7013	ED	155	151	0	0	15	136	114	22
PCT7013	TO	1139	431	0	0	34	397	311	86
PCT7014	MV	610	298	0	0	30	268	214	54
PCT7014	ED	109	112	0	0	16	96	81	15
PCT7014	TO	719	410	0	0	46	364	295	69
PCT7015	MV	128	40	0	0	4	36	32	4
PCT7015	ED	-18	0	0	0	0	0	0	0
PCT7015	TO	110	40	0	0	4	36	32	4
PCT7016	MV	655	238	0	0	16	222	147	75
PCT7016	ED	277	75	0	0	6	69	55	14
PCT7016	TO	932	313	0	0	22	291	202	89
PCT7017	MV	543	180	0	0	15	165	128	37
PCT7017	ED	238	53	0	0	6	47	42	5
PCT7017	TO	781	233	0	0	21	212	170	42
PCT7018	MV	847	357	0	0	23	334	207	127
PCT7018	ED	200	56	0	0	4	52	47	5
PCT7018	TO	1047	413	0	0	27	386	254	132
PCT7019	MV	734	355	0	0	23	332	212	120
PCT7019	ED	166	74	0	0	8	66	55	11
PCT7019	TO	900	429	0	0	31	398	267	131
PCT7021	MV	679	271	0	0	15	256	198	58
PCT7021	ED	288	106	0	0	7	99	86	13
PCT7021	TO	967	377	0	0	22	355	284	71
PCT7022	MV	770	311	0	1	22	288	223	65
PCT7022	ED	193	55	0	0	1	54	45	9
PCT7022	TO	963	366	0	1	23	342	268	74
PCT7023	MV	687	331	0	0	18	313	235	78
PCT7023	ED	233	71	0	0	5	66	54	12
PCT7023	TO	920	402	0	0	23	379	289	90
PCT7024	MV	251	50	0	0	2	48	43	5
PCT7024	ED	190	20	0	0	3	17	17	0
PCT7024	TO	441	70	0	0	5	65	60	5
PCT7025	MV	316	95	0	0	4	91	76	15
PCT7025	ED	167	39	0	0	1	38	32	6
PCT7025	TO	483	134	0	0	5	129	108	21
PCT7026	MV	819	336	0	0	14	322	169	153
PCT7026	ED	191	72	0	0	3	69	54	15
PCT7026	TO	1010	408	0	0	17	391	223	168
PCT7027	MV	677	270	0	0	14	256	163	93
PCT7027	ED	219	96	0	0	4	92	73	19
PCT7027	TO	896	366	0	0	18	348	236	112
PCT7028	MV	585	220	0	0	17	203	157	46
PCT7028	ED	271	97	0	0	5	92	75	17
PCT7028	TO	856	317	0	0	22	295	232	63
PCT7029	MV	642	208	0	0	15	193	150	43
PCT7029	ED	267	39	0	0	1	38	31	7
PCT7029	TO	909	247	0	0	16	231	181	50
PCT7030	MV	654	274	0	0	11	263	146	117
PCT7030	ED	141	58	0	0	3	55	30	25
PCT7030	TO	795	332	0	0	14	318	176	142
PCT7031	MV	622	263	0	0	24	239	155	84
PCT7031	ED	72	48	0	0	4	44	32	12
PCT7031	TO	694	311	0	0	28	283	187	96
PCT7032	MV	643	266	0	0	18	248	176	72
PCT7032	ED	238	53	0	0	3	50	42	8
PCT7032	TO	881	319	0	0	21	298	218	80
PCT7033	MV	549	214	0	0	17	197	138	59
PCT7033	ED	229	86	0	0	5	81	63	18
PCT7033	TO	778	300	0	0	22	278	201	77
PCT7034	MV	620	140	0	0	15	125	112	13
PCT7034	ED	318	58	0	0	3	55	48	7
PCT7034	TO	938	198	0	0	18	180	160	20
PCT7035	MV	567	237	0	0	20	217	151	66
PCT7035	ED	152	52	0	0	5	47	39	8
PCT7035	TO	719	289	0	0	25	264	190	74
PCT7036	MV	781	262	0	0	16	246	160	86
PCT7036	ED	193	39	0	0	1	38	28	10
PCT7036	TO	974	301	0	0	17	284	188	96
PCT7037	MV	434	63	0	0	0	63	50	13
PCT7037	ED	312	38	0	0	5	33	32	1
PCT7037	TO	746	101	0	0	5	96	82	14
PCT7038	MV	758	308	0	0	16	292	175	117
PCT7038	ED	203	58	0	0	8	50	39	11
PCT7038	TO	961	366	0	0	24	342	214	128
PCT7039	MV	636	243	0	0	16	227	127	100
PCT7039	ED	201	104	0	0	5	99	63	36
PCT7039	TO	837	347	0	0	21	326	190	136
PCT7041	MV	70	29	0	0	3	26	16	10
PCT7041	ED	-4	0	0	0	0	0	0	0
PCT7041	TO	66	29	0	0	3	26	16	10
PCT7042	MV	514	221	0	0	11	210	143	67
PCT7042	ED	146	59	0	0	2	57	42	15
PCT7042	TO	660	280	0	0	13	267	185	82
PCT7043	MV	754	295	0	0	22	273	178	95
PCT7043	ED	224	78	0	0	1	77	53	24
PCT7043	TO	978	373	0	0	23	350	231	119
PCT7044	MV	586	148	0	0	4	144	105	39
PCT7044	ED	266	33	0	0	2	31	26	5
PCT7044	TO	852	181	0	0	6	175	131	44
PCT7045	MV	632	266	0	0	16	250	146	104
PCT7045	ED	154	53	0	0	3	50	36	14
PCT7045	TO	786	319	0	0	19	300	182	118
PCT7046	MV	334	132	0	0	9	123	74	49
PCT7046	ED	96	48	0	0	3	45	34	11
PCT7046	TO	430	180	0	0	12	168	108	60
PCT7047	MV	733	314	0	0	12	302	177	125
PCT7047	ED	150	62	0	0	3	59	46	13
PCT7047	TO	883	376	0	0	15	361	223	138
PCT7048	MV	685	267	0	0	15	252	177	75
PCT7048	ED	196	56	0	0	4	52	41	11
PCT7048	TO	881	323	0	0	19	304	218	86
PCT7049	MV	616	247	0	0	14	233	132	101
PCT7049	ED	210	70	0	0	10	60	39	21
PCT7049	TO	826	317	0	0	24	293	171	122
PCT7051	MV	715	306	0	0	22	284	154	130
PCT7051	ED	165	70	0	0	6	64	45	19
PCT7051	TO	880	376	0	0	28	348	199	149
PCT7052	MV	722	296	0	0	12	284	155	129
PCT7052	ED	184	84	0	0	3	81	65	16
PCT7052	TO	906	380	0	0	15	365	220	145
PCT7053	MV	542	227	0	0	31	196	101	95
PCT7053	ED	43	42	0	0	4	38	29	9
PCT7053	TO	585	269	0	0	35	234	130	104
PCT7054	MV	863	308	0	0	20	288	219	69
PCT7054	ED	273	106	0	0	3	103	72	31
PCT7054	TO	1136	414	0	0	23	391	291	100
PCT7055	MV	732	291	0	0	21	270	182	88
PCT7055	ED	94	77	0	0	8	69	53	16
PCT7055	TO	826	368	0	0	29	339	235	104
PCT7056	MV	618	273	0	0	23	250	182	68
PCT7056	ED	87	119	0	0	12	107	83	24
PCT7056	TO	705	392	0	0	35	357	265	92
PCT7101	MV	162	99	0	0	6	93	84	9
PCT7101	ED	-15	4	0	0	1	3	3	0
PCT7101	TO	147	103	0	0	7	96	87	9
PCT7201	MV	788	383	0	0	32	351	225	126
PCT7201	ED	147	168	0	0	23	145	110	35
PCT7201	TO	935	551	0	0	55	496	335	161
PCT7202	MV	708	308	0	0	30	278	181	97
PCT7202	ED	143	156	0	0	17	139	103	36
PCT7202	TO	851	464	0	0	47	417	284	133
PCT7203	MV	693	321	0	0	37	284	185	99
PCT7203	ED	186	186	0	0	22	164	116	48
PCT7203	TO	879	507	0	0	59	448	301	147
PCT7204	MV	773	421	0	0	48	373	264	109
PCT7204	ED	126	122	0	0	19	103	72	31
PCT7204	TO	899	543	0	0	67	476	336	140
PCT7205	MV	724	360	0	1	26	333	224	109
PCT7205	ED	147	175	0	0	17	158	114	44
PCT7205	TO	871	535	0	1	43	491	338	153
PCT7206	MV	299	129	0	0	8	121	83	38
PCT7206	ED	78	102	0	0	12	90	62	28
PCT7206	TO	377	231	0	0	20	211	145	66
PCT7207	MV	744	333	0	0	28	305	197	108
PCT7207	ED	123	151	0	0	14	137	104	33
PCT7207	TO	867	484	0	0	42	442	301	141
PCT7208	MV	492	253	0	0	28	225	155	70
PCT7208	ED	78	94	0	0	11	83	74	9
PCT7208	TO	570	347	0	0	39	308	229	79
PCT7209	MV	595	341	0	0	27	314	218	96
PCT7209	ED	52	75	0	0	7	68	54	14
PCT7209	TO	647	416	0	0	34	382	272	110
PCT7301	MV	813	317	0	0	21	296	208	88
PCT7301	ED	201	141	0	0	13	128	92	36
PCT7301	TO	1014	458	0	0	34	424	300	124
PCT7302	MV	713	351	0	0	28	323	218	105
PCT7302	ED	136	137	0	0	13	124	91	33
PCT7302	TO	849	488	0	0	41	447	309	138
PCT7303	MV	869	376	0	0	24	352	240	112
PCT7303	ED	199	155	0	0	12	143	118	25
PCT7303	TO	1068	531	0	0	36	495	358	137
PCT7304	MV	802	366	0	0	29	337	223	114
PCT7304	ED	199	184	0	0	14	170	130	40
PCT7304	TO	1001	550	0	0	43	507	353	154
PCT7305	MV	713	386	0	0	28	358	216	142
PCT7305	ED	154	154	0	0	10	144	104	40
PCT7305	TO	867	540	0	0	38	502	320	182
PCT7306	MV	801	373	0	0	47	326	196	130
PCT7306	ED	243	193	0	0	25	168	129	39
PCT7306	TO	1044	566	0	0	72	494	325	169
PCT7307	MV	605	272	0	0	15	257	172	85
PCT7307	ED	169	126	0	1	16	109	85	24
PCT7307	TO	774	398	0	1	31	366	257	109
PCT7308	MV	520	256	0	0	12	244	165	79
PCT7308	ED	105	157	0	1	12	144	112	32
PCT7308	TO	625	413	0	1	24	388	277	111
PCT7309	MV	691	324	0	0	33	291	200	91
PCT7309	ED	167	190	0	0	15	175	135	40
PCT7309	TO	858	514	0	0	48	466	335	131
PCT7311	MV	698	333	0	0	28	305	217	88
PCT7311	ED	208	215	0	0	20	195	151	44
PCT7311	TO	906	548	0	0	48	500	368	132
PCT7312	MV	700	394	0	0	30	364	233	131
PCT7312	ED	110	160	0	0	18	142	98	44
PCT7312	TO	810	554	0	0	48	506	331	175
PCT7313	MV	819	373	0	0	24	349	228	121
PCT7313	ED	184	160	0	0	24	136	100	36
PCT7313	TO	1003	533	0	0	48	485	328	157
PCT7314	MV	612	226	0	0	25	201	139	62
PCT7314	ED	147	83	0	0	10	73	58	15
PCT7314	TO	759	309	0	0	35	274	197	77
PCT7315	MV	570	206	0	0	14	192	129	63
PCT7315	ED	195	134	0	0	8	126	99	27
PCT7315	TO	765	340	0	0	22	318	228	90
PCT7316	MV	654	261	0	0	29	232	159	73
PCT7316	ED	178	130	0	0	18	112	88	24
PCT7316	TO	832	391	0	0	47	344	247	97
PCT7317	MV	744	348	0	1	23	324	210	114
PCT7317	ED	146	111	0	0	14	97	82	15
PCT7317	TO	890	459	0	1	37	421	292	129
PCT7318	MV	605	293	0	0	35	258	170	88
PCT7318	ED	118	106	0	0	19	87	53	34
PCT7318	TO	723	399	0	0	54	345	223	122
PCT7319	MV	861	344	0	0	25	319	215	104
PCT7319	ED	188	180	0	1	23	156	110	46
PCT7319	TO	1049	524	0	1	48	475	325	150
PCT7321	MV	557	202	0	0	19	183	113	70
PCT7321	ED	102	84	0	0	8	76	58	18
PCT7321	TO	659	286	0	0	27	259	171	88
PCT7322	MV	742	294	0	0	34	260	181	79
PCT7322	ED	146	49	0	0	8	41	37	4
PCT7322	TO	888	343	0	0	42	301	218	83
PCT7323	MV	790	368	0	0	43	325	221	104
PCT7323	ED	166	157	0	0	18	139	108	31
PCT7323	TO	956	525	0	0	61	464	329	135
PCT7324	MV	587	259	0	0	29	230	156	74
PCT7324	ED	150	89	0	0	10	79	50	29
PCT7324	TO	737	348	0	0	39	309	206	103
PCT7325	MV	714	326	0	0	36	290	200	90
PCT7325	ED	172	123	0	0	11	112	82	30
PCT7325	TO	886	449	0	0	47	402	282	120
PCT7326	MV	685	303	0	0	28	275	190	85
PCT7326	ED	174	155	0	1	25	129	94	35
PCT7326	TO	859	458	0	1	53	404	284	120
PCT7327	MV	561	230	0	0	27	203	132	71
PCT7327	ED	126	49	0	0	2	47	39	8
PCT7327	TO	687	279	0	0	29	250	171	79
PCT7328	MV	829	333	0	0	54	279	180	99
PCT7328	ED	173	67	0	0	12	55	43	12
PCT7328	TO	1002	400	0	0	66	334	223	111
PCT7329	MV	556	227	0	0	24	203	141	62
PCT7329	ED	95	76	0	0	6	70	51	19
PCT7329	TO	651	303	0	0	30	273	192	81
PCT7331	MV	710	360	0	0	33	327	223	104
PCT7331	ED	160	158	0	0	21	137	99	38
PCT7331	TO	870	518	0	0	54	464	322	142
PCT7332	MV	654	262	0	0	22	240	182	58
PCT7332	ED	136	147	0	0	9	138	116	22
PCT7332	TO	790	409	0	0	31	378	298	80
PCT7333	MV	822	389	0	0	39	350	244	106
PCT7333	ED	193	219	0	0	17	202	158	44
PCT7333	TO	1015	608	0	0	56	552	402	150
PCT7334	MV	688	306	0	0	18	288	223	65
PCT7334	ED	131	131	0	0	11	120	97	23
PCT7334	TO	819	437	0	0	29	408	320	88
PCT7335	MV	788	389	0	0	39	350	226	124
PCT7335	ED	146	189	0	0	18	171	138	33
PCT7335	TO	934	578	0	0	57	521	364	157
PCT7336	MV	779	404	0	1	27	376	227	149
PCT7336	ED	175	174	0	0	21	153	110	43
PCT7336	TO	954	578	0	1	48	529	337	192
PCT7337	MV	772	386	0	0	41	345	230	115
PCT7337	ED	125	111	0	0	6	105	78	27
PCT7337	TO	897	497	0	0	47	450	308	142
PCT7338	MV	770	360	0	0	40	320	205	115
PCT7338	ED	125	90	0	0	9	81	67	14
PCT7338	TO	895	450	0	0	49	401	272	129
PCT7339	MV	605	270	0	0	24	246	187	59
PCT7339	ED	150	122	0	0	5	117	88	29
PCT7339	TO	755	392	0	0	29	363	275	88
PCT7341	MV	675	291	0	1	32	258	188	70
PCT7341	ED	178	159	0	0	10	149	121	28
PCT7341	TO	853	450	0	1	42	407	309	98
PCT7342	MV	674	323	0	0	19	304	233	71
PCT7342	ED	230	238	0	0	22	216	167	49
PCT7342	TO	904	561	0	0	41	520	400	120
PCT7343	MV	554	251	0	0	21	230	197	33
PCT7343	ED	150	146	0	0	16	130	110	20
PCT7343	TO	704	397	0	0	37	360	307	53
PCT7344	MV	863	392	0	0	28	364	265	99
PCT7344	ED	201	161	0	0	9	152	108	44
PCT7344	TO	1064	553	0	0	37	516	373	143
PCT7345	MV	904	432	0	0	36	396	302	94
PCT7345	ED	210	214	0	0	17	197	158	39
PCT7345	TO	1114	646	0	0	53	593	460	133
PCT7346	MV	681	288	0	0	20	268	208	60
PCT7346	ED	208	169	0	0	17	152	126	26
PCT7346	TO	889	457	0	0	37	420	334	86
PCT7347	MV	833	370	0	1	36	333	293	40
PCT7347	ED	170	109	0	0	6	103	88	15
PCT7347	TO	1003	479	0	1	42	436	381	55
PCT7348	MV	650	279	0	0	22	257	199	58
PCT7348	ED	193	115	0	0	9	106	85	21
PCT7348	TO	843	394	0	0	31	363	284	79
PCT7349	MV	710	315	0	0	23	292	204	88
PCT7349	ED	202	143	0	0	15	128	104	24
PCT7349	TO	912	458	0	0	38	420	308	112
PCT7501	MV	456	248	0	0	28	220	140	80
PCT7501	ED	95	116	0	0	13	103	70	33
PCT7501	TO	551	364	0	0	41	323	210	113
PCT7502	MV	668	314	0	0	27	287	206	81
PCT7502	ED	121	135	0	0	17	118	89	29
PCT7502	TO	789	449	0	0	44	405	295	110
PCT7503	MV	614	286	0	0	24	262	203	59
PCT7503	ED	148	134	0	0	19	115	91	24
PCT7503	TO	762	420	0	0	43	377	294	83
PCT7504	MV	404	175	0	0	15	160	127	33
PCT7504	ED	84	57	0	0	5	52	39	13
PCT7504	TO	488	232	0	0	20	212	166	46
PCT7505	MV	729	405	0	0	35	370	293	77
PCT7505	ED	133	96	0	0	3	93	77	16
PCT7505	TO	862	501	0	0	38	463	370	93
PCT7506	MV	842	363	0	0	41	322	240	82
PCT7506	ED	158	117	0	0	11	106	91	15
PCT7506	TO	1000	480	0	0	52	428	331	97
PCT7507	MV	694	289	0	0	20	269	223	46
PCT7507	ED	262	102	0	0	5	97	85	12
PCT7507	TO	956	391	0	0	25	366	308	58
PCT7508	MV	618	373	0	0	38	335	247	88
PCT7508	ED	126	106	0	0	7	99	83	16
PCT7508	TO	744	479	0	0	45	434	330	104
PCT7509	MV	756	399	0	0	28	371	278	93
PCT7509	ED	173	148	0	0	10	138	109	29
PCT7509	TO	929	547	0	0	38	509	387	122
PCT7512	MV	475	248	0	0	21	227	163	64
PCT7512	ED	125	86	0	0	9	77	63	14
PCT7512	TO	600	334	0	0	30	304	226	78
PCT7513	MV	575	248	0	0	25	223	185	38
PCT7513	ED	231	112	0	0	13	99	86	13
PCT7513	TO	806	360	0	0	38	322	271	51
PCT7514	MV	709	242	0	0	28	214	165	49
PCT7514	ED	207	61	0	0	12	49	44	5
PCT7514	TO	916	303	0	0	40	263	209	54
PCT7515	MV	663	321	0	0	21	300	216	84
PCT7515	ED	201	90	0	0	11	79	69	10
PCT7515	TO	864	411	0	0	32	379	285	94
PCT7516	MV	773	423	0	0	23	400	297	103
PCT7516	ED	147	118	0	0	3	115	85	30
PCT7516	TO	920	541	0	0	26	515	382	133
PCT7517	MV	645	362	0	0	34	328	261	67
PCT7517	ED	223	179	0	0	9	170	141	29
PCT7517	TO	868	541	0	0	43	498	402	96
PCT7518	MV	708	392	0	0	30	362	279	83
PCT7518	ED	218	186	0	0	14	172	150	22
PCT7518	TO	926	578	0	0	44	534	429	105
PCT7519	MV	543	259	0	0	28	231	188	43
PCT7519	ED	172	136	0	0	7	129	106	23
PCT7519	TO	715	395	0	0	35	360	294	66
PCT7521	MV	597	318	0	1	23	294	246	48
PCT7521	ED	182	149	0	0	4	145	121	24
PCT7521	TO	779	467	0	1	27	439	367	72
PCT7522	MV	588	301	0	0	23	278	230	48
PCT7522	ED	171	159	0	0	14	145	125	20
PCT7522	TO	759	460	0	0	37	423	355	68
PCT7523	MV	564	285	0	0	28	257	212	45
PCT7523	ED	180	169	0	0	8	161	130	31
PCT7523	TO	744	454	0	0	36	418	342	76
PCT7524	MV	480	228	0	0	26	202	173	29
PCT7524	ED	144	102	0	0	7	95	81	14
PCT7524	TO	624	330	0	0	33	297	254	43
PCT7525	MV	594	246	0	0	23	223	177	46
PCT7525	ED	170	96	0	0	8	88	82	6
PCT7525	TO	764	342	0	0	31	311	259	52
PCT7526	MV	826	395	0	0	45	350	287	63
PCT7526	ED	162	149	0	0	15	134	106	28
PCT7526	TO	988	544	0	0	60	484	393	91
PCT7527	MV	538	296	0	0	27	269	210	59
PCT7527	ED	172	113	0	0	4	109	89	20
PCT7527	TO	710	409	0	0	31	378	299	79
PCT7529	MV	749	366	0	0	20	346	295	51
PCT7529	ED	154	187	0	0	7	180	154	26
PCT7529	TO	903	553	0	0	27	526	449	77
PCT7531	MV	714	336	0	0	25	311	261	50
PCT7531	ED	159	135	0	0	4	131	107	24
PCT7531	TO	873	471	0	0	29	442	368	74
PCT7532	MV	668	328	0	0	29	299	231	68
PCT7532	ED	167	139	0	0	13	126	89	37
PCT7532	TO	835	467	0	0	42	425	320	105
PCT7533	MV	776	405	0	0	32	373	306	67
PCT7533	ED	194	189	0	0	19	170	144	26
PCT7533	TO	970	594	0	0	51	543	450	93
PCT7534	MV	670	375	0	0	34	341	266	75
PCT7534	ED	233	187	0	0	18	169	155	14
PCT7534	TO	903	562	0	0	52	510	421	89
PCT7535	MV	606	300	0	0	23	277	220	57
PCT7535	ED	139	162	0	0	18	144	128	16
PCT7535	TO	745	462	0	0	41	421	348	73
PCT7536	MV	670	346	0	0	21	325	267	58
PCT7536	ED	163	172	0	0	15	157	134	23
PCT7536	TO	833	518	0	0	36	482	401	81
PCT7537	MV	619	301	0	0	23	278	214	64
PCT7537	ED	126	150	0	1	9	140	116	24
PCT7537	TO	745	451	0	1	32	418	330	88
PCT7538	MV	562	321	0	0	20	301	243	58
PCT7538	ED	189	175	0	0	18	157	133	24
PCT7538	TO	751	496	0	0	38	458	376	82
PCT7539	MV	696	374	0	0	24	350	295	55
PCT7539	ED	225	195	0	0	11	184	162	22
PCT7539	TO	921	569	0	0	35	534	457	77
PCT7541	MV	600	295	0	0	29	266	209	57
PCT7541	ED	170	164	0	0	16	148	124	24
PCT7541	TO	770	459	0	0	45	414	333	81
PCT7542	MV	632	323	0	0	17	306	252	54
PCT7542	ED	192	171	0	0	6	165	138	27
PCT7542	TO	824	494	0	0	23	471	390	81
PCT7543	MV	694	371	0	0	16	355	290	65
PCT7543	ED	230	141	0	0	7	134	109	25
PCT7543	TO	924	512	0	0	23	489	399	90
PCT7544	MV	731	389	0	0	37	352	284	68
PCT7544	ED	168	164	0	0	17	147	122	25
PCT7544	TO	899	553	0	0	54	499	406	93
PCT7545	MV	723	384	0	0	26	358	288	70
PCT7545	ED	172	149	0	0	10	139	119	20
PCT7545	TO	895	533	0	0	36	497	407	90
PCT7546	MV	770	417	0	0	21	396	333	63
PCT7546	ED	183	219	0	0	17	202	164	38
PCT7546	TO	953	636	0	0	38	598	497	101
PCT7547	MV	798	426	0	0	33	393	335	58
PCT7547	ED	183	180	0	0	9	171	155	16
PCT7547	TO	981	606	0	0	42	564	490	74
PCT7548	MV	802	447	0	0	25	422	353	69
PCT7548	ED	249	204	0	0	11	193	163	30
PCT7548	TO	1051	651	0	0	36	615	516	99
PCT7549	MV	660	357	0	0	32	325	255	70
PCT7549	ED	146	143	0	0	16	127	106	21
PCT7549	TO	806	500	0	0	48	452	361	91
PCT7551	MV	587	303	0	0	18	285	228	57
PCT7551	ED	136	175	0	0	11	164	128	36
PCT7551	TO	723	478	0	0	29	449	356	93
PCT7552	MV	561	285	0	0	24	261	216	45
PCT7552	ED	124	130	0	0	12	118	99	19
PCT7552	TO	685	415	0	0	36	379	315	64
PCT7553	MV	211	95	0	0	7	88	69	19
PCT7553	ED	-20	0	0	0	0	0	0	0
PCT7553	TO	191	95	0	0	7	88	69	19
PCT7554	MV	653	381	0	0	29	352	266	86
PCT7554	ED	168	180	0	0	15	165	122	43
PCT7554	TO	821	561	0	0	44	517	388	129
PCT7555	MV	662	416	0	0	34	382	303	79
PCT7555	ED	210	210	0	0	15	195	162	33
PCT7555	TO	872	626	0	0	49	577	465	112
PCT7556	MV	812	512	0	0	29	483	366	117
PCT7556	ED	154	168	0	0	14	154	116	38
PCT7556	TO	966	680	0	0	43	637	482	155
PCT7601	MV	485	207	0	0	14	193	159	34
PCT7601	ED	192	91	0	0	10	81	68	13
PCT7601	TO	677	298	0	0	24	274	227	47
PCT7602	MV	654	276	0	0	20	256	218	38
PCT7602	ED	232	104	0	0	8	96	84	12
PCT7602	TO	886	380	0	0	28	352	302	50
PCT7603	MV	615	295	0	0	28	267	227	40
PCT7603	ED	200	168	0	0	10	158	133	25
PCT7603	TO	815	463	0	0	38	425	360	65
PCT7604	MV	685	270	0	0	18	252	213	39
PCT7604	ED	259	135	0	0	14	121	95	26
PCT7604	TO	944	405	0	0	32	373	308	65
PCT7605	MV	468	191	0	1	17	173	141	32
PCT7605	ED	193	62	0	0	5	57	50	7
PCT7605	TO	661	253	0	1	22	230	191	39
PCT7606	MV	673	267	0	0	27	240	195	45
PCT7606	ED	210	80	0	0	6	74	67	7
PCT7606	TO	883	347	0	0	33	314	262	52
PCT7607	MV	712	288	0	0	23	265	208	57
PCT7607	ED	207	101	0	0	5	96	81	15
PCT7607	TO	919	389	0	0	28	361	289	72
PCT7608	MV	279	96	0	0	9	87	64	23
PCT7608	ED	101	19	0	0	1	18	16	2
PCT7608	TO	380	115	0	0	10	105	80	25
PCT7609	MV	699	286	0	0	31	255	204	51
PCT7609	ED	185	49	0	1	3	45	38	7
PCT7609	TO	884	335	0	1	34	300	242	58
PCT7611	MV	586	235	0	0	15	220	188	32
PCT7611	ED	202	43	0	0	1	42	36	6
PCT7611	TO	788	278	0	0	16	262	224	38
PCT7612	MV	452	216	0	0	10	206	157	49
PCT7612	ED	105	31	0	0	1	30	22	8
PCT7612	TO	557	247	0	0	11	236	179	57
PCT7613	MV	634	244	0	0	17	227	194	33
PCT7613	ED	249	89	0	0	5	84	76	8
PCT7613	TO	883	333	0	0	22	311	270	41
PCT7614	MV	713	253	0	0	22	231	193	38
PCT7614	ED	203	81	0	0	4	77	61	16
PCT7614	TO	916	334	0	0	26	308	254	54
PCT7615	MV	510	165	0	0	9	156	125	31
PCT7615	ED	240	58	0	0	4	54	44	10
PCT7615	TO	750	223	0	0	13	210	169	41
PCT7616	MV	754	330	0	0	35	295	209	86
PCT7616	ED	82	86	0	0	8	78	59	19
PCT7616	TO	836	416	0	0	43	373	268	105
PCT7617	MV	583	222	0	0	21	201	165	36
PCT7617	ED	169	42	0	0	9	33	26	7
PCT7617	TO	752	264	0	0	30	234	191	43
PCT7618	MV	763	365	0	0	23	342	252	90
PCT7618	ED	151	85	0	0	9	76	54	22
PCT7618	TO	914	450	0	0	32	418	306	112
PCT7619	MV	937	439	0	0	27	412	315	97
PCT7619	ED	170	119	0	0	12	107	89	18
PCT7619	TO	1107	558	0	0	39	519	404	115
PCT7621	MV	1006	443	0	0	35	408	305	103
PCT7621	ED	149	104	0	0	10	94	72	22
PCT7621	TO	1155	547	0	0	45	502	377	125
PCT7622	MV	697	215	0	0	13	202	169	33
PCT7622	ED	263	74	0	0	10	64	56	8
PCT7622	TO	960	289	0	0	23	266	225	41
PCT7623	MV	767	256	0	1	22	233	201	32
PCT7623	ED	237	98	0	0	8	90	83	7
PCT7623	TO	1004	354	0	1	30	323	284	39
PCT7624	MV	652	209	0	0	11	198	161	37
PCT7624	ED	223	73	0	0	11	62	54	8
PCT7624	TO	875	282	0	0	22	260	215	45
PCT7625	MV	749	394	0	0	52	342	261	81
PCT7625	ED	73	34	0	0	1	33	27	6
PCT7625	TO	822	428	0	0	53	375	288	87
PCT7626	MV	944	401	0	0	43	358	240	118
PCT7626	ED	129	108	0	0	4	104	78	26
PCT7626	TO	1073	509	0	0	47	462	318	144
PCT7627	MV	457	196	0	0	17	179	108	71
PCT7627	ED	67	59	0	0	7	52	33	19
PCT7627	TO	524	255	0	0	24	231	141	90
PCT7628	MV	718	331	0	0	14	317	252	65
PCT7628	ED	220	111	0	0	5	106	88	18
PCT7628	TO	938	442	0	0	19	423	340	83
PCT7629	MV	691	276	0	0	23	253	201	52
PCT7629	ED	162	87	0	0	7	80	68	12
PCT7629	TO	853	363	0	0	30	333	269	64
PCT7631	MV	1009	440	0	0	28	412	312	100
PCT7631	ED	210	111	0	0	8	103	80	23
PCT7631	TO	1219	551	0	0	36	515	392	123
PCT7632	MV	1002	413	0	0	26	387	290	97
PCT7632	ED	169	130	0	0	5	125	102	23
PCT7632	TO	1171	543	0	0	31	512	392	120
PCT7633	MV	609	278	0	0	23	255	187	68
PCT7633	ED	126	97	0	0	8	89	69	20
PCT7633	TO	735	375	0	0	31	344	256	88
PCT7634	MV	704	344	0	0	38	306	237	69
PCT7634	ED	186	105	0	0	12	93	71	22
PCT7634	TO	890	449	0	0	50	399	308	91
PCT7635	MV	665	273	0	0	16	257	177	80
PCT7635	ED	188	62	0	0	3	59	43	16
PCT7635	TO	853	335	0	0	19	316	220	96
PCT7636	MV	798	330	0	0	32	298	187	111
PCT7636	ED	161	107	0	0	7	100	72	28
PCT7636	TO	959	437	0	0	39	398	259	139
PCT7637	MV	747	344	0	0	31	313	190	123
PCT7637	ED	121	99	0	0	11	88	63	25
PCT7637	TO	868	443	0	0	42	401	253	148
PCT7638	MV	806	372	0	0	29	343	192	151
PCT7638	ED	83	89	0	0	10	79	42	37
PCT7638	TO	889	461	0	0	39	422	234	188
PCT7639	MV	889	396	0	0	41	355	227	128
PCT7639	ED	133	134	0	0	20	114	76	38
PCT7639	TO	1022	530	0	0	61	469	303	166
PCT7641	MV	817	399	0	0	27	372	234	138
PCT7641	ED	134	93	0	0	5	88	61	27
PCT7641	TO	951	492	0	0	32	460	295	165
PCT7642	MV	647	311	0	0	36	275	196	79
PCT7642	ED	118	82	0	0	13	69	48	21
PCT7642	TO	765	393	0	0	49	344	244	100
PCT7643	MV	810	433	0	0	31	402	264	138
PCT7643	ED	131	106	0	0	12	94	71	23
PCT7643	TO	941	539	0	0	43	496	335	161
PCT7644	MV	1014	403	0	0	43	360	239	121
PCT7644	ED	162	142	0	0	9	133	117	16
PCT7644	TO	1176	545	0	0	52	493	356	137
PCT7645	MV	595	286	0	0	22	264	179	85
PCT7645	ED	61	56	0	0	8	48	35	13
PCT7645	TO	656	342	0	0	30	312	214	98
PCT7646	MV	1032	484	0	0	44	440	296	144
PCT7646	ED	121	134	0	0	18	116	96	20
PCT7646	TO	1153	618	0	0	62	556	392	164
PCT7647	MV	724	210	0	0	4	206	163	43
PCT7647	ED	263	79	0	0	6	73	60	13
PCT7647	TO	987	289	0	0	10	279	223	56
PCT7648	MV	2	1	0	0	1	0	0	0
PCT7648	ED	0	0	0	0	0	0	0	0
PCT7648	TO	2	1	0	0	1	0	0	0
PCT7649	MV	723	286	0	0	12	274	205	69
PCT7649	ED	177	81	0	0	6	75	60	15
PCT7649	TO	900	367	0	0	18	349	265	84
PCT7651	MV	834	332	0	0	30	302	209	93
PCT7651	ED	113	73	0	0	9	64	42	22
PCT7651	TO	947	405	0	0	39	366	251	115
PCT7652	MV	535	207	0	0	19	188	125	63
PCT7652	ED	100	87	0	0	10	77	61	16
PCT7652	TO	635	294	0	0	29	265	186	79
PCT7653	MV	750	334	0	0	36	298	217	81
PCT7653	ED	89	80	0	0	9	71	51	20
PCT7653	TO	839	414	0	0	45	369	268	101
PCT7654	MV	413	191	0	0	13	178	130	48
PCT7654	ED	53	84	0	0	9	75	62	13
PCT7654	TO	466	275	0	0	22	253	192	61
PCT7655	MV	583	215	0	0	10	205	146	59
PCT7655	ED	96	60	0	0	9	51	42	9
PCT7655	TO	679	275	0	0	19	256	188	68
PCT7656	MV	603	308	0	0	29	279	159	120
PCT7656	ED	35	40	0	0	3	37	17	20
PCT7656	TO	638	348	0	0	32	316	176	140
PCT7657	MV	561	269	0	0	31	238	145	93
PCT7657	ED	37	61	0	0	6	55	37	18
PCT7657	TO	598	330	0	0	37	293	182	111
PCT7701	MV	868	481	0	0	36	445	335	110
PCT7701	ED	196	174	0	0	10	164	126	38
PCT7701	TO	1064	655	0	0	46	609	461	148
PCT7702	MV	623	375	0	0	22	353	223	130
PCT7702	ED	133	104	0	0	7	97	67	30
PCT7702	TO	756	479	0	0	29	450	290	160
PCT7703	MV	187	71	0	0	4	67	58	9
PCT7703	ED	-13	0	0	0	0	0	0	0
PCT7703	TO	174	71	0	0	4	67	58	9
PCT7704	MV	798	489	0	0	37	452	266	186
PCT7704	ED	204	173	0	0	4	169	110	59
PCT7704	TO	1002	662	0	0	41	621	376	245
PCT7705	MV	470	285	0	0	17	268	154	114
PCT7705	ED	125	110	0	0	11	99	60	39
PCT7705	TO	595	395	0	0	28	367	214	153
PCT7706	MV	687	447	0	0	25	422	259	163
PCT7706	ED	179	162	0	0	7	155	103	52
PCT7706	TO	866	609	0	0	32	577	362	215
PCT7707	MV	683	432	0	0	24	408	278	130
PCT7707	ED	189	179	0	0	8	171	103	68
PCT7707	TO	872	611	0	0	32	579	381	198
PCT7708	MV	710	461	0	0	38	423	272	151
PCT7708	ED	165	154	0	0	11	143	99	44
PCT7708	TO	875	615	0	0	49	566	371	195
PCT7709	MV	324	193	0	0	10	183	118	65
PCT7709	ED	82	90	0	0	5	85	67	18
PCT7709	TO	406	283	0	0	15	268	185	83
PCT7711	MV	658	379	0	1	20	358	245	113
PCT7711	ED	153	125	0	0	6	119	92	27
PCT7711	TO	811	504	0	1	26	477	337	140
PCT7712	MV	425	258	0	0	14	244	183	61
PCT7712	ED	107	106	0	0	8	98	71	27
PCT7712	TO	532	364	0	0	22	342	254	88
PCT7801	MV	823	478	0	0	21	457	325	132
PCT7801	ED	151	190	0	0	9	181	133	48
PCT7801	TO	974	668	0	0	30	638	458	180
PCT7802	MV	646	401	0	0	25	376	286	90
PCT7802	ED	152	158	0	0	7	151	126	25
PCT7802	TO	798	559	0	0	32	527	412	115
PCT7803	MV	718	476	0	0	31	445	317	128
PCT7803	ED	113	128	0	0	12	116	89	27
PCT7803	TO	831	604	0	0	43	561	406	155
PCT7804	MV	734	463	0	0	47	416	301	115
PCT7804	ED	151	181	0	1	18	162	127	35
PCT7804	TO	885	644	0	1	65	578	428	150
PCT7805	MV	644	399	0	0	42	357	260	97
PCT7805	ED	156	156	0	0	12	144	123	21
PCT7805	TO	800	555	0	0	54	501	383	118
PCT7806	MV	602	361	0	0	28	333	263	70
PCT7806	ED	153	152	0	0	14	138	113	25
PCT7806	TO	755	513	0	0	42	471	376	95
PCT7807	MV	642	361	0	0	19	342	272	70
PCT7807	ED	185	174	0	0	17	157	136	21
PCT7807	TO	827	535	0	0	36	499	408	91
PCT7808	MV	525	296	0	0	25	271	221	50
PCT7808	ED	129	129	0	0	11	118	95	23
PCT7808	TO	654	425	0	0	36	389	316	73
PCT7809	MV	624	351	0	0	22	329	272	57
PCT7809	ED	140	136	0	0	13	123	113	10
PCT7809	TO	764	487	0	0	35	452	385	67
PCT7811	MV	582	311	0	0	22	289	240	49
PCT7811	ED	176	155	0	0	8	147	121	26
PCT7811	TO	758	466	0	0	30	436	361	75
PCT7812	MV	680	369	0	0	32	337	272	65
PCT7812	ED	217	163	0	0	10	153	126	27
PCT7812	TO	897	532	0	0	42	490	398	92
PCT7813	MV	843	483	0	0	25	458	360	98
PCT7813	ED	225	215	0	0	17	198	168	30
PCT7813	TO	1068	698	0	0	42	656	528	128
PCT7814	MV	660	279	0	0	19	260	205	55
PCT7814	ED	241	118	0	0	9	109	99	10
PCT7814	TO	901	397	0	0	28	369	304	65
PCT7815	MV	749	465	0	0	49	416	321	95
PCT7815	ED	168	179	0	0	9	170	138	32
PCT7815	TO	917	644	0	0	58	586	459	127
PCT7816	MV	724	472	0	0	37	435	331	104
PCT7816	ED	148	149	0	0	7	142	105	37
PCT7816	TO	872	621	0	0	44	577	436	141
PCT7817	MV	652	396	0	0	13	383	321	62
PCT7817	ED	186	183	0	0	10	173	150	23
PCT7817	TO	838	579	0	0	23	556	471	85
PCT7818	MV	668	393	0	0	26	367	290	77
PCT7818	ED	171	149	0	0	8	141	122	19
PCT7818	TO	839	542	0	0	34	508	412	96
PCT7819	MV	635	352	0	0	29	323	248	75
PCT7819	ED	139	89	0	0	6	83	75	8
PCT7819	TO	774	441	0	0	35	406	323	83
PCT7821	MV	806	519	0	0	32	487	380	107
PCT7821	ED	170	190	0	0	9	181	130	51
PCT7821	TO	976	709	0	0	41	668	510	158
PCT7822	MV	673	395	0	1	25	369	296	73
PCT7822	ED	219	223	0	0	21	202	154	48
PCT7822	TO	892	618	0	1	46	571	450	121
PCT7823	MV	706	410	0	0	26	384	306	78
PCT7823	ED	177	189	0	0	5	184	160	24
PCT7823	TO	883	599	0	0	31	568	466	102
PCT7824	MV	615	334	0	0	29	305	228	77
PCT7824	ED	153	158	0	0	12	146	123	23
PCT7824	TO	768	492	0	0	41	451	351	100
PCT7825	MV	457	252	0	0	17	235	208	27
PCT7825	ED	151	130	0	0	4	126	106	20
PCT7825	TO	608	382	0	0	21	361	314	47
PCT7826	MV	486	263	0	0	18	245	200	45
PCT7826	ED	204	162	0	0	6	156	142	14
PCT7826	TO	690	425	0	0	24	401	342	59
PCT7827	MV	607	318	0	0	20	298	239	59
PCT7827	ED	219	146	0	0	16	130	110	20
PCT7827	TO	826	464	0	0	36	428	349	79
PCT7828	MV	857	477	0	1	32	444	327	117
PCT7828	ED	171	179	0	1	19	159	127	32
PCT7828	TO	1028	656	0	2	51	603	454	149
PCT7829	MV	742	466	0	0	35	431	296	135
PCT7829	ED	149	151	0	0	5	146	118	28
PCT7829	TO	891	617	0	0	40	577	414	163
PCT7831	MV	763	485	0	0	41	444	333	111
PCT7831	ED	139	138	0	0	9	129	94	35
PCT7831	TO	902	623	0	0	50	573	427	146
PCT7832	MV	663	412	0	0	33	379	292	87
PCT7832	ED	118	127	0	0	9	118	99	19
PCT7832	TO	781	539	0	0	42	497	391	106
PCT7833	MV	587	343	0	0	24	319	253	66
PCT7833	ED	146	145	0	0	17	128	107	21
PCT7833	TO	733	488	0	0	41	447	360	87
PCT7834	MV	700	374	0	0	28	346	294	52
PCT7834	ED	194	177	0	0	13	164	139	25
PCT7834	TO	894	551	0	0	41	510	433	77
PCT7835	MV	721	427	0	0	26	401	274	127
PCT7835	ED	142	147	0	0	12	135	101	34
PCT7835	TO	863	574	0	0	38	536	375	161
PCT7836	MV	850	505	0	0	25	480	335	145
PCT7836	ED	193	170	0	0	6	164	116	48
PCT7836	TO	1043	675	0	0	31	644	451	193
PCT7837	MV	718	424	0	0	46	378	272	106
PCT7837	ED	205	199	0	0	9	190	156	34
PCT7837	TO	923	623	0	0	55	568	428	140
PCT7838	MV	752	492	0	0	39	453	323	130
PCT7838	ED	143	156	0	0	9	147	115	32
PCT7838	TO	895	648	0	0	48	600	438	162
PCT7839	MV	731	456	0	0	40	416	305	111
PCT7839	ED	130	137	0	1	10	126	97	29
PCT7839	TO	861	593	0	1	50	542	402	140
PCT7841	MV	752	457	0	0	33	424	322	102
PCT7841	ED	198	207	0	0	8	199	159	40
PCT7841	TO	950	664	0	0	41	623	481	142
PCT7842	MV	702	393	0	0	31	362	294	68
PCT7842	ED	177	155	0	0	6	149	123	26
PCT7842	TO	879	548	0	0	37	511	417	94
PCT7843	MV	546	295	0	0	13	282	234	48
PCT7843	ED	183	165	0	0	12	153	123	30
PCT7843	TO	729	460	0	0	25	435	357	78
PCT7844	MV	499	281	0	0	27	254	213	41
PCT7844	ED	152	136	0	0	13	123	100	23
PCT7844	TO	651	417	0	0	40	377	313	64
PCT7845	MV	676	405	0	0	27	378	301	77
PCT7845	ED	204	177	0	0	14	163	127	36
PCT7845	TO	880	582	0	0	41	541	428	113
PCT7846	MV	736	463	0	0	43	420	296	124
PCT7846	ED	172	167	0	0	16	151	121	30
PCT7846	TO	908	630	0	0	59	571	417	154
PCT7847	MV	698	427	0	0	40	387	305	82
PCT7847	ED	193	183	0	0	7	176	139	37
PCT7847	TO	891	610	0	0	47	563	444	119
PCT7848	MV	665	437	0	0	29	408	311	97
PCT7848	ED	182	169	0	0	18	151	118	33
PCT7848	TO	847	606	0	0	47	559	429	130
PCT7849	MV	729	441	0	1	35	405	310	95
PCT7849	ED	172	186	0	0	15	171	141	30
PCT7849	TO	901	627	0	1	50	576	451	125
PCT7851	MV	414	272	0	0	23	249	152	97
PCT7851	ED	112	84	0	0	8	76	48	28
PCT7851	TO	526	356	0	0	31	325	200	125
PCT7852	MV	533	350	0	0	24	326	205	121
PCT7852	ED	111	103	0	0	5	98	68	30
PCT7852	TO	644	453	0	0	29	424	273	151
PCT7853	MV	694	394	0	0	32	362	251	111
PCT7853	ED	161	137	0	0	9	128	92	36
PCT7853	TO	855	531	0	0	41	490	343	147
PCT7854	MV	703	430	0	0	35	395	284	111
PCT7854	ED	175	172	0	0	10	162	128	34
PCT7854	TO	878	602	0	0	45	557	412	145
PCT7855	MV	763	450	0	0	36	414	306	108
PCT7855	ED	211	202	0	0	16	186	150	36
PCT7855	TO	974	652	0	0	52	600	456	144
PCT7856	MV	643	372	0	0	25	347	264	83
PCT7856	ED	204	193	0	0	10	183	145	38
PCT7856	TO	847	565	0	0	35	530	409	121
PCT7857	MV	748	435	0	1	36	398	303	95
PCT7857	ED	158	154	0	0	9	145	120	25
PCT7857	TO	906	589	0	1	45	543	423	120
PCT7858	MV	622	349	0	0	30	319	261	58
PCT7858	ED	157	148	0	0	11	137	119	18
PCT7858	TO	779	497	0	0	41	456	380	76
PCT7859	MV	747	464	0	0	34	430	310	120
PCT7859	ED	152	166	0	0	17	149	106	43
PCT7859	TO	899	630	0	0	51	579	416	163
PCT7861	MV	699	431	0	0	24	407	292	115
PCT7861	ED	164	171	0	0	9	162	123	39
PCT7861	TO	863	602	0	0	33	569	415	154
PCT7862	MV	669	400	0	0	26	374	271	103
PCT7862	ED	195	198	0	0	12	186	150	36
PCT7862	TO	864	598	0	0	38	560	421	139
PCT7863	MV	693	371	0	0	24	347	268	79
PCT7863	ED	208	205	0	0	8	197	145	52
PCT7863	TO	901	576	0	0	32	544	413	131
PCT7864	MV	661	374	0	0	30	344	253	91
PCT7864	ED	153	157	0	0	12	145	114	31
PCT7864	TO	814	531	0	0	42	489	367	122
PCT7865	MV	677	408	0	0	39	369	280	89
PCT7865	ED	163	157	0	0	10	147	112	35
PCT7865	TO	840	565	0	0	49	516	392	124
PCT7866	MV	690	446	0	0	21	425	263	162
PCT7866	ED	158	141	0	0	6	135	90	45
PCT7866	TO	848	587	0	0	27	560	353	207
PCT7867	MV	766	470	0	0	29	441	333	108
PCT7867	ED	212	182	0	0	13	169	133	36
PCT7867	TO	978	652	0	0	42	610	466	144
PCT7868	MV	659	374	0	0	21	353	260	93
PCT7868	ED	217	161	0	1	9	151	116	35
PCT7868	TO	876	535	0	1	30	504	376	128
PCT7869	MV	683	440	0	0	30	410	306	104
PCT7869	ED	178	190	0	0	11	179	145	34
PCT7869	TO	861	630	0	0	41	589	451	138
PCT7871	MV	702	463	0	0	34	429	329	100
PCT7871	ED	200	157	0	0	9	148	108	40
PCT7871	TO	902	620	0	0	43	577	437	140
PCT7872	MV	675	420	0	0	25	395	299	96
PCT7872	ED	199	185	0	0	9	176	131	45
PCT7872	TO	874	605	0	0	34	571	430	141
PCT7873	MV	689	444	0	1	28	415	316	99
PCT7873	ED	202	213	0	0	15	198	165	33
PCT7873	TO	891	657	0	1	43	613	481	132
PCT7874	MV	370	189	0	0	8	181	135	46
PCT7874	ED	119	107	0	0	6	101	83	18
PCT7874	TO	489	296	0	0	14	282	218	64
PCT7875	MV	500	252	0	0	16	236	176	60
PCT7875	ED	147	115	0	0	5	110	93	17
PCT7875	TO	647	367	0	0	21	346	269	77
PCT7876	MV	462	256	0	0	27	229	186	43
PCT7876	ED	106	91	0	0	11	80	67	13
PCT7876	TO	568	347	0	0	38	309	253	56
PCT7901	MV	399	191	0	0	14	177	148	29
PCT7901	ED	150	65	0	0	3	62	53	9
PCT7901	TO	549	256	0	0	17	239	201	38
PCT7902	MV	680	290	0	0	14	276	234	42
PCT7902	ED	232	141	0	0	8	133	114	19
PCT7902	TO	912	431	0	0	22	409	348	61
PCT7903	MV	623	284	0	0	22	262	220	42
PCT7903	ED	229	123	0	0	7	116	109	7
PCT7903	TO	852	407	0	0	29	378	329	49
PCT7904	MV	680	297	0	0	25	272	219	53
PCT7904	ED	157	118	0	0	9	109	92	17
PCT7904	TO	837	415	0	0	34	381	311	70
PCT7905	MV	684	356	0	0	20	336	265	71
PCT7905	ED	191	183	0	0	8	175	151	24
PCT7905	TO	875	539	0	0	28	511	416	95
PCT7906	MV	599	283	0	0	20	263	223	40
PCT7906	ED	187	117	0	0	13	104	87	17
PCT7906	TO	786	400	0	0	33	367	310	57
PCT7907	MV	704	343	0	0	15	328	268	60
PCT7907	ED	238	164	0	0	15	149	128	21
PCT7907	TO	942	507	0	0	30	477	396	81
PCT7908	MV	752	365	0	0	24	341	289	52
PCT7908	ED	240	169	0	0	12	157	140	17
PCT7908	TO	992	534	0	0	36	498	429	69
PCT7909	MV	558	310	0	0	22	288	247	41
PCT7909	ED	185	140	0	0	7	133	117	16
PCT7909	TO	743	450	0	0	29	421	364	57
PCT7911	MV	666	320	0	0	26	294	232	62
PCT7911	ED	205	129	0	0	8	121	104	17
PCT7911	TO	871	449	0	0	34	415	336	79
PCT7912	MV	800	370	0	0	26	344	301	43
PCT7912	ED	259	177	0	0	19	158	144	14
PCT7912	TO	1059	547	0	0	45	502	445	57
PCT7913	MV	660	350	0	0	14	336	277	59
PCT7913	ED	263	214	0	0	5	209	173	36
PCT7913	TO	923	564	0	0	19	545	450	95
PCT7914	MV	715	389	0	0	29	360	300	60
PCT7914	ED	187	142	0	0	12	130	109	21
PCT7914	TO	902	531	0	0	41	490	409	81
PCT7915	MV	605	290	0	0	23	267	220	47
PCT7915	ED	238	181	0	0	5	176	147	29
PCT7915	TO	843	471	0	0	28	443	367	76
PCT7916	MV	639	334	0	0	20	314	264	50
PCT7916	ED	219	161	0	0	11	150	137	13
PCT7916	TO	858	495	0	0	31	464	401	63
PCT7917	MV	716	356	0	0	20	336	286	50
PCT7917	ED	271	187	0	0	8	179	157	22
PCT7917	TO	987	543	0	0	28	515	443	72
PCT7918	MV	597	297	0	0	13	284	242	42
PCT7918	ED	227	144	0	0	7	137	115	22
PCT7918	TO	824	441	0	0	20	421	357	64
PCT7919	MV	608	309	0	0	16	293	254	39
PCT7919	ED	258	176	0	0	9	167	148	19
PCT7919	TO	866	485	0	0	25	460	402	58
PCT7921	MV	682	309	0	0	18	291	244	47
PCT7921	ED	229	102	0	0	4	98	89	9
PCT7921	TO	911	411	0	0	22	389	333	56
PCT7922	MV	648	314	0	0	14	300	248	52
PCT7922	ED	210	155	0	0	13	142	118	24
PCT7922	TO	858	469	0	0	27	442	366	76
PCT7923	MV	666	336	0	0	15	321	244	77
PCT7923	ED	214	171	0	0	10	161	135	26
PCT7923	TO	880	507	0	0	25	482	379	103
PCT7924	MV	649	302	0	0	11	291	231	60
PCT7924	ED	202	124	0	0	10	114	92	22
PCT7924	TO	851	426	0	0	21	405	323	82
PCT7925	MV	434	225	0	0	16	209	164	45
PCT7925	ED	110	89	0	0	4	85	74	11
PCT7925	TO	544	314	0	0	20	294	238	56
PCT7926	MV	610	337	0	0	23	314	254	60
PCT7926	ED	178	150	0	0	6	144	115	29
PCT7926	TO	788	487	0	0	29	458	369	89
PCT7927	MV	580	334	0	0	26	308	254	54
PCT7927	ED	162	153	0	0	6	147	124	23
PCT7927	TO	742	487	0	0	32	455	378	77
PCT7928	MV	700	395	0	0	23	372	292	80
PCT7928	ED	217	208	0	0	4	204	164	40
PCT7928	TO	917	603	0	0	27	576	456	120
PCT7929	MV	678	422	0	0	21	401	328	73
PCT7929	ED	169	171	0	0	9	162	146	16
PCT7929	TO	847	593	0	0	30	563	474	89
PCT7931	MV	610	376	0	0	34	342	264	78
PCT7931	ED	141	150	0	0	6	144	119	25
PCT7931	TO	751	526	0	0	40	486	383	103
PCT7932	MV	443	277	0	0	21	256	179	77
PCT7932	ED	118	96	0	0	6	90	73	17
PCT7932	TO	561	373	0	0	27	346	252	94
PCT7933	MV	9	6	0	0	0	6	4	2
PCT7933	ED	-1	0	0	0	0	0	0	0
PCT7933	TO	8	6	0	0	0	6	4	2
PCT7934	MV	702	408	0	0	27	381	324	57
PCT7934	ED	182	155	0	0	10	145	120	25
PCT7934	TO	884	563	0	0	37	526	444	82
PCT7935	MV	716	435	0	0	26	409	324	85
PCT7935	ED	227	225	0	0	15	210	176	34
PCT7935	TO	943	660	0	0	41	619	500	119
PCT7936	MV	620	369	0	0	29	340	272	68
PCT7936	ED	236	220	0	0	10	210	170	40
PCT7936	TO	856	589	0	0	39	550	442	108
PCT7937	MV	698	406	0	0	23	383	300	83
PCT7937	ED	202	171	0	0	7	164	138	26
PCT7937	TO	900	577	0	0	30	547	438	109
PCT7938	MV	536	301	0	0	15	286	213	73
PCT7938	ED	215	121	0	0	8	113	97	16
PCT7938	TO	751	422	0	0	23	399	310	89
PCT7939	MV	481	289	0	0	16	273	227	46
PCT7939	ED	205	191	0	0	10	181	153	28
PCT7939	TO	686	480	0	0	26	454	380	74
PCT7941	MV	576	304	0	0	29	275	220	55
PCT7941	ED	196	171	0	0	10	161	123	38
PCT7941	TO	772	475	0	0	39	436	343	93
PCT7942	MV	658	330	0	0	20	310	245	65
PCT7942	ED	274	141	0	0	5	136	114	22
PCT7942	TO	932	471	0	0	25	446	359	87
PCT7943	MV	687	367	0	0	17	350	257	93
PCT7943	ED	213	156	0	0	11	145	105	40
PCT7943	TO	900	523	0	0	28	495	362	133
PCT7944	MV	584	340	0	0	25	315	245	70
PCT7944	ED	230	196	0	0	11	185	152	33
PCT7944	TO	814	536	0	0	36	500	397	103
PCT7945	MV	726	337	0	0	25	312	249	63
PCT7945	ED	228	83	0	0	7	76	69	7
PCT7945	TO	954	420	0	0	32	388	318	70
PCT7946	MV	779	365	0	1	20	344	195	149
PCT7946	ED	206	115	0	0	7	108	81	27
PCT7946	TO	985	480	0	1	27	452	276	176
PCT7947	MV	792	332	0	0	23	309	161	148
PCT7947	ED	194	94	0	0	2	92	69	23
PCT7947	TO	986	426	0	0	25	401	230	171
PCT7948	MV	730	373	0	0	25	348	194	154
PCT7948	ED	200	119	0	0	3	116	85	31
PCT7948	TO	930	492	0	0	28	464	279	185
PCT7949	MV	484	233	0	0	12	221	113	108
PCT7949	ED	106	56	0	0	7	49	35	14
PCT7949	TO	590	289	0	0	19	270	148	122
PCT7951	MV	731	365	0	0	26	339	179	160
PCT7951	ED	156	90	0	0	3	87	56	31
PCT7951	TO	887	455	0	0	29	426	235	191
PCT7952	MV	730	292	0	0	18	274	151	123
PCT7952	ED	182	86	0	0	6	80	51	29
PCT7952	TO	912	378	0	0	24	354	202	152
PCT7953	MV	669	331	0	0	17	314	177	137
PCT7953	ED	161	106	0	0	5	101	63	38
PCT7953	TO	830	437	0	0	22	415	240	175
PCT7954	MV	0	0	0	0	0	0	0	0
PCT7954	ED	0	0	0	0	0	0	0	0
PCT7954	TO	0	0	0	0	0	0	0	0
PCT7955	MV	774	350	0	0	18	332	202	130
PCT7955	ED	173	98	0	0	8	90	55	35
PCT7955	TO	947	448	0	0	26	422	257	165
PCT7956	MV	699	266	0	0	12	254	150	104
PCT7956	ED	170	39	0	0	2	37	30	7
PCT7956	TO	869	305	0	0	14	291	180	111
PCT7957	MV	538	261	0	0	15	246	165	81
PCT7957	ED	135	85	0	0	6	79	60	19
PCT7957	TO	673	346	0	0	21	325	225	100
PCT7958	MV	320	104	0	0	6	98	71	27
PCT7958	ED	-23	0	0	0	0	0	0	0
PCT7958	TO	297	104	0	0	6	98	71	27
PCT7959	MV	541	230	0	0	23	207	172	35
PCT7959	ED	145	68	0	0	5	63	59	4
PCT7959	TO	686	298	0	0	28	270	231	39
PCT9001	MV	314	100	0	0	1	99	79	20
PCT9001	ED	-30	0	0	0	0	0	0	0
PCT9001	TO	284	100	0	0	1	99	79	20
PCT9101	MV	712	377	0	0	23	354	240	114
PCT9101	ED	201	193	0	0	12	181	122	59
PCT9101	TO	913	570	0	0	35	535	362	173
PCT9102	MV	788	393	0	0	26	367	246	121
PCT9102	ED	204	173	0	0	16	157	122	35
PCT9102	TO	992	566	0	0	42	524	368	156
PCT9103	MV	719	381	0	0	32	349	250	99
PCT9103	ED	238	190	0	0	15	175	113	62
PCT9103	TO	957	571	0	0	47	524	363	161
PCT9104	MV	810	381	0	0	35	346	244	102
PCT9104	ED	220	178	0	0	15	163	129	34
PCT9104	TO	1030	559	0	0	50	509	373	136
PCT9105	MV	719	413	0	0	23	390	254	136
PCT9105	ED	199	221	0	0	22	199	139	60
PCT9105	TO	918	634	0	0	45	589	393	196
PCT9106	MV	748	397	0	0	30	367	257	110
PCT9106	ED	198	223	0	0	20	203	156	47
PCT9106	TO	946	620	0	0	50	570	413	157
PCT9107	MV	636	305	0	1	24	280	207	73
PCT9107	ED	208	165	0	0	14	151	124	27
PCT9107	TO	844	470	0	1	38	431	331	100
PCT9108	MV	610	336	0	0	30	306	228	78
PCT9108	ED	200	140	0	0	7	133	106	27
PCT9108	TO	810	476	0	0	37	439	334	105
PCT9109	MV	672	300	0	0	29	271	198	73
PCT9109	ED	211	196	0	0	11	185	140	45
PCT9109	TO	883	496	0	0	40	456	338	118
PCT9111	MV	639	316	0	0	25	291	193	98
PCT9111	ED	195	169	0	0	15	154	125	29
PCT9111	TO	834	485	0	0	40	445	318	127
PCT9112	MV	742	351	0	0	22	329	237	92
PCT9112	ED	219	204	0	0	14	190	148	42
PCT9112	TO	961	555	0	0	36	519	385	134
PCT9113	MV	796	371	0	0	31	340	250	90
PCT9113	ED	208	241	0	0	23	218	157	61
PCT9113	TO	1004	612	0	0	54	558	407	151
PCT9114	MV	659	290	0	0	19	271	198	73
PCT9114	ED	231	182	0	0	15	167	136	31
PCT9114	TO	890	472	0	0	34	438	334	104
PCT9115	MV	699	322	0	0	28	294	216	78
PCT9115	ED	182	179	0	0	22	157	135	22
PCT9115	TO	881	501	0	0	50	451	351	100
PCT9116	MV	782	345	0	0	20	325	228	97
PCT9116	ED	179	174	0	0	12	162	117	45
PCT9116	TO	961	519	0	0	32	487	345	142
PCT9117	MV	629	326	0	0	16	310	199	111
PCT9117	ED	171	195	0	0	13	182	122	60
PCT9117	TO	800	521	0	0	29	492	321	171
PCT9118	MV	742	340	0	0	24	316	198	118
PCT9118	ED	242	223	0	0	23	200	141	59
PCT9118	TO	984	563	0	0	47	516	339	177
PCT9119	MV	703	387	0	0	22	365	222	143
PCT9119	ED	197	156	0	0	14	142	113	29
PCT9119	TO	900	543	0	0	36	507	335	172
PCT9121	MV	735	335	0	0	19	316	209	107
PCT9121	ED	218	184	0	0	11	173	112	61
PCT9121	TO	953	519	0	0	30	489	321	168
PCT9122	MV	775	364	0	0	29	335	204	131
PCT9122	ED	192	160	0	0	18	142	103	39
PCT9122	TO	967	524	0	0	47	477	307	170
PCT9123	MV	661	319	0	0	18	301	204	97
PCT9123	ED	191	187	0	0	15	172	134	38
PCT9123	TO	852	506	0	0	33	473	338	135
PCT9124	MV	736	351	0	0	13	338	205	133
PCT9124	ED	167	159	0	0	10	149	112	37
PCT9124	TO	903	510	0	0	23	487	317	170
PCT9125	MV	681	358	0	0	19	339	231	108
PCT9125	ED	188	152	0	0	12	140	107	33
PCT9125	TO	869	510	0	0	31	479	338	141
PCT9126	MV	819	385	0	1	28	356	208	148
PCT9126	ED	194	200	0	0	15	185	140	45
PCT9126	TO	1013	585	0	1	43	541	348	193
PCT9127	MV	748	380	0	0	32	348	245	103
PCT9127	ED	223	220	0	0	12	208	152	56
PCT9127	TO	971	600	0	0	44	556	397	159
PCT9128	MV	628	333	0	0	25	308	200	108
PCT9128	ED	190	195	0	0	13	182	133	49
PCT9128	TO	818	528	0	0	38	490	333	157
PCT9129	MV	587	271	0	0	15	256	170	86
PCT9129	ED	151	153	0	0	9	144	114	30
PCT9129	TO	738	424	0	0	24	400	284	116
PCT9131	MV	596	285	0	0	13	272	181	91
PCT9131	ED	138	152	0	0	10	142	104	38
PCT9131	TO	734	437	0	0	23	414	285	129
PCT9132	MV	627	262	0	0	21	241	189	52
PCT9132	ED	194	172	0	0	16	156	126	30
PCT9132	TO	821	434	0	0	37	397	315	82
PCT9133	MV	808	381	0	0	23	358	263	95
PCT9133	ED	209	211	0	0	14	197	147	50
PCT9133	TO	1017	592	0	0	37	555	410	145
PCT9134	MV	736	327	0	0	22	305	196	109
PCT9134	ED	155	103	0	0	10	93	71	22
PCT9134	TO	891	430	0	0	32	398	267	131
PCT9135	MV	640	304	0	0	20	284	186	98
PCT9135	ED	182	154	0	0	12	142	88	54
PCT9135	TO	822	458	0	0	32	426	274	152
PCT9136	MV	706	368	0	0	36	332	224	108
PCT9136	ED	212	162	0	0	16	146	114	32
PCT9136	TO	918	530	0	0	52	478	338	140
PCT9137	MV	806	387	0	0	26	361	245	116
PCT9137	ED	209	175	0	0	9	166	126	40
PCT9137	TO	1015	562	0	0	35	527	371	156
PCT9138	MV	770	398	0	0	21	377	249	128
PCT9138	ED	175	149	0	0	8	141	106	35
PCT9138	TO	945	547	0	0	29	518	355	163
PCT9139	MV	828	422	0	0	29	393	252	141
PCT9139	ED	190	174	0	0	15	159	111	48
PCT9139	TO	1018	596	0	0	44	552	363	189
PCT9141	MV	789	418	0	0	33	385	239	146
PCT9141	ED	184	172	0	0	15	157	113	44
PCT9141	TO	973	590	0	0	48	542	352	190
PCT9142	MV	747	364	0	0	18	346	242	104
PCT9142	ED	239	204	0	0	19	185	144	41
PCT9142	TO	986	568	0	0	37	531	386	145
PCT9143	MV	705	359	0	0	23	336	204	132
PCT9143	ED	209	170	0	0	8	162	112	50
PCT9143	TO	914	529	0	0	31	498	316	182
PCT9144	MV	767	376	0	0	27	349	230	119
PCT9144	ED	203	213	0	0	10	203	161	42
PCT9144	TO	970	589	0	0	37	552	391	161
PCT9145	MV	681	334	0	0	15	319	239	80
PCT9145	ED	194	176	0	0	9	167	122	45
PCT9145	TO	875	510	0	0	24	486	361	125
PCT9146	MV	725	353	0	0	28	325	241	84
PCT9146	ED	160	189	0	0	18	171	135	36
PCT9146	TO	885	542	0	0	46	496	376	120
PCT9147	MV	765	373	0	0	32	341	248	93
PCT9147	ED	225	208	0	0	17	191	143	48
PCT9147	TO	990	581	0	0	49	532	391	141
PCT9148	MV	779	397	0	0	26	371	280	91
PCT9148	ED	235	226	0	0	20	206	167	39
PCT9148	TO	1014	623	0	0	46	577	447	130
PCT9149	MV	813	384	0	0	23	361	265	96
PCT9149	ED	178	248	0	0	12	236	181	55
PCT9149	TO	991	632	0	0	35	597	446	151
PCT9151	MV	693	351	0	0	30	321	239	82
PCT9151	ED	168	114	0	0	5	109	79	30
PCT9151	TO	861	465	0	0	35	430	318	112
PCT9152	MV	550	196	0	0	11	185	152	33
PCT9152	ED	187	142	0	0	11	131	111	20
PCT9152	TO	737	338	0	0	22	316	263	53
PCT9201	MV	785	357	0	0	30	327	277	50
PCT9201	ED	186	226	0	0	17	209	172	37
PCT9201	TO	971	583	0	0	47	536	449	87
PCT9202	MV	819	368	0	1	38	329	252	77
PCT9202	ED	177	223	0	0	18	205	152	53
PCT9202	TO	996	591	0	1	56	534	404	130
PCT9203	MV	847	373	0	0	54	319	189	130
PCT9203	ED	155	188	0	0	28	160	94	66
PCT9203	TO	1002	561	0	0	82	479	283	196
PCT9204	MV	686	309	0	0	35	274	154	120
PCT9204	ED	176	195	0	0	27	168	100	68
PCT9204	TO	862	504	0	0	62	442	254	188
PCT9205	MV	621	288	0	0	36	252	168	84
PCT9205	ED	115	150	0	0	20	130	80	50
PCT9205	TO	736	438	0	0	56	382	248	134
PCT9206	MV	741	350	0	0	30	320	179	141
PCT9206	ED	188	194	0	0	38	156	92	64
PCT9206	TO	929	544	0	0	68	476	271	205
PCT9207	MV	824	369	0	0	33	336	187	149
PCT9207	ED	165	192	0	0	17	175	113	62
PCT9207	TO	989	561	0	0	50	511	300	211
PCT9208	MV	808	357	0	0	32	325	196	129
PCT9208	ED	179	179	0	0	16	163	107	56
PCT9208	TO	987	536	0	0	48	488	303	185
PCT9209	MV	615	275	0	0	24	251	156	95
PCT9209	ED	156	170	0	0	29	141	86	55
PCT9209	TO	771	445	0	0	53	392	242	150
PCT9211	MV	730	314	0	1	35	278	162	116
PCT9211	ED	161	154	0	0	24	130	78	52
PCT9211	TO	891	468	0	1	59	408	240	168
PCT9212	MV	671	284	0	1	27	256	160	96
PCT9212	ED	137	170	0	0	31	139	91	48
PCT9212	TO	808	454	0	1	58	395	251	144
PCT9213	MV	776	349	0	0	36	313	192	121
PCT9213	ED	161	195	0	0	27	168	105	63
PCT9213	TO	937	544	0	0	63	481	297	184
PCT9214	MV	517	236	0	0	19	217	137	80
PCT9214	ED	110	135	0	0	24	111	68	43
PCT9214	TO	627	371	0	0	43	328	205	123
PCT9215	MV	524	246	0	1	15	230	133	97
PCT9215	ED	120	131	0	0	14	117	71	46
PCT9215	TO	644	377	0	1	29	347	204	143
PCT9216	MV	669	264	0	0	33	231	133	98
PCT9216	ED	155	172	0	0	20	152	107	45
PCT9216	TO	824	436	0	0	53	383	240	143
PCT9217	MV	588	268	0	0	13	255	154	101
PCT9217	ED	117	133	0	0	8	125	79	46
PCT9217	TO	705	401	0	0	21	380	233	147
PCT9218	MV	652	278	0	0	26	252	142	110
PCT9218	ED	164	158	0	0	16	142	101	41
PCT9218	TO	816	436	0	0	42	394	243	151
PCT9219	MV	646	288	0	0	34	254	175	79
PCT9219	ED	144	168	0	0	18	150	111	39
PCT9219	TO	790	456	0	0	52	404	286	118
PCT9221	MV	562	322	0	0	19	303	163	140
PCT9221	ED	89	140	0	0	16	124	88	36
PCT9221	TO	651	462	0	0	35	427	251	176
PCT9222	MV	773	373	0	0	32	341	203	138
PCT9222	ED	137	174	0	0	22	152	98	54
PCT9222	TO	910	547	0	0	54	493	301	192
PCT9223	MV	558	266	0	0	18	248	143	105
PCT9223	ED	109	113	0	0	11	102	58	44
PCT9223	TO	667	379	0	0	29	350	201	149
PCT9224	MV	768	380	0	0	32	348	227	121
PCT9224	ED	181	166	0	0	20	146	89	57
PCT9224	TO	949	546	0	0	52	494	316	178
PCT9225	MV	757	303	0	0	26	277	176	101
PCT9225	ED	169	219	0	0	28	191	131	60
PCT9225	TO	926	522	0	0	54	468	307	161
PCT9226	MV	741	355	0	0	43	312	208	104
PCT9226	ED	155	148	0	0	12	136	95	41
PCT9226	TO	896	503	0	0	55	448	303	145
PCT9227	MV	605	371	0	0	26	345	214	131
PCT9227	ED	124	149	0	0	7	142	98	44
PCT9227	TO	729	520	0	0	33	487	312	175
PCT9228	MV	578	314	0	0	21	293	170	123
PCT9228	ED	160	179	0	0	14	165	105	60
PCT9228	TO	738	493	0	0	35	458	275	183
PCT9229	MV	460	257	0	0	20	237	171	66
PCT9229	ED	119	122	0	0	8	114	74	40
PCT9229	TO	579	379	0	0	28	351	245	106
PCT9231	MV	726	352	0	0	24	328	235	93
PCT9231	ED	236	255	0	0	20	235	166	69
PCT9231	TO	962	607	0	0	44	563	401	162
PCT9232	MV	608	293	0	1	28	264	154	110
PCT9232	ED	126	155	0	0	14	141	83	58
PCT9232	TO	734	448	0	1	42	405	237	168
PCT9233	MV	668	330	0	0	31	299	176	123
PCT9233	ED	150	186	0	0	25	161	117	44
PCT9233	TO	818	516	0	0	56	460	293	167
PCT9234	MV	643	319	0	0	26	293	181	112
PCT9234	ED	91	144	0	0	21	123	80	43
PCT9234	TO	734	463	0	0	47	416	261	155
PCT9235	MV	703	365	0	0	29	336	190	146
PCT9235	ED	160	194	0	0	17	177	120	57
PCT9235	TO	863	559	0	0	46	513	310	203
PCT9236	MV	537	282	0	0	24	258	171	87
PCT9236	ED	136	137	0	0	18	119	83	36
PCT9236	TO	673	419	0	0	42	377	254	123
PCT9237	MV	779	395	0	0	35	360	234	126
PCT9237	ED	118	182	0	0	15	167	108	59
PCT9237	TO	897	577	0	0	50	527	342	185
PCT9238	MV	687	330	0	0	33	297	168	129
PCT9238	ED	118	174	0	0	25	149	101	48
PCT9238	TO	805	504	0	0	58	446	269	177
PCT9239	MV	740	390	0	0	45	345	225	120
PCT9239	ED	124	157	0	0	18	139	103	36
PCT9239	TO	864	547	0	0	63	484	328	156
PCT9241	MV	819	403	0	0	36	367	223	144
PCT9241	ED	141	195	0	0	21	174	120	54
PCT9241	TO	960	598	0	0	57	541	343	198
PCT9242	MV	771	348	0	1	39	308	215	93
PCT9242	ED	172	213	0	0	26	187	136	51
PCT9242	TO	943	561	0	1	65	495	351	144
PCT9243	MV	480	241	0	0	22	219	146	73
PCT9243	ED	123	138	0	0	21	117	86	31
PCT9243	TO	603	379	0	0	43	336	232	104
PCT9244	MV	756	394	0	0	49	345	256	89
PCT9244	ED	154	182	0	0	16	166	110	56
PCT9244	TO	910	576	0	0	65	511	366	145
PCT9245	MV	616	300	0	0	31	269	169	100
PCT9245	ED	98	127	0	0	14	113	80	33
PCT9245	TO	714	427	0	0	45	382	249	133
PCT9246	MV	815	430	0	0	35	395	258	137
PCT9246	ED	155	194	0	0	23	171	126	45
PCT9246	TO	970	624	0	0	58	566	384	182
PCT9247	MV	764	380	0	0	23	357	257	100
PCT9247	ED	148	204	0	0	28	176	125	51
PCT9247	TO	912	584	0	0	51	533	382	151
PCT9248	MV	757	358	0	0	35	323	245	78
PCT9248	ED	150	190	0	0	18	172	130	42
PCT9248	TO	907	548	0	0	53	495	375	120
PCT9249	MV	724	379	0	0	32	347	246	101
PCT9249	ED	191	213	0	0	17	196	137	59
PCT9249	TO	915	592	0	0	49	543	383	160
PCT9251	MV	792	392	0	0	33	359	234	125
PCT9251	ED	174	235	0	0	20	215	152	63
PCT9251	TO	966	627	0	0	53	574	386	188
PCT9252	MV	811	381	0	0	32	349	217	132
PCT9252	ED	142	175	0	0	14	161	111	50
PCT9252	TO	953	556	0	0	46	510	328	182
PCT9253	MV	599	300	0	0	18	282	188	94
PCT9253	ED	162	148	0	0	16	132	91	41
PCT9253	TO	761	448	0	0	34	414	279	135
PCT9254	MV	758	414	0	0	29	385	285	100
PCT9254	ED	163	181	0	0	28	153	98	55
PCT9254	TO	921	595	0	0	57	538	383	155
PCT9255	MV	436	196	0	0	25	171	112	59
PCT9255	ED	114	133	0	0	14	119	91	28
PCT9255	TO	550	329	0	0	39	290	203	87
PCT9256	MV	367	169	0	0	13	156	114	42
PCT9256	ED	95	114	0	0	11	103	73	30
PCT9256	TO	462	283	0	0	24	259	187	72
PCT9257	MV	359	161	0	0	16	145	124	21
PCT9257	ED	-39	6	0	0	1	5	5	0
PCT9257	TO	320	167	0	0	17	150	129	21
PCT9258	MV	583	306	0	0	29	277	190	87
PCT9258	ED	120	145	0	0	10	135	106	29
PCT9258	TO	703	451	0	0	39	412	296	116
PCT9401	MV	796	358	0	0	19	339	265	74
PCT9401	ED	242	177	0	0	9	168	138	30
PCT9401	TO	1038	535	0	0	28	507	403	104
PCT9402	MV	775	377	0	0	16	361	254	107
PCT9402	ED	242	159	0	0	11	148	119	29
PCT9402	TO	1017	536	0	0	27	509	373	136
PCT9403	MV	731	346	0	0	14	332	222	110
PCT9403	ED	190	126	0	0	6	120	102	18
PCT9403	TO	921	472	0	0	20	452	324	128
PCT9404	MV	753	345	0	0	17	328	211	117
PCT9404	ED	191	155	0	0	10	145	106	39
PCT9404	TO	944	500	0	0	27	473	317	156
PCT9405	MV	629	276	0	0	20	256	160	96
PCT9405	ED	151	104	0	0	4	100	65	35
PCT9405	TO	780	380	0	0	24	356	225	131
PCT9406	MV	695	327	0	0	19	308	198	110
PCT9406	ED	188	152	0	0	6	146	99	47
PCT9406	TO	883	479	0	0	25	454	297	157
PCT9407	MV	712	368	0	0	13	355	264	91
PCT9407	ED	201	132	0	0	13	119	91	28
PCT9407	TO	913	500	0	0	26	474	355	119
PCT9408	MV	711	321	0	0	24	297	235	62
PCT9408	ED	152	126	0	0	12	114	91	23
PCT9408	TO	863	447	0	0	36	411	326	85
PCT9409	MV	443	226	0	0	20	206	157	49
PCT9409	ED	158	127	0	0	5	122	101	21
PCT9409	TO	601	353	0	0	25	328	258	70
PCT9411	MV	816	376	0	0	25	351	259	92
PCT9411	ED	191	135	0	0	6	129	102	27
PCT9411	TO	1007	511	0	0	31	480	361	119
PCT9412	MV	668	339	0	0	20	319	199	120
PCT9412	ED	202	139	0	0	7	132	99	33
PCT9412	TO	870	478	0	0	27	451	298	153
PCT9413	MV	757	375	0	0	35	340	205	135
PCT9413	ED	179	127	0	0	7	120	88	32
PCT9413	TO	936	502	0	0	42	460	293	167
PCT9414	MV	734	360	0	0	22	338	209	129
PCT9414	ED	186	108	0	0	4	104	74	30
PCT9414	TO	920	468	0	0	26	442	283	159
PCT9415	MV	634	314	0	0	18	296	190	106
PCT9415	ED	154	98	0	0	4	94	67	27
PCT9415	TO	788	412	0	0	22	390	257	133
PCT9416	MV	769	391	0	0	34	357	226	131
PCT9416	ED	230	143	0	0	4	139	96	43
PCT9416	TO	999	534	0	0	38	496	322	174
PCT9417	MV	629	321	0	0	21	300	167	133
PCT9417	ED	145	110	0	0	3	107	75	32
PCT9417	TO	774	431	0	0	24	407	242	165
PCT9418	MV	631	310	0	0	22	288	160	128
PCT9418	ED	188	122	0	0	8	114	75	39
PCT9418	TO	819	432	0	0	30	402	235	167
PCT9419	MV	736	369	0	0	23	346	179	167
PCT9419	ED	173	108	0	0	8	100	59	41
PCT9419	TO	909	477	0	0	31	446	238	208
PCT9421	MV	752	338	0	0	25	313	159	154
PCT9421	ED	173	112	0	0	6	106	70	36
PCT9421	TO	925	450	0	0	31	419	229	190
PCT9422	MV	831	412	0	0	27	385	225	160
PCT9422	ED	270	148	0	0	10	138	100	38
PCT9422	TO	1101	560	0	0	37	523	325	198
PCT9423	MV	714	316	0	0	22	294	181	113
PCT9423	ED	190	121	0	0	7	114	84	30
PCT9423	TO	904	437	0	0	29	408	265	143
PCT9424	MV	799	384	0	1	23	360	203	157
PCT9424	ED	210	116	0	0	8	108	78	30
PCT9424	TO	1009	500	0	1	31	468	281	187
PCT9425	MV	789	346	0	0	24	322	189	133
PCT9425	ED	187	115	0	0	7	108	73	35
PCT9425	TO	976	461	0	0	31	430	262	168
PCT9426	MV	697	323	0	0	22	301	158	143
PCT9426	ED	156	104	0	0	12	92	59	33
PCT9426	TO	853	427	0	0	34	393	217	176
PCT9427	MV	799	381	0	1	20	360	188	172
PCT9427	ED	188	115	0	0	13	102	56	46
PCT9427	TO	987	496	0	1	33	462	244	218
PCT9428	MV	811	351	0	0	27	324	194	130
PCT9428	ED	179	115	0	0	8	107	80	27
PCT9428	TO	990	466	0	0	35	431	274	157
PCT9429	MV	709	343	0	0	20	323	173	150
PCT9429	ED	197	124	0	0	16	108	67	41
PCT9429	TO	906	467	0	0	36	431	240	191
PCT9431	MV	832	411	0	0	28	383	203	180
PCT9431	ED	204	125	0	0	4	121	82	39
PCT9431	TO	1036	536	0	0	32	504	285	219
PCT9432	MV	743	358	0	0	31	327	183	144
PCT9432	ED	215	118	0	0	8	110	78	32
PCT9432	TO	958	476	0	0	39	437	261	176
PCT9433	MV	794	373	0	0	29	344	185	159
PCT9433	ED	164	95	0	0	6	89	51	38
PCT9433	TO	958	468	0	0	35	433	236	197
PCT9434	MV	785	387	0	0	28	359	229	130
PCT9434	ED	227	163	0	0	17	146	108	38
PCT9434	TO	1012	550	0	0	45	505	337	168
PCT9435	MV	779	366	0	0	25	341	188	153
PCT9435	ED	225	158	0	0	7	151	99	52
PCT9435	TO	1004	524	0	0	32	492	287	205
PCT9436	MV	842	386	0	0	20	366	204	162
PCT9436	ED	226	129	0	0	9	120	79	41
PCT9436	TO	1068	515	0	0	29	486	283	203
PCT9437	MV	736	376	0	0	18	358	209	149
PCT9437	ED	191	130	0	0	2	128	83	45
PCT9437	TO	927	506	0	0	20	486	292	194
PCT9438	MV	837	416	0	0	22	394	217	177
PCT9438	ED	152	84	0	0	6	78	52	26
PCT9438	TO	989	500	0	0	28	472	269	203
PCT9439	MV	718	343	0	0	17	326	194	132
PCT9439	ED	199	112	0	0	12	100	64	36
PCT9439	TO	917	455	0	0	29	426	258	168
PCT9441	MV	778	396	0	0	29	367	220	147
PCT9441	ED	193	125	0	0	13	112	84	28
PCT9441	TO	971	521	0	0	42	479	304	175
PCT9442	MV	830	378	0	0	37	341	188	153
PCT9442	ED	210	159	0	0	10	149	111	38
PCT9442	TO	1040	537	0	0	47	490	299	191
PCT9443	MV	759	362	0	0	21	341	212	129
PCT9443	ED	196	109	0	0	4	105	72	33
PCT9443	TO	955	471	0	0	25	446	284	162
PCT9444	MV	768	340	0	0	13	327	176	151
PCT9444	ED	197	94	0	0	9	85	59	26
PCT9444	TO	965	434	0	0	22	412	235	177
PCT9445	MV	829	405	0	0	26	379	226	153
PCT9445	ED	167	114	0	0	6	108	70	38
PCT9445	TO	996	519	0	0	32	487	296	191
PCT9446	MV	900	465	0	0	27	438	245	193
PCT9446	ED	216	146	0	0	10	136	92	44
PCT9446	TO	1116	611	0	0	37	574	337	237
PCT9447	MV	729	392	0	0	17	375	211	164
PCT9447	ED	192	146	0	0	13	133	89	44
PCT9447	TO	921	538	0	0	30	508	300	208
PCT9448	MV	742	346	0	0	21	325	189	136
PCT9448	ED	198	128	0	0	6	122	94	28
PCT9448	TO	940	474	0	0	27	447	283	164
PCT9449	MV	719	340	0	0	20	320	152	168
PCT9449	ED	162	98	0	0	7	91	61	30
PCT9449	TO	881	438	0	0	27	411	213	198
PCT9451	MV	353	178	0	0	7	171	86	85
PCT9451	ED	88	55	0	0	2	53	37	16
PCT9451	TO	441	233	0	0	9	224	123	101
PCT9452	MV	647	334	0	0	22	312	168	144
PCT9452	ED	195	134	0	0	10	124	70	54
PCT9452	TO	842	468	0	0	32	436	238	198
PCT9453	MV	409	217	0	0	12	205	105	100
PCT9453	ED	115	70	0	0	7	63	37	26
PCT9453	TO	524	287	0	0	19	268	142	126
PCT9501	MV	158	92	0	0	11	81	58	23
PCT9501	ED	-8	2	0	0	0	2	2	0
PCT9501	TO	150	94	0	0	11	83	60	23
PCT9502	MV	294	136	0	0	12	124	91	33
PCT9502	ED	-43	2	0	0	0	2	2	0
PCT9502	TO	251	138	0	0	12	126	93	33
PCT9503	MV	550	260	0	0	28	232	202	30
PCT9503	ED	150	83	0	0	4	79	66	13
PCT9503	TO	700	343	0	0	32	311	268	43
PCT9505	MV	589	296	0	0	23	273	203	70
PCT9505	ED	176	113	0	0	6	107	87	20
PCT9505	TO	765	409	0	0	29	380	290	90
PCT9506	MV	547	232	0	0	18	214	173	41
PCT9506	ED	207	132	0	0	11	121	103	18
PCT9506	TO	754	364	0	0	29	335	276	59
PCT9507	MV	556	305	0	0	21	284	229	55
PCT9507	ED	160	155	0	0	17	138	113	25
PCT9507	TO	716	460	0	0	38	422	342	80
PCT9508	MV	632	317	0	0	18	299	246	53
PCT9508	ED	148	141	0	0	11	130	114	16
PCT9508	TO	780	458	0	0	29	429	360	69
PCT9509	MV	585	296	0	0	18	278	207	71
PCT9509	ED	142	134	0	0	9	125	106	19
PCT9509	TO	727	430	0	0	27	403	313	90
PCT9511	MV	458	240	0	0	18	222	181	41
PCT9511	ED	176	122	0	0	4	118	97	21
PCT9511	TO	634	362	0	0	22	340	278	62
PCT9512	MV	617	327	0	0	19	308	238	70
PCT9512	ED	160	136	0	0	8	128	111	17
PCT9512	TO	777	463	0	0	27	436	349	87
PCT9513	MV	686	334	0	0	22	312	271	41
PCT9513	ED	191	133	0	0	7	126	111	15
PCT9513	TO	877	467	0	0	29	438	382	56
PCT9514	MV	713	352	0	0	31	321	257	64
PCT9514	ED	183	172	0	0	14	158	136	22
PCT9514	TO	896	524	0	0	45	479	393	86
PCT9515	MV	543	304	0	0	21	283	220	63
PCT9515	ED	169	135	0	0	12	123	95	28
PCT9515	TO	712	439	0	0	33	406	315	91
PCT9516	MV	705	366	0	0	26	340	256	84
PCT9516	ED	184	158	0	0	8	150	107	43
PCT9516	TO	889	524	0	0	34	490	363	127
PCT9517	MV	626	335	0	0	28	307	249	58
PCT9517	ED	162	137	0	0	16	121	104	17
PCT9517	TO	788	472	0	0	44	428	353	75
PCT9518	MV	642	315	0	0	27	288	237	51
PCT9518	ED	146	149	0	0	6	143	107	36
PCT9518	TO	788	464	0	0	33	431	344	87
PCT9519	MV	693	368	0	0	25	343	268	75
PCT9519	ED	198	170	0	0	9	161	118	43
PCT9519	TO	891	538	0	0	34	504	386	118
PCT9521	MV	687	352	0	0	25	327	256	71
PCT9521	ED	214	193	0	0	14	179	151	28
PCT9521	TO	901	545	0	0	39	506	407	99
PCT9701	MV	498	269	0	0	21	248	181	67
PCT9701	ED	156	135	0	0	5	130	107	23
PCT9701	TO	654	404	0	0	26	378	288	90
PCT9702	MV	554	305	0	0	17	288	204	84
PCT9702	ED	166	148	0	0	6	142	121	21
PCT9702	TO	720	453	0	0	23	430	325	105
PCT9703	MV	809	403	0	0	38	365	213	152
PCT9703	ED	182	143	0	0	6	137	96	41
PCT9703	TO	991	546	0	0	44	502	309	193
PCT9704	MV	760	422	0	0	30	392	256	136
PCT9704	ED	199	197	0	0	10	187	141	46
PCT9704	TO	959	619	0	0	40	579	397	182
PCT9705	MV	754	421	0	0	29	392	283	109
PCT9705	ED	175	144	0	0	12	132	108	24
PCT9705	TO	929	565	0	0	41	524	391	133
PCT9706	MV	57	34	0	0	3	31	24	7
PCT9706	ED	-8	0	0	0	0	0	0	0
PCT9706	TO	49	34	0	0	3	31	24	7
PCT9707	MV	687	358	0	0	21	337	192	145
PCT9707	ED	139	102	0	0	8	94	62	32
PCT9707	TO	826	460	0	0	29	431	254	177
PCT9708	MV	786	429	0	1	36	392	280	112
PCT9708	ED	175	158	0	0	5	153	111	42
PCT9708	TO	961	587	0	1	41	545	391	154
PCT9709	MV	831	427	0	0	39	388	221	167
PCT9709	ED	209	181	0	0	7	174	111	63
PCT9709	TO	1040	608	0	0	46	562	332	230
PCT9711	MV	502	307	0	0	18	289	180	109
PCT9711	ED	144	139	0	0	6	133	86	47
PCT9711	TO	646	446	0	0	24	422	266	156
PCT9712	MV	534	335	0	0	21	314	181	133
PCT9712	ED	127	117	0	0	3	114	69	45
PCT9712	TO	661	452	0	0	24	428	250	178
PCT9713	MV	747	389	0	0	19	370	212	158
PCT9713	ED	203	137	0	0	6	131	85	46
PCT9713	TO	950	526	0	0	25	501	297	204
PCT9714	MV	795	446	0	0	31	415	238	177
PCT9714	ED	156	133	0	0	2	131	80	51
PCT9714	TO	951	579	0	0	33	546	318	228
PCT9715	MV	449	241	0	0	15	226	138	88
PCT9715	ED	130	134	0	0	3	131	89	42
PCT9715	TO	579	375	0	0	18	357	227	130
PCT9716	MV	745	398	0	0	30	368	220	148
PCT9716	ED	221	164	0	0	10	154	102	52
PCT9716	TO	966	562	0	0	40	522	322	200
PCT9717	MV	753	436	0	0	27	409	231	178
PCT9717	ED	224	145	0	0	13	132	80	52
PCT9717	TO	977	581	0	0	40	541	311	230
PCT9718	MV	749	449	0	0	28	421	259	162
PCT9718	ED	152	144	0	0	6	138	85	53
PCT9718	TO	901	593	0	0	34	559	344	215
PCT9719	MV	747	461	0	0	23	438	261	177
PCT9719	ED	173	151	0	0	8	143	86	57
PCT9719	TO	920	612	0	0	31	581	347	234
PCT9721	MV	498	288	0	0	18	270	143	127
PCT9721	ED	164	133	0	0	5	128	73	55
PCT9721	TO	662	421	0	0	23	398	216	182
PCT9722	MV	513	315	0	0	19	296	182	114
PCT9722	ED	84	76	0	0	5	71	45	26
PCT9722	TO	597	391	0	0	24	367	227	140
PCT9723	MV	436	223	0	0	9	214	75	139
PCT9723	ED	72	44	0	0	3	41	20	21
PCT9723	TO	508	267	0	0	12	255	95	160
PCT9724	MV	851	451	0	1	24	426	188	238
PCT9724	ED	169	99	0	0	4	95	54	41
PCT9724	TO	1020	550	0	1	28	521	242	279
PCT9725	MV	814	436	0	0	24	412	199	213
PCT9725	ED	157	96	0	0	10	86	35	51
PCT9725	TO	971	532	0	0	34	498	234	264
PCT9726	MV	630	216	0	0	19	197	153	44
PCT9726	ED	-14	102	0	0	6	96	71	25
PCT9726	TO	616	318	0	0	25	293	224	69
PCT9727	MV	404	227	0	2	11	214	117	97
PCT9727	ED	56	33	0	0	2	31	19	12
PCT9727	TO	460	260	0	2	13	245	136	109
PCT9728	MV	751	446	0	0	25	421	216	205
PCT9728	ED	212	137	0	0	8	129	78	51
PCT9728	TO	963	583	0	0	33	550	294	256
PCT9729	MV	654	335	0	0	22	313	158	155
PCT9729	ED	164	129	0	0	3	126	78	48
PCT9729	TO	818	464	0	0	25	439	236	203
PCT9731	MV	436	245	0	0	15	230	121	109
PCT9731	ED	143	111	0	0	9	102	59	43
PCT9731	TO	579	356	0	0	24	332	180	152
PCT9732	MV	78	47	0	0	6	41	22	19
PCT9732	ED	-5	0	0	0	0	0	0	0
PCT9732	TO	73	47	0	0	6	41	22	19
PCT9733	MV	261	161	0	0	4	157	114	43
PCT9733	ED	-21	0	0	0	0	0	0	0
PCT9733	TO	240	161	0	0	4	157	114	43
PCT9734	MV	473	285	0	0	17	268	150	118
PCT9734	ED	131	109	0	0	3	106	66	40
PCT9734	TO	604	394	0	0	20	374	216	158
PCT9735	MV	650	386	0	0	20	366	213	153
PCT9735	ED	170	133	0	0	16	117	67	50
PCT9735	TO	820	519	0	0	36	483	280	203
PCT9736	MV	586	323	0	0	21	302	196	106
PCT9736	ED	150	153	0	0	11	142	94	48
PCT9736	TO	736	476	0	0	32	444	290	154
PCT9737	MV	637	387	0	0	22	365	205	160
PCT9737	ED	154	135	0	0	7	128	90	38
PCT9737	TO	791	522	0	0	29	493	295	198
PCT9738	MV	688	319	0	0	22	297	221	76
PCT9738	ED	150	64	0	0	5	59	41	18
PCT9738	TO	838	383	0	0	27	356	262	94
PCT9739	MV	674	270	0	0	10	260	213	47
PCT9739	ED	115	88	0	0	3	85	71	14
PCT9739	TO	789	358	0	0	13	345	284	61
PCT9741	MV	837	173	0	0	15	158	147	11
PCT9741	ED	-396	10	0	0	2	8	8	0
PCT9741	TO	441	183	0	0	17	166	155	11
PCT9742	MV	530	229	0	0	10	219	112	107
PCT9742	ED	165	99	0	0	6	93	49	44
PCT9742	TO	695	328	0	0	16	312	161	151
PCT9743	MV	913	400	0	0	21	379	281	98
PCT9743	ED	227	170	0	0	13	157	130	27
PCT9743	TO	1140	570	0	0	34	536	411	125
PCT9744	MV	783	333	0	0	22	311	247	64
PCT9744	ED	160	123	0	0	10	113	94	19
PCT9744	TO	943	456	0	0	32	424	341	83
PCT9745	MV	790	317	0	0	23	294	243	51
PCT9745	ED	202	128	0	0	11	117	104	13
PCT9745	TO	992	445	0	0	34	411	347	64
PCT9746	MV	714	373	0	0	13	360	219	141
PCT9746	ED	189	119	0	0	11	108	66	42
PCT9746	TO	903	492	0	0	24	468	285	183
PCT9747	MV	772	401	0	0	18	383	257	126
PCT9747	ED	204	145	0	0	10	135	103	32
PCT9747	TO	976	546	0	0	28	518	360	158
PCT9748	MV	746	425	0	1	22	402	268	134
PCT9748	ED	167	116	0	0	4	112	68	44
PCT9748	TO	913	541	0	1	26	514	336	178
PCT9749	MV	750	289	0	0	9	280	196	84
PCT9749	ED	188	108	0	0	2	106	82	24
PCT9749	TO	938	397	0	0	11	386	278	108
PCT9751	MV	857	472	0	1	29	442	274	168
PCT9751	ED	214	153	0	0	15	138	101	37
PCT9751	TO	1071	625	0	1	44	580	375	205
PCT9752	MV	563	327	0	0	20	307	182	125
PCT9752	ED	134	108	0	0	3	105	77	28
PCT9752	TO	697	435	0	0	23	412	259	153
PCT9753	MV	617	298	0	0	18	280	204	76
PCT9753	ED	145	123	0	0	2	121	98	23
PCT9753	TO	762	421	0	0	20	401	302	99
PCT9754	MV	545	317	0	0	15	302	228	74
PCT9754	ED	162	113	0	0	8	105	86	19
PCT9754	TO	707	430	0	0	23	407	314	93
PCT9755	MV	441	238	0	0	18	220	150	70
PCT9755	ED	139	99	0	0	2	97	71	26
PCT9755	TO	580	337	0	0	20	317	221	96
PCT9756	MV	805	364	0	0	23	341	194	147
PCT9756	ED	162	106	0	0	5	101	71	30
PCT9756	TO	967	470	0	0	28	442	265	177
PCT9801	MV	320	163	0	0	12	151	109	42
PCT9801	ED	88	52	0	0	3	49	41	8
PCT9801	TO	408	215	0	0	15	200	150	50
PCT9900	MV	0	0	0	0	0	0	0	0
PCT9900	ED	0	0	0	0	0	0	0	0
PCT9900	TO	0	0	0	0	0	0	0	0
PCT9901	MV	0	0	0	0	0	0	0	0
PCT9901	ED	0	0	0	0	0	0	0	0
PCT9901	TO	0	0	0	0	0	0	0	0
PCT9902	MV	0	0	0	0	0	0	0	0
PCT9902	ED	0	0	0	0	0	0	0	0
PCT9902	TO	0	0	0	0	0	0	0	0
CONG12	MV	355594	174452	0	28	13007	161417	114208	47209
CONG12	ED	90254	71265	0	10	5560	65695	50407	15288
CONG12	TO	445848	245717	0	38	18567	227112	164615	62497
CONG14	MV	47252	22340	0	10	1218	21112	13181	7931
CONG14	ED	10799	6956	0	0	408	6548	4636	1912
CONG14	TO	58051	29296	0	10	1626	27660	17817	9843
ASSM17	MV	232787	114347	0	17	8539	105791	77793	27998
ASSM17	ED	59635	43919	0	10	3282	40627	32324	8303
ASSM17	TO	292422	158266	0	27	11821	146418	110117	36301
ASSM19	MV	170059	82445	0	21	5686	76738	49596	27142
ASSM19	ED	41418	34302	0	0	2686	31616	22719	8897
ASSM19	TO	211477	116747	0	21	8372	108354	72315	36039
SUPV1	MV	33868	16565	0	2	1140	15423	10589	4834
SUPV1	ED	9248	8530	0	0	653	7877	5916	1961
SUPV1	TO	43116	25095	0	2	1793	23300	16505	6795
SUPV2	MV	41435	19971	0	7	1823	18141	11766	6375
SUPV2	ED	8611	10149	0	0	1143	9006	6190	2816
SUPV2	TO	50046	30120	0	7	2966	27147	17956	9191
SUPV3	MV	31943	14408	0	4	1284	13120	9088	4032
SUPV3	ED	7434	6360	0	4	622	5734	4415	1319
SUPV3	TO	39377	20768	0	8	1906	18854	13503	5351
SUPV4	MV	35049	16862	0	2	1062	15798	9420	6378
SUPV4	ED	9045	5910	0	0	382	5528	3886	1642
SUPV4	TO	44094	22772	0	2	1444	21326	13306	8020
SUPV5	MV	41966	21496	0	1	1680	19815	15733	4082
SUPV5	ED	10934	9272	0	1	692	8579	7091	1488
SUPV5	TO	52900	30768	0	2	2372	28394	22824	5570
SUPV6	MV	35755	15225	0	2	1248	13975	10231	3744
SUPV6	ED	7940	4383	0	1	394	3988	3136	852
SUPV6	TO	43695	19608	0	3	1642	17963	13367	4596
SUPV7	MV	38887	20717	0	7	1277	19433	12253	7180
SUPV7	ED	8556	7211	0	0	397	6814	4686	2128
SUPV7	TO	47443	27928	0	7	1674	26247	16939	9308
SUPV8	MV	46370	27474	0	5	1995	25474	19264	6210
SUPV8	ED	11807	11114	0	4	740	10370	8296	2074
SUPV8	TO	58177	38588	0	9	2735	35844	27560	8284
SUPV9	MV	33165	16755	0	1	1052	15702	12001	3701
SUPV9	ED	10098	7086	0	0	402	6684	5535	1149
SUPV9	TO	43263	23841	0	1	1454	22386	17536	4850
SUPV10	MV	33765	13891	0	2	948	12941	8948	3993
SUPV10	ED	9348	4201	0	0	305	3896	3065	831
SUPV10	TO	43113	18092	0	2	1253	16837	12013	4824
SUPV11	MV	30643	13428	0	5	716	12707	8096	4611
SUPV11	ED	8032	4005	0	0	238	3767	2827	940
SUPV11	TO	38675	17433	0	5	954	16474	10923	5551
NEIG1	MV	15464	5936	0	1	396	5539	3780	1759
NEIG1	ED	5021	1551	0	0	90	1461	1165	296
NEIG1	TO	20485	7487	0	1	486	7000	4945	2055
NEIG2	MV	14029	6273	0	0	625	5648	3779	1869
NEIG2	ED	3238	2776	0	2	303	2471	1863	608
NEIG2	TO	17267	9049	0	2	928	8119	5642	2477
NEIG3	MV	22050	9495	0	4	808	8683	6647	2036
NEIG3	ED	5969	3742	0	1	318	3423	2756	667
NEIG3	TO	28019	13237	0	5	1126	12106	9403	2703
NEIG4	MV	5630	3491	0	0	232	3259	2286	973
NEIG4	ED	1430	1237	0	1	84	1152	832	320
NEIG4	TO	7060	4728	0	1	316	4411	3118	1293
NEIG5	MV	22700	10117	0	1	570	9546	6063	3483
NEIG5	ED	5893	2969	0	0	179	2790	2058	732
NEIG5	TO	28593	13086	0	1	749	12336	8121	4215
NEIG6	MV	11526	5963	0	1	438	5524	4465	1059
NEIG6	ED	2336	2800	0	1	203	2596	2185	411
NEIG6	TO	13862	8763	0	2	641	8120	6650	1470
NEIG7	MV	9818	4127	0	4	190	3933	2532	1401
NEIG7	ED	2577	1302	0	0	69	1233	963	270
NEIG7	TO	12395	5429	0	4	259	5166	3495	1671
NEIG8	MV	7628	4025	0	0	309	3716	2875	841
NEIG8	ED	2030	1847	0	0	126	1721	1375	346
NEIG8	TO	9658	5872	0	0	435	5437	4250	1187
NEIG9	MV	7416	3138	0	1	189	2948	1967	981
NEIG9	ED	842	924	0	0	67	857	628	229
NEIG9	TO	8258	4062	0	1	256	3805	2595	1210
NEIG10	MV	8172	3949	0	0	306	3643	2566	1077
NEIG10	ED	1850	1947	0	0	155	1792	1351	441
NEIG10	TO	10022	5896	0	0	461	5435	3917	1518
NEIG11	MV	33509	15520	0	6	1470	14044	9114	4930
NEIG11	ED	5931	7800	0	0	935	6865	4733	2132
NEIG11	TO	39440	23320	0	6	2405	20909	13847	7062
NEIG12	MV	23572	11845	0	0	781	11064	9062	2002
NEIG12	ED	7433	5298	0	0	351	4947	4238	709
NEIG12	TO	31005	17143	0	0	1132	16011	13300	2711
NEIG14	MV	6791	3984	0	0	269	3715	2955	760
NEIG14	ED	1942	1788	0	0	83	1705	1419	286
NEIG14	TO	8733	5772	0	0	352	5420	4374	1046
NEIG15	MV	5779	2672	0	1	180	2491	1652	839
NEIG15	ED	1309	1165	0	2	104	1059	814	245
NEIG15	TO	7088	3837	0	3	284	3550	2466	1084
NEIG13	MV	13553	8149	0	2	618	7529	5570	1959
NEIG13	ED	3435	3370	0	0	210	3160	2480	680
NEIG13	TO	16988	11519	0	2	828	10689	8050	2639
NEIG26	MV	7830	3522	0	1	206	3315	1917	1398
NEIG26	ED	1802	947	0	0	51	896	627	269
NEIG26	TO	9632	4469	0	1	257	4211	2544	1667
NEIG16	MV	14623	6798	0	1	565	6232	4494	1738
NEIG16	ED	2733	2413	0	0	212	2201	1745	456
NEIG16	TO	17356	9211	0	1	777	8433	6239	2194
NEIG17	MV	29447	14398	0	2	995	13401	9142	4259
NEIG17	ED	8178	7475	0	0	572	6903	5176	1727
NEIG17	TO	37625	21873	0	2	1567	20304	14318	5986
NEIG19	MV	7165	4013	0	1	254	3758	2888	870
NEIG19	ED	2406	1869	0	0	108	1761	1430	331
NEIG19	TO	9571	5882	0	1	362	5519	4318	1201
NEIG18	MV	6458	3411	0	1	258	3152	2002	1150
NEIG18	ED	1563	1828	0	0	168	1660	1138	522
NEIG18	TO	8021	5239	0	1	426	4812	3140	1672
NEIG20	MV	20910	8905	0	1	711	8193	5828	2365
NEIG20	ED	4167	2452	0	0	228	2224	1692	532
NEIG20	TO	25077	11357	0	1	939	10417	7520	2897
NEIG21	MV	34606	16636	0	2	1042	15592	9263	6329
NEIG21	ED	8887	5783	0	0	377	5406	3785	1621
NEIG21	TO	43493	22419	0	2	1419	20998	13048	7950
NEIG22	MV	15381	9289	0	2	670	8617	6576	2041
NEIG22	ED	3512	3613	0	3	240	3370	2720	650
NEIG22	TO	18893	12902	0	5	910	11987	9296	2691
NEIG23	MV	6638	2508	0	0	137	2371	1451	920
NEIG23	ED	1850	598	0	0	48	550	403	147
NEIG23	TO	8488	3106	0	0	185	2921	1854	1067
NEIG24	MV	28439	16094	0	6	1004	15084	9328	5756
NEIG24	ED	6935	5684	0	0	304	5380	3606	1774
NEIG24	TO	35374	21778	0	6	1308	20464	12934	7530
NEIG25	MV	23712	12534	0	0	1002	11532	9187	2345
NEIG25	ED	7784	5043	0	0	383	4660	3861	799
NEIG25	TO	31496	17577	0	0	1385	16192	13048	3144
