area_id	subtotal_type	RSReg	RSCst	RSRej	RSOvr	RSUnd	RSTot	3:YES	4:NO
ALLPCTS	TO	503899	304904	0	52	24419	280433	203002	77431
ALLPCTS	ED	101264	107001	0	13	10060	96928	74846	22082
ALLPCTS	MV	402635	197903	0	39	14359	183505	128156	55349
PCT1101	MV	448	216	0	0	15	201	128	73
PCT1101	ED	114	93	0	0	7	86	73	13
PCT1101	TO	562	309	0	0	22	287	201	86
PCT1102	MV	774	370	0	0	19	351	230	121
PCT1102	ED	230	209	0	0	16	193	138	55
PCT1102	TO	1004	579	0	0	35	544	368	176
PCT1103	MV	749	373	0	0	19	354	239	115
PCT1103	ED	222	194	0	0	12	182	133	49
PCT1103	TO	971	567	0	0	31	536	372	164
PCT1104	MV	751	343	0	0	13	330	237	93
PCT1104	ED	267	169	0	0	14	155	118	37
PCT1104	TO	1018	512	0	0	27	485	355	130
PCT1106	MV	598	255	0	0	12	243	134	109
PCT1106	ED	173	149	0	0	10	139	107	32
PCT1106	TO	771	404	0	0	22	382	241	141
PCT1107	MV	612	288	0	0	17	271	172	99
PCT1107	ED	139	125	0	0	8	117	92	25
PCT1107	TO	751	413	0	0	25	388	264	124
PCT1108	MV	725	360	0	0	21	339	234	105
PCT1108	ED	198	159	0	0	17	142	107	35
PCT1108	TO	923	519	0	0	38	481	341	140
PCT1109	MV	653	285	0	0	14	271	159	112
PCT1109	ED	169	141	0	0	10	131	103	28
PCT1109	TO	822	426	0	0	24	402	262	140
PCT1111	MV	849	354	0	0	18	336	201	135
PCT1111	ED	197	189	0	0	10	179	140	39
PCT1111	TO	1046	543	0	0	28	515	341	174
PCT1112	MV	643	280	0	0	15	265	180	85
PCT1112	ED	159	119	0	0	7	112	91	21
PCT1112	TO	802	399	0	0	22	377	271	106
PCT1113	MV	675	286	0	0	13	273	174	99
PCT1113	ED	120	108	0	0	16	92	74	18
PCT1113	TO	795	394	0	0	29	365	248	117
PCT1114	MV	769	328	0	0	22	306	224	82
PCT1114	ED	222	167	0	0	16	151	128	23
PCT1114	TO	991	495	0	0	38	457	352	105
PCT1115	MV	743	295	0	0	15	280	177	103
PCT1115	ED	193	131	0	0	12	119	97	22
PCT1115	TO	936	426	0	0	27	399	274	125
PCT1116	MV	715	309	0	0	17	292	186	106
PCT1116	ED	216	197	0	0	15	182	155	27
PCT1116	TO	931	506	0	0	32	474	341	133
PCT1117	MV	665	259	0	0	15	244	164	80
PCT1117	ED	181	152	0	0	15	137	109	28
PCT1117	TO	846	411	0	0	30	381	273	108
PCT1118	MV	846	366	0	1	12	353	222	131
PCT1118	ED	219	164	0	0	13	151	114	37
PCT1118	TO	1065	530	0	1	25	504	336	168
PCT1119	MV	659	305	0	0	12	293	204	89
PCT1119	ED	138	117	0	0	10	107	89	18
PCT1119	TO	797	422	0	0	22	400	293	107
PCT1121	MV	556	269	0	0	21	248	140	108
PCT1121	ED	149	123	0	0	8	115	80	35
PCT1121	TO	705	392	0	0	29	363	220	143
PCT1122	MV	519	247	0	0	18	229	117	112
PCT1122	ED	118	97	0	0	7	90	62	28
PCT1122	TO	637	344	0	0	25	319	179	140
PCT1123	MV	730	258	0	1	10	247	170	77
PCT1123	ED	208	151	0	0	14	137	113	24
PCT1123	TO	938	409	0	1	24	384	283	101
PCT1124	MV	631	246	0	2	7	237	146	91
PCT1124	ED	198	125	0	0	7	118	102	16
PCT1124	TO	829	371	0	2	14	355	248	107
PCT1125	MV	919	365	0	1	27	337	194	143
PCT1125	ED	178	115	0	0	11	104	90	14
PCT1125	TO	1097	480	0	1	38	441	284	157
PCT1126	MV	812	308	0	0	15	293	210	83
PCT1126	ED	200	108	0	0	6	102	79	23
PCT1126	TO	1012	416	0	0	21	395	289	106
PCT1127	MV	743	295	0	0	10	285	155	130
PCT1127	ED	222	148	0	0	5	143	105	38
PCT1127	TO	965	443	0	0	15	428	260	168
PCT1128	MV	734	287	0	0	12	275	153	122
PCT1128	ED	145	108	0	0	9	99	77	22
PCT1128	TO	879	395	0	0	21	374	230	144
PCT1129	MV	790	314	0	0	21	293	173	120
PCT1129	ED	246	146	0	0	16	130	95	35
PCT1129	TO	1036	460	0	0	37	423	268	155
PCT1131	MV	694	280	0	0	25	255	142	113
PCT1131	ED	166	111	0	0	9	102	83	19
PCT1131	TO	860	391	0	0	34	357	225	132
PCT1132	MV	838	370	0	0	27	343	214	129
PCT1132	ED	194	103	0	0	7	96	63	33
PCT1132	TO	1032	473	0	0	34	439	277	162
PCT1133	MV	716	336	0	0	9	327	209	118
PCT1133	ED	159	113	0	0	7	106	68	38
PCT1133	TO	875	449	0	0	16	433	277	156
PCT1134	MV	585	293	0	0	9	284	153	131
PCT1134	ED	182	127	0	0	13	114	99	15
PCT1134	TO	767	420	0	0	22	398	252	146
PCT1135	MV	465	220	0	0	6	214	131	83
PCT1135	ED	91	61	0	0	1	60	41	19
PCT1135	TO	556	281	0	0	7	274	172	102
PCT1136	MV	710	342	0	0	15	327	200	127
PCT1136	ED	157	117	0	0	10	107	83	24
PCT1136	TO	867	459	0	0	25	434	283	151
PCT1141	MV	836	394	0	0	22	372	238	134
PCT1141	ED	220	185	0	0	10	175	132	43
PCT1141	TO	1056	579	0	0	32	547	370	177
PCT1142	MV	721	330	0	0	27	303	206	97
PCT1142	ED	175	119	0	0	6	113	91	22
PCT1142	TO	896	449	0	0	33	416	297	119
PCT1143	MV	824	360	0	0	26	334	226	108
PCT1143	ED	225	189	0	0	14	175	148	27
PCT1143	TO	1049	549	0	0	40	509	374	135
PCT1144	MV	727	327	0	0	12	315	202	113
PCT1144	ED	220	165	0	0	18	147	110	37
PCT1144	TO	947	492	0	0	30	462	312	150
PCT1145	MV	753	411	0	0	25	386	251	135
PCT1145	ED	152	152	0	0	8	144	106	38
PCT1145	TO	905	563	0	0	33	530	357	173
PCT1146	MV	839	364	0	0	17	347	243	104
PCT1146	ED	215	159	0	0	11	148	113	35
PCT1146	TO	1054	523	0	0	28	495	356	139
PCT1147	MV	673	310	0	0	13	297	198	99
PCT1147	ED	212	159	0	0	13	146	112	34
PCT1147	TO	885	469	0	0	26	443	310	133
PCT1148	MV	804	370	0	0	18	352	212	140
PCT1148	ED	224	158	0	0	15	143	107	36
PCT1148	TO	1028	528	0	0	33	495	319	176
PCT1149	MV	710	320	0	0	23	297	192	105
PCT1149	ED	229	161	0	0	11	150	113	37
PCT1149	TO	939	481	0	0	34	447	305	142
PCT1151	MV	0	0	0	0	0	0	0	0
PCT1151	ED	0	0	0	0	0	0	0	0
PCT1151	TO	0	0	0	0	0	0	0	0
PCT1152	MV	710	315	0	0	19	296	210	86
PCT1152	ED	180	137	0	0	9	128	101	27
PCT1152	TO	890	452	0	0	28	424	311	113
PCT1153	MV	730	285	0	0	18	267	185	82
PCT1153	ED	210	181	0	0	12	169	108	61
PCT1153	TO	940	466	0	0	30	436	293	143
PCT1154	MV	0	0	0	0	0	0	0	0
PCT1154	ED	0	0	0	0	0	0	0	0
PCT1154	TO	0	0	0	0	0	0	0	0
PCT7001	MV	632	331	0	0	21	310	232	78
PCT7001	ED	141	149	0	0	13	136	115	21
PCT7001	TO	773	480	0	0	34	446	347	99
PCT7002	MV	598	270	0	1	24	245	179	66
PCT7002	ED	116	142	0	0	15	127	103	24
PCT7002	TO	714	412	0	1	39	372	282	90
PCT7003	MV	759	435	0	0	29	406	301	105
PCT7003	ED	147	193	0	0	21	172	131	41
PCT7003	TO	906	628	0	0	50	578	432	146
PCT7004	MV	764	418	0	0	30	388	290	98
PCT7004	ED	149	225	0	0	24	201	162	39
PCT7004	TO	913	643	0	0	54	589	452	137
PCT7005	MV	698	351	0	0	26	325	253	72
PCT7005	ED	161	230	0	0	28	202	161	41
PCT7005	TO	859	581	0	0	54	527	414	113
PCT7006	MV	729	361	0	0	28	333	259	74
PCT7006	ED	203	240	0	0	18	222	176	46
PCT7006	TO	932	601	0	0	46	555	435	120
PCT7007	MV	777	438	0	0	36	402	286	116
PCT7007	ED	180	242	0	0	20	222	184	38
PCT7007	TO	957	680	0	0	56	624	470	154
PCT7008	MV	732	369	0	0	42	327	237	90
PCT7008	ED	177	254	0	0	24	230	177	53
PCT7008	TO	909	623	0	0	66	557	414	143
PCT7009	MV	752	391	0	0	23	368	268	100
PCT7009	ED	119	160	0	0	15	145	105	40
PCT7009	TO	871	551	0	0	38	513	373	140
PCT7011	MV	704	231	0	0	16	215	160	55
PCT7011	ED	269	142	0	0	10	132	107	25
PCT7011	TO	973	373	0	0	26	347	267	80
PCT7012	MV	999	489	0	0	35	454	341	113
PCT7012	ED	227	308	0	0	36	272	209	63
PCT7012	TO	1226	797	0	0	71	726	550	176
PCT7013	MV	984	431	0	0	33	398	310	88
PCT7013	ED	155	259	0	0	30	229	180	49
PCT7013	TO	1139	690	0	0	63	627	490	137
PCT7014	MV	610	305	0	0	30	275	217	58
PCT7014	ED	109	182	0	0	28	154	127	27
PCT7014	TO	719	487	0	0	58	429	344	85
PCT7015	MV	110	41	0	0	4	37	33	4
PCT7015	ED	0	5	0	0	0	5	3	2
PCT7015	TO	110	46	0	0	4	42	36	6
PCT7016	MV	655	239	0	0	16	223	147	76
PCT7016	ED	277	124	0	0	10	114	99	15
PCT7016	TO	932	363	0	0	26	337	246	91
PCT7017	MV	543	182	0	0	15	167	130	37
PCT7017	ED	238	92	0	0	10	82	73	9
PCT7017	TO	781	274	0	0	25	249	203	46
PCT7018	MV	847	358	0	0	23	335	208	127
PCT7018	ED	200	103	0	0	8	95	81	14
PCT7018	TO	1047	461	0	0	31	430	289	141
PCT7019	MV	734	356	0	0	23	333	213	120
PCT7019	ED	166	112	0	0	12	100	78	22
PCT7019	TO	900	468	0	0	35	433	291	142
PCT7021	MV	679	271	0	0	15	256	198	58
PCT7021	ED	288	159	0	0	13	146	124	22
PCT7021	TO	967	430	0	0	28	402	322	80
PCT7022	MV	770	340	0	1	22	317	249	68
PCT7022	ED	193	93	0	0	6	87	75	12
PCT7022	TO	963	433	0	1	28	404	324	80
PCT7023	MV	687	331	0	0	18	313	235	78
PCT7023	ED	233	118	0	0	10	108	92	16
PCT7023	TO	920	449	0	0	28	421	327	94
PCT7024	MV	251	51	0	0	2	49	44	5
PCT7024	ED	190	35	0	0	5	30	28	2
PCT7024	TO	441	86	0	0	7	79	72	7
PCT7025	MV	316	97	0	0	4	93	76	17
PCT7025	ED	167	66	0	0	1	65	55	10
PCT7025	TO	483	163	0	0	5	158	131	27
PCT7026	MV	819	337	0	0	14	323	169	154
PCT7026	ED	191	125	0	0	12	113	84	29
PCT7026	TO	1010	462	0	0	26	436	253	183
PCT7027	MV	677	272	0	0	14	258	164	94
PCT7027	ED	219	143	0	0	9	134	110	24
PCT7027	TO	896	415	0	0	23	392	274	118
PCT7028	MV	586	221	0	0	17	204	158	46
PCT7028	ED	270	151	0	0	9	142	115	27
PCT7028	TO	856	372	0	0	26	346	273	73
PCT7029	MV	643	209	0	0	15	194	150	44
PCT7029	ED	266	82	0	0	6	76	65	11
PCT7029	TO	909	291	0	0	21	270	215	55
PCT7030	MV	654	274	0	0	11	263	146	117
PCT7030	ED	141	80	0	0	5	75	44	31
PCT7030	TO	795	354	0	0	16	338	190	148
PCT7031	MV	622	265	0	0	24	241	156	85
PCT7031	ED	72	78	0	0	8	70	52	18
PCT7031	TO	694	343	0	0	32	311	208	103
PCT7032	MV	643	266	0	0	18	248	176	72
PCT7032	ED	238	105	0	0	9	96	77	19
PCT7032	TO	881	371	0	0	27	344	253	91
PCT7033	MV	549	214	0	0	17	197	138	59
PCT7033	ED	229	136	0	0	11	125	101	24
PCT7033	TO	778	350	0	0	28	322	239	83
PCT7034	MV	620	142	0	0	15	127	113	14
PCT7034	ED	318	111	0	0	9	102	90	12
PCT7034	TO	938	253	0	0	24	229	203	26
PCT7035	MV	567	238	0	0	20	218	152	66
PCT7035	ED	152	101	0	0	9	92	73	19
PCT7035	TO	719	339	0	0	29	310	225	85
PCT7036	MV	781	267	0	0	16	251	162	89
PCT7036	ED	193	79	0	0	7	72	61	11
PCT7036	TO	974	346	0	0	23	323	223	100
PCT7037	MV	434	64	0	0	0	64	51	13
PCT7037	ED	312	65	0	0	10	55	52	3
PCT7037	TO	746	129	0	0	10	119	103	16
PCT7038	MV	758	308	0	0	16	292	175	117
PCT7038	ED	203	105	0	0	13	92	76	16
PCT7038	TO	961	413	0	0	29	384	251	133
PCT7039	MV	636	244	0	0	16	228	128	100
PCT7039	ED	201	146	0	0	5	141	97	44
PCT7039	TO	837	390	0	0	21	369	225	144
PCT7041	MV	66	29	0	0	3	26	16	10
PCT7041	ED	0	2	0	0	0	2	1	1
PCT7041	TO	66	31	0	0	3	28	17	11
PCT7042	MV	514	224	0	0	11	213	146	67
PCT7042	ED	146	96	0	0	4	92	71	21
PCT7042	TO	660	320	0	0	15	305	217	88
PCT7043	MV	754	295	0	0	22	273	178	95
PCT7043	ED	224	122	0	0	9	113	82	31
PCT7043	TO	978	417	0	0	31	386	260	126
PCT7044	MV	586	150	0	0	4	146	107	39
PCT7044	ED	266	95	0	0	11	84	69	15
PCT7044	TO	852	245	0	0	15	230	176	54
PCT7045	MV	632	268	0	0	16	252	148	104
PCT7045	ED	154	80	0	0	10	70	51	19
PCT7045	TO	786	348	0	0	26	322	199	123
PCT7046	MV	334	134	0	0	9	125	75	50
PCT7046	ED	96	76	0	0	4	72	58	14
PCT7046	TO	430	210	0	0	13	197	133	64
PCT7047	MV	733	315	0	0	12	303	178	125
PCT7047	ED	150	100	0	0	10	90	72	18
PCT7047	TO	883	415	0	0	22	393	250	143
PCT7048	MV	685	267	0	0	15	252	177	75
PCT7048	ED	196	80	0	0	6	74	61	13
PCT7048	TO	881	347	0	0	21	326	238	88
PCT7049	MV	616	248	0	0	15	233	132	101
PCT7049	ED	210	104	0	0	11	93	65	28
PCT7049	TO	826	352	0	0	26	326	197	129
PCT7051	MV	715	311	0	0	22	289	158	131
PCT7051	ED	165	105	0	0	7	98	73	25
PCT7051	TO	880	416	0	0	29	387	231	156
PCT7052	MV	722	298	0	0	12	286	157	129
PCT7052	ED	184	135	0	0	11	124	94	30
PCT7052	TO	906	433	0	0	23	410	251	159
PCT7053	MV	542	227	0	0	31	196	101	95
PCT7053	ED	43	70	0	0	4	66	45	21
PCT7053	TO	585	297	0	0	35	262	146	116
PCT7054	MV	863	310	0	0	21	289	220	69
PCT7054	ED	273	170	0	0	7	163	123	40
PCT7054	TO	1136	480	0	0	28	452	343	109
PCT7055	MV	732	292	0	0	21	271	182	89
PCT7055	ED	94	150	0	0	19	131	103	28
PCT7055	TO	826	442	0	0	40	402	285	117
PCT7056	MV	619	277	0	0	23	254	184	70
PCT7056	ED	86	179	0	0	24	155	120	35
PCT7056	TO	705	456	0	0	47	409	304	105
PCT7101	MV	147	99	0	0	6	93	84	9
PCT7101	ED	0	9	0	0	3	6	6	0
PCT7101	TO	147	108	0	0	9	99	90	9
PCT7201	MV	789	384	0	0	32	352	226	126
PCT7201	ED	146	195	0	0	28	167	129	38
PCT7201	TO	935	579	0	0	60	519	355	164
PCT7202	MV	708	309	0	0	30	279	182	97
PCT7202	ED	143	188	0	0	21	167	118	49
PCT7202	TO	851	497	0	0	51	446	300	146
PCT7203	MV	693	321	0	0	37	284	185	99
PCT7203	ED	186	217	0	0	27	190	134	56
PCT7203	TO	879	538	0	0	64	474	319	155
PCT7204	MV	773	425	0	0	48	377	267	110
PCT7204	ED	126	206	0	0	34	172	120	52
PCT7204	TO	899	631	0	0	82	549	387	162
PCT7205	MV	724	360	0	1	26	333	224	109
PCT7205	ED	147	203	0	0	20	183	134	49
PCT7205	TO	871	563	0	1	46	516	358	158
PCT7206	MV	299	129	0	0	8	121	83	38
PCT7206	ED	78	130	0	0	17	113	82	31
PCT7206	TO	377	259	0	0	25	234	165	69
PCT7207	MV	744	333	0	0	28	305	197	108
PCT7207	ED	123	177	0	0	18	159	120	39
PCT7207	TO	867	510	0	0	46	464	317	147
PCT7208	MV	492	254	0	0	28	226	156	70
PCT7208	ED	78	110	0	0	15	95	84	11
PCT7208	TO	570	364	0	0	43	321	240	81
PCT7209	MV	595	343	0	0	27	316	219	97
PCT7209	ED	52	82	0	0	7	75	61	14
PCT7209	TO	647	425	0	0	34	391	280	111
PCT7301	MV	813	319	0	0	21	298	209	89
PCT7301	ED	201	154	0	0	14	140	102	38
PCT7301	TO	1014	473	0	0	35	438	311	127
PCT7302	MV	713	352	0	0	28	324	219	105
PCT7302	ED	136	153	0	0	15	138	102	36
PCT7302	TO	849	505	0	0	43	462	321	141
PCT7303	MV	869	376	0	0	24	352	240	112
PCT7303	ED	199	255	0	0	41	214	167	47
PCT7303	TO	1068	631	0	0	65	566	407	159
PCT7304	MV	803	367	0	0	29	338	223	115
PCT7304	ED	198	239	0	0	21	218	165	53
PCT7304	TO	1001	606	0	0	50	556	388	168
PCT7305	MV	714	390	0	0	28	362	219	143
PCT7305	ED	153	206	0	0	14	192	141	51
PCT7305	TO	867	596	0	0	42	554	360	194
PCT7306	MV	801	375	0	0	47	328	198	130
PCT7306	ED	243	222	0	0	34	188	140	48
PCT7306	TO	1044	597	0	0	81	516	338	178
PCT7307	MV	605	276	0	0	16	260	175	85
PCT7307	ED	169	155	0	1	24	130	106	24
PCT7307	TO	774	431	0	1	40	390	281	109
PCT7308	MV	520	257	0	0	12	245	166	79
PCT7308	ED	105	175	0	1	16	158	124	34
PCT7308	TO	625	432	0	1	28	403	290	113
PCT7309	MV	691	324	0	0	33	291	200	91
PCT7309	ED	167	214	0	0	21	193	149	44
PCT7309	TO	858	538	0	0	54	484	349	135
PCT7311	MV	698	336	0	0	28	308	219	89
PCT7311	ED	208	250	0	0	22	228	172	56
PCT7311	TO	906	586	0	0	50	536	391	145
PCT7312	MV	700	397	0	0	30	367	235	132
PCT7312	ED	110	176	0	0	18	158	111	47
PCT7312	TO	810	573	0	0	48	525	346	179
PCT7313	MV	819	375	0	0	24	351	230	121
PCT7313	ED	184	181	0	0	29	152	109	43
PCT7313	TO	1003	556	0	0	53	503	339	164
PCT7314	MV	612	226	0	0	25	201	139	62
PCT7314	ED	147	89	0	0	13	76	61	15
PCT7314	TO	759	315	0	0	38	277	200	77
PCT7315	MV	570	207	0	0	14	193	129	64
PCT7315	ED	195	181	0	0	16	165	132	33
PCT7315	TO	765	388	0	0	30	358	261	97
PCT7316	MV	654	261	0	0	29	232	159	73
PCT7316	ED	178	161	0	0	19	142	111	31
PCT7316	TO	832	422	0	0	48	374	270	104
PCT7317	MV	744	350	0	1	23	326	211	115
PCT7317	ED	146	162	0	0	21	141	116	25
PCT7317	TO	890	512	0	1	44	467	327	140
PCT7318	MV	605	294	0	0	35	259	171	88
PCT7318	ED	118	150	0	0	30	120	76	44
PCT7318	TO	723	444	0	0	65	379	247	132
PCT7319	MV	861	346	0	0	25	321	217	104
PCT7319	ED	188	208	0	1	31	176	128	48
PCT7319	TO	1049	554	0	1	56	497	345	152
PCT7321	MV	557	202	0	0	19	183	113	70
PCT7321	ED	102	106	0	0	12	94	68	26
PCT7321	TO	659	308	0	0	31	277	181	96
PCT7322	MV	742	296	0	0	35	261	181	80
PCT7322	ED	146	56	0	0	8	48	43	5
PCT7322	TO	888	352	0	0	43	309	224	85
PCT7323	MV	790	369	0	0	43	326	222	104
PCT7323	ED	166	180	0	0	22	158	120	38
PCT7323	TO	956	549	0	0	65	484	342	142
PCT7324	MV	587	260	0	0	29	231	157	74
PCT7324	ED	150	136	0	0	18	118	79	39
PCT7324	TO	737	396	0	0	47	349	236	113
PCT7325	MV	714	328	0	0	36	292	201	91
PCT7325	ED	172	183	0	0	19	164	119	45
PCT7325	TO	886	511	0	0	55	456	320	136
PCT7326	MV	685	304	0	0	28	276	190	86
PCT7326	ED	174	187	0	1	34	152	114	38
PCT7326	TO	859	491	0	1	62	428	304	124
PCT7327	MV	561	230	0	0	27	203	132	71
PCT7327	ED	126	59	0	0	4	55	46	9
PCT7327	TO	687	289	0	0	31	258	178	80
PCT7328	MV	829	334	0	0	54	280	181	99
PCT7328	ED	173	85	0	0	18	67	52	15
PCT7328	TO	1002	419	0	0	72	347	233	114
PCT7329	MV	556	228	0	0	24	204	142	62
PCT7329	ED	95	105	0	0	16	89	67	22
PCT7329	TO	651	333	0	0	40	293	209	84
PCT7331	MV	710	363	0	0	35	328	224	104
PCT7331	ED	160	170	0	0	23	147	106	41
PCT7331	TO	870	533	0	0	58	475	330	145
PCT7332	MV	654	265	0	0	22	243	185	58
PCT7332	ED	136	173	0	0	17	156	131	25
PCT7332	TO	790	438	0	0	39	399	316	83
PCT7333	MV	822	392	0	0	39	353	246	107
PCT7333	ED	193	241	0	0	25	216	167	49
PCT7333	TO	1015	633	0	0	64	569	413	156
PCT7334	MV	688	307	0	0	18	289	224	65
PCT7334	ED	131	170	0	0	16	154	123	31
PCT7334	TO	819	477	0	0	34	443	347	96
PCT7335	MV	788	390	0	0	39	351	227	124
PCT7335	ED	146	217	0	0	23	194	157	37
PCT7335	TO	934	607	0	0	62	545	384	161
PCT7336	MV	779	405	0	1	27	377	228	149
PCT7336	ED	175	189	0	0	26	163	117	46
PCT7336	TO	954	594	0	1	53	540	345	195
PCT7337	MV	772	387	0	0	41	346	230	116
PCT7337	ED	125	143	0	0	9	134	102	32
PCT7337	TO	897	530	0	0	50	480	332	148
PCT7338	MV	770	360	0	0	40	320	205	115
PCT7338	ED	125	104	0	0	11	93	76	17
PCT7338	TO	895	464	0	0	51	413	281	132
PCT7339	MV	605	270	0	0	24	246	187	59
PCT7339	ED	150	149	0	0	11	138	102	36
PCT7339	TO	755	419	0	0	35	384	289	95
PCT7341	MV	675	292	0	1	32	259	188	71
PCT7341	ED	178	183	0	1	18	164	133	31
PCT7341	TO	853	475	0	2	50	423	321	102
PCT7342	MV	674	326	0	0	19	307	235	72
PCT7342	ED	230	269	0	0	24	245	190	55
PCT7342	TO	904	595	0	0	43	552	425	127
PCT7343	MV	554	253	0	0	21	232	199	33
PCT7343	ED	150	176	0	0	20	156	129	27
PCT7343	TO	704	429	0	0	41	388	328	60
PCT7344	MV	863	393	0	0	28	365	266	99
PCT7344	ED	201	238	0	0	25	213	157	56
PCT7344	TO	1064	631	0	0	53	578	423	155
PCT7345	MV	904	434	0	0	36	398	304	94
PCT7345	ED	210	253	0	0	24	229	184	45
PCT7345	TO	1114	687	0	0	60	627	488	139
PCT7346	MV	681	288	0	0	20	268	208	60
PCT7346	ED	208	209	0	0	24	185	150	35
PCT7346	TO	889	497	0	0	44	453	358	95
PCT7347	MV	833	371	0	1	36	334	294	40
PCT7347	ED	170	192	0	0	17	175	152	23
PCT7347	TO	1003	563	0	1	53	509	446	63
PCT7348	MV	650	279	0	0	22	257	199	58
PCT7348	ED	193	159	0	0	18	141	118	23
PCT7348	TO	843	438	0	0	40	398	317	81
PCT7349	MV	710	318	0	0	24	294	205	89
PCT7349	ED	202	178	0	0	22	156	129	27
PCT7349	TO	912	496	0	0	46	450	334	116
PCT7501	MV	456	248	0	0	28	220	140	80
PCT7501	ED	95	127	0	0	14	113	80	33
PCT7501	TO	551	375	0	0	42	333	220	113
PCT7502	MV	669	318	0	0	28	290	208	82
PCT7502	ED	120	167	0	0	23	144	111	33
PCT7502	TO	789	485	0	0	51	434	319	115
PCT7503	MV	614	286	0	0	24	262	203	59
PCT7503	ED	148	163	0	0	22	141	111	30
PCT7503	TO	762	449	0	0	46	403	314	89
PCT7504	MV	404	175	0	0	15	160	127	33
PCT7504	ED	84	92	0	0	10	82	66	16
PCT7504	TO	488	267	0	0	25	242	193	49
PCT7505	MV	729	406	0	0	35	371	294	77
PCT7505	ED	133	143	0	0	9	134	109	25
PCT7505	TO	862	549	0	0	44	505	403	102
PCT7506	MV	842	365	0	0	42	323	241	82
PCT7506	ED	158	206	0	0	25	181	157	24
PCT7506	TO	1000	571	0	0	67	504	398	106
PCT7507	MV	694	291	0	0	20	271	224	47
PCT7507	ED	262	156	0	0	10	146	126	20
PCT7507	TO	956	447	0	0	30	417	350	67
PCT7508	MV	618	375	0	0	38	337	249	88
PCT7508	ED	126	131	0	0	11	120	100	20
PCT7508	TO	744	506	0	0	49	457	349	108
PCT7509	MV	756	399	0	0	28	371	278	93
PCT7509	ED	173	184	0	0	14	170	133	37
PCT7509	TO	929	583	0	0	42	541	411	130
PCT7512	MV	476	248	0	0	21	227	163	64
PCT7512	ED	124	120	0	0	14	106	83	23
PCT7512	TO	600	368	0	0	35	333	246	87
PCT7513	MV	575	248	0	0	25	223	185	38
PCT7513	ED	231	159	0	0	20	139	118	21
PCT7513	TO	806	407	0	0	45	362	303	59
PCT7514	MV	709	242	0	0	28	214	165	49
PCT7514	ED	207	100	0	0	16	84	73	11
PCT7514	TO	916	342	0	0	44	298	238	60
PCT7515	MV	664	323	0	0	21	302	218	84
PCT7515	ED	200	131	0	0	18	113	101	12
PCT7515	TO	864	454	0	0	39	415	319	96
PCT7516	MV	773	424	0	0	23	401	298	103
PCT7516	ED	147	152	0	0	10	142	105	37
PCT7516	TO	920	576	0	0	33	543	403	140
PCT7517	MV	645	362	0	0	34	328	261	67
PCT7517	ED	223	266	0	0	22	244	207	37
PCT7517	TO	868	628	0	0	56	572	468	104
PCT7518	MV	708	396	0	0	33	363	280	83
PCT7518	ED	218	273	0	0	28	245	213	32
PCT7518	TO	926	669	0	0	61	608	493	115
PCT7519	MV	543	261	0	0	28	233	190	43
PCT7519	ED	172	194	0	0	18	176	146	30
PCT7519	TO	715	455	0	0	46	409	336	73
PCT7521	MV	597	323	0	1	23	299	250	49
PCT7521	ED	182	222	0	0	13	209	169	40
PCT7521	TO	779	545	0	1	36	508	419	89
PCT7522	MV	588	302	0	0	24	278	230	48
PCT7522	ED	171	221	0	0	29	192	162	30
PCT7522	TO	759	523	0	0	53	470	392	78
PCT7523	MV	564	285	0	0	28	257	212	45
PCT7523	ED	180	247	0	0	17	230	187	43
PCT7523	TO	744	532	0	0	45	487	399	88
PCT7524	MV	481	228	0	0	26	202	173	29
PCT7524	ED	143	154	0	0	16	138	119	19
PCT7524	TO	624	382	0	0	42	340	292	48
PCT7525	MV	594	247	0	0	24	223	177	46
PCT7525	ED	170	159	0	0	17	142	127	15
PCT7525	TO	764	406	0	0	41	365	304	61
PCT7526	MV	825	397	0	0	45	352	289	63
PCT7526	ED	163	258	0	0	29	229	182	47
PCT7526	TO	988	655	0	0	74	581	471	110
PCT7527	MV	538	296	0	0	27	269	210	59
PCT7527	ED	172	157	0	0	12	145	118	27
PCT7527	TO	710	453	0	0	39	414	328	86
PCT7529	MV	749	367	0	0	20	347	296	51
PCT7529	ED	154	261	0	0	17	244	203	41
PCT7529	TO	903	628	0	0	37	591	499	92
PCT7531	MV	714	336	0	0	25	311	261	50
PCT7531	ED	159	211	0	0	14	197	164	33
PCT7531	TO	873	547	0	0	39	508	425	83
PCT7532	MV	668	330	0	0	29	301	233	68
PCT7532	ED	167	225	0	0	21	204	148	56
PCT7532	TO	835	555	0	0	50	505	381	124
PCT7533	MV	777	405	0	0	32	373	306	67
PCT7533	ED	193	286	0	0	29	257	219	38
PCT7533	TO	970	691	0	0	61	630	525	105
PCT7534	MV	670	377	0	0	34	343	267	76
PCT7534	ED	233	259	0	0	29	230	207	23
PCT7534	TO	903	636	0	0	63	573	474	99
PCT7535	MV	606	303	0	0	25	278	221	57
PCT7535	ED	139	218	0	0	27	191	171	20
PCT7535	TO	745	521	0	0	52	469	392	77
PCT7536	MV	670	347	0	0	21	326	268	58
PCT7536	ED	163	231	0	0	24	207	171	36
PCT7536	TO	833	578	0	0	45	533	439	94
PCT7537	MV	619	302	0	0	23	279	215	64
PCT7537	ED	126	221	0	1	16	204	170	34
PCT7537	TO	745	523	0	1	39	483	385	98
PCT7538	MV	562	324	0	0	20	304	246	58
PCT7538	ED	189	233	0	0	26	207	172	35
PCT7538	TO	751	557	0	0	46	511	418	93
PCT7539	MV	696	376	0	0	24	352	297	55
PCT7539	ED	225	277	0	0	23	254	216	38
PCT7539	TO	921	653	0	0	47	606	513	93
PCT7541	MV	601	296	0	0	29	267	210	57
PCT7541	ED	169	236	0	0	30	206	172	34
PCT7541	TO	770	532	0	0	59	473	382	91
PCT7542	MV	632	325	0	0	18	307	252	55
PCT7542	ED	192	222	0	0	14	208	178	30
PCT7542	TO	824	547	0	0	32	515	430	85
PCT7543	MV	694	373	0	0	16	357	292	65
PCT7543	ED	230	191	0	0	20	171	142	29
PCT7543	TO	924	564	0	0	36	528	434	94
PCT7544	MV	731	389	0	0	37	352	284	68
PCT7544	ED	168	232	0	0	27	205	165	40
PCT7544	TO	899	621	0	0	64	557	449	108
PCT7545	MV	723	386	0	0	26	360	290	70
PCT7545	ED	172	211	0	0	22	189	165	24
PCT7545	TO	895	597	0	0	48	549	455	94
PCT7546	MV	770	419	0	0	21	398	335	63
PCT7546	ED	183	277	0	0	28	249	203	46
PCT7546	TO	953	696	0	0	49	647	538	109
PCT7547	MV	799	427	0	0	33	394	336	58
PCT7547	ED	182	270	0	0	19	251	227	24
PCT7547	TO	981	697	0	0	52	645	563	82
PCT7548	MV	803	450	0	0	25	425	354	71
PCT7548	ED	248	281	0	0	25	256	222	34
PCT7548	TO	1051	731	0	0	50	681	576	105
PCT7549	MV	660	359	0	0	33	326	256	70
PCT7549	ED	146	200	0	0	23	177	145	32
PCT7549	TO	806	559	0	0	56	503	401	102
PCT7551	MV	587	304	0	0	18	286	228	58
PCT7551	ED	136	233	0	0	17	216	174	42
PCT7551	TO	723	537	0	0	35	502	402	100
PCT7552	MV	561	289	0	0	26	263	218	45
PCT7552	ED	124	185	0	0	26	159	136	23
PCT7552	TO	685	474	0	0	52	422	354	68
PCT7553	MV	191	96	0	0	7	89	70	19
PCT7553	ED	0	19	0	0	3	16	12	4
PCT7553	TO	191	115	0	0	10	105	82	23
PCT7554	MV	653	382	0	0	30	352	266	86
PCT7554	ED	168	226	0	0	21	205	151	54
PCT7554	TO	821	608	0	0	51	557	417	140
PCT7555	MV	662	418	0	0	34	384	304	80
PCT7555	ED	210	258	0	0	20	238	197	41
PCT7555	TO	872	676	0	0	54	622	501	121
PCT7556	MV	812	514	0	0	29	485	368	117
PCT7556	ED	154	236	0	0	27	209	163	46
PCT7556	TO	966	750	0	0	56	694	531	163
PCT7601	MV	485	207	0	0	14	193	159	34
PCT7601	ED	192	125	0	1	16	108	93	15
PCT7601	TO	677	332	0	1	30	301	252	49
PCT7602	MV	654	277	0	0	20	257	219	38
PCT7602	ED	232	150	0	0	12	138	123	15
PCT7602	TO	886	427	0	0	32	395	342	53
PCT7603	MV	615	296	0	0	28	268	228	40
PCT7603	ED	200	208	0	0	15	193	162	31
PCT7603	TO	815	504	0	0	43	461	390	71
PCT7604	MV	685	270	0	0	18	252	213	39
PCT7604	ED	259	187	0	0	24	163	129	34
PCT7604	TO	944	457	0	0	42	415	342	73
PCT7605	MV	469	192	0	1	17	174	142	32
PCT7605	ED	192	98	0	0	9	89	78	11
PCT7605	TO	661	290	0	1	26	263	220	43
PCT7606	MV	673	267	0	0	27	240	195	45
PCT7606	ED	210	123	0	0	15	108	93	15
PCT7606	TO	883	390	0	0	42	348	288	60
PCT7607	MV	712	288	0	0	23	265	208	57
PCT7607	ED	207	143	0	0	12	131	113	18
PCT7607	TO	919	431	0	0	35	396	321	75
PCT7608	MV	279	96	0	0	9	87	64	23
PCT7608	ED	101	28	0	0	2	26	23	3
PCT7608	TO	380	124	0	0	11	113	87	26
PCT7609	MV	699	287	0	0	31	256	204	52
PCT7609	ED	185	76	0	1	7	68	59	9
PCT7609	TO	884	363	0	1	38	324	263	61
PCT7611	MV	586	236	0	0	15	221	189	32
PCT7611	ED	202	70	0	0	5	65	57	8
PCT7611	TO	788	306	0	0	20	286	246	40
PCT7612	MV	452	216	0	0	10	206	157	49
PCT7612	ED	105	61	0	0	6	55	44	11
PCT7612	TO	557	277	0	0	16	261	201	60
PCT7613	MV	634	244	0	0	17	227	194	33
PCT7613	ED	249	123	0	0	11	112	102	10
PCT7613	TO	883	367	0	0	28	339	296	43
PCT7614	MV	713	255	0	0	22	233	195	38
PCT7614	ED	203	133	0	0	10	123	102	21
PCT7614	TO	916	388	0	0	32	356	297	59
PCT7615	MV	510	165	0	0	9	156	125	31
PCT7615	ED	240	91	0	0	7	84	71	13
PCT7615	TO	750	256	0	0	16	240	196	44
PCT7616	MV	754	332	0	0	35	297	211	86
PCT7616	ED	82	191	0	0	25	166	126	40
PCT7616	TO	836	523	0	0	60	463	337	126
PCT7617	MV	583	222	0	0	21	201	165	36
PCT7617	ED	169	78	0	0	13	65	55	10
PCT7617	TO	752	300	0	0	34	266	220	46
PCT7618	MV	763	365	0	0	23	342	252	90
PCT7618	ED	151	141	0	0	18	123	91	32
PCT7618	TO	914	506	0	0	41	465	343	122
PCT7619	MV	938	439	0	0	27	412	315	97
PCT7619	ED	169	207	0	0	25	182	148	34
PCT7619	TO	1107	646	0	0	52	594	463	131
PCT7621	MV	1006	443	0	0	35	408	305	103
PCT7621	ED	149	185	0	0	26	159	120	39
PCT7621	TO	1155	628	0	0	61	567	425	142
PCT7622	MV	697	216	0	0	13	203	170	33
PCT7622	ED	263	127	0	0	17	110	96	14
PCT7622	TO	960	343	0	0	30	313	266	47
PCT7623	MV	767	256	0	1	22	233	201	32
PCT7623	ED	237	167	0	0	19	148	135	13
PCT7623	TO	1004	423	0	1	41	381	336	45
PCT7624	MV	652	210	0	0	11	199	161	38
PCT7624	ED	223	114	0	0	19	95	81	14
PCT7624	TO	875	324	0	0	30	294	242	52
PCT7625	MV	749	396	0	0	52	344	263	81
PCT7625	ED	73	51	0	0	2	49	42	7
PCT7625	TO	822	447	0	0	54	393	305	88
PCT7626	MV	945	404	0	0	44	360	242	118
PCT7626	ED	128	164	0	0	13	151	115	36
PCT7626	TO	1073	568	0	0	57	511	357	154
PCT7627	MV	457	196	0	0	17	179	108	71
PCT7627	ED	67	80	0	0	12	68	43	25
PCT7627	TO	524	276	0	0	29	247	151	96
PCT7628	MV	718	333	0	0	14	319	253	66
PCT7628	ED	220	185	0	0	17	168	134	34
PCT7628	TO	938	518	0	0	31	487	387	100
PCT7629	MV	691	277	0	0	23	254	202	52
PCT7629	ED	162	159	0	0	17	142	122	20
PCT7629	TO	853	436	0	0	40	396	324	72
PCT7631	MV	1009	442	0	0	29	413	313	100
PCT7631	ED	210	213	0	0	20	193	161	32
PCT7631	TO	1219	655	0	0	49	606	474	132
PCT7632	MV	1002	414	0	0	26	388	291	97
PCT7632	ED	169	237	0	0	19	218	177	41
PCT7632	TO	1171	651	0	0	45	606	468	138
PCT7633	MV	609	278	0	0	23	255	187	68
PCT7633	ED	126	124	0	0	13	111	89	22
PCT7633	TO	735	402	0	0	36	366	276	90
PCT7634	MV	704	344	0	0	38	306	237	69
PCT7634	ED	186	155	0	0	22	133	101	32
PCT7634	TO	890	499	0	0	60	439	338	101
PCT7635	MV	665	274	0	0	16	258	178	80
PCT7635	ED	188	145	0	0	12	133	104	29
PCT7635	TO	853	419	0	0	28	391	282	109
PCT7636	MV	798	331	0	0	33	298	187	111
PCT7636	ED	161	188	0	0	23	165	121	44
PCT7636	TO	959	519	0	0	56	463	308	155
PCT7637	MV	747	344	0	0	31	313	190	123
PCT7637	ED	121	169	0	0	26	143	104	39
PCT7637	TO	868	513	0	0	57	456	294	162
PCT7638	MV	806	374	0	0	30	344	193	151
PCT7638	ED	83	148	0	0	18	130	69	61
PCT7638	TO	889	522	0	0	48	474	262	212
PCT7639	MV	889	397	0	0	41	356	228	128
PCT7639	ED	133	175	0	0	34	141	92	49
PCT7639	TO	1022	572	0	0	75	497	320	177
PCT7641	MV	817	401	0	0	27	374	235	139
PCT7641	ED	134	158	0	0	14	144	101	43
PCT7641	TO	951	559	0	0	41	518	336	182
PCT7642	MV	647	314	0	0	36	278	199	79
PCT7642	ED	118	157	0	0	25	132	101	31
PCT7642	TO	765	471	0	0	61	410	300	110
PCT7643	MV	810	434	0	0	31	403	265	138
PCT7643	ED	131	135	0	0	20	115	87	28
PCT7643	TO	941	569	0	0	51	518	352	166
PCT7644	MV	1014	404	0	0	43	361	239	122
PCT7644	ED	162	234	0	0	24	210	177	33
PCT7644	TO	1176	638	0	0	67	571	416	155
PCT7645	MV	595	286	0	0	22	264	179	85
PCT7645	ED	61	112	0	0	18	94	66	28
PCT7645	TO	656	398	0	0	40	358	245	113
PCT7646	MV	1032	485	0	0	44	441	296	145
PCT7646	ED	121	251	0	0	46	205	170	35
PCT7646	TO	1153	736	0	0	90	646	466	180
PCT7647	MV	724	212	0	0	4	208	165	43
PCT7647	ED	263	148	0	0	17	131	106	25
PCT7647	TO	987	360	0	0	21	339	271	68
PCT7648	MV	2	1	0	0	1	0	0	0
PCT7648	ED	0	0	0	0	0	0	0	0
PCT7648	TO	2	1	0	0	1	0	0	0
PCT7649	MV	724	286	0	0	12	274	205	69
PCT7649	ED	176	152	0	0	16	136	112	24
PCT7649	TO	900	438	0	0	28	410	317	93
PCT7651	MV	834	334	0	0	30	304	211	93
PCT7651	ED	113	169	0	0	23	146	95	51
PCT7651	TO	947	503	0	0	53	450	306	144
PCT7652	MV	535	209	0	0	19	190	127	63
PCT7652	ED	100	122	0	0	15	107	81	26
PCT7652	TO	635	331	0	0	34	297	208	89
PCT7653	MV	750	337	0	0	37	300	218	82
PCT7653	ED	89	146	0	0	23	123	87	36
PCT7653	TO	839	483	0	0	60	423	305	118
PCT7654	MV	413	191	0	0	13	178	130	48
PCT7654	ED	53	106	0	0	13	93	73	20
PCT7654	TO	466	297	0	0	26	271	203	68
PCT7655	MV	583	216	0	0	10	206	146	60
PCT7655	ED	96	127	0	0	19	108	82	26
PCT7655	TO	679	343	0	0	29	314	228	86
PCT7656	MV	603	309	0	0	29	280	160	120
PCT7656	ED	35	81	0	0	15	66	36	30
PCT7656	TO	638	390	0	0	44	346	196	150
PCT7657	MV	561	270	0	0	31	239	146	93
PCT7657	ED	37	109	0	0	16	93	65	28
PCT7657	TO	598	379	0	0	47	332	211	121
PCT7701	MV	869	482	0	0	36	446	336	110
PCT7701	ED	195	251	0	0	25	226	180	46
PCT7701	TO	1064	733	0	0	61	672	516	156
PCT7702	MV	623	378	0	0	22	356	226	130
PCT7702	ED	133	146	0	0	17	129	92	37
PCT7702	TO	756	524	0	0	39	485	318	167
PCT7703	MV	174	71	0	0	4	67	58	9
PCT7703	ED	0	1	0	0	1	0	0	0
PCT7703	TO	174	72	0	0	5	67	58	9
PCT7704	MV	798	491	0	0	37	454	268	186
PCT7704	ED	204	221	0	0	15	206	135	71
PCT7704	TO	1002	712	0	0	52	660	403	257
PCT7705	MV	470	286	0	0	17	269	155	114
PCT7705	ED	125	148	0	0	12	136	84	52
PCT7705	TO	595	434	0	0	29	405	239	166
PCT7706	MV	687	451	0	0	26	425	261	164
PCT7706	ED	179	198	0	0	9	189	124	65
PCT7706	TO	866	649	0	0	35	614	385	229
PCT7707	MV	683	432	0	0	24	408	278	130
PCT7707	ED	189	226	0	0	15	211	133	78
PCT7707	TO	872	658	0	0	39	619	411	208
PCT7708	MV	710	462	0	0	38	424	273	151
PCT7708	ED	165	192	0	0	17	175	119	56
PCT7708	TO	875	654	0	0	55	599	392	207
PCT7709	MV	324	194	0	0	10	184	119	65
PCT7709	ED	82	107	0	0	10	97	76	21
PCT7709	TO	406	301	0	0	20	281	195	86
PCT7711	MV	658	380	0	1	21	358	245	113
PCT7711	ED	153	163	0	0	13	150	117	33
PCT7711	TO	811	543	0	1	34	508	362	146
PCT7712	MV	425	259	0	0	14	245	184	61
PCT7712	ED	107	135	0	0	13	122	91	31
PCT7712	TO	532	394	0	0	27	367	275	92
PCT7801	MV	824	487	0	0	23	464	331	133
PCT7801	ED	150	249	0	0	16	233	177	56
PCT7801	TO	974	736	0	0	39	697	508	189
PCT7802	MV	647	402	0	0	25	377	287	90
PCT7802	ED	151	212	0	0	14	198	160	38
PCT7802	TO	798	614	0	0	39	575	447	128
PCT7803	MV	718	476	0	0	31	445	317	128
PCT7803	ED	113	160	0	0	16	144	111	33
PCT7803	TO	831	636	0	0	47	589	428	161
PCT7804	MV	734	463	0	0	47	416	301	115
PCT7804	ED	151	246	0	1	28	217	162	55
PCT7804	TO	885	709	0	1	75	633	463	170
PCT7805	MV	644	402	0	0	42	360	263	97
PCT7805	ED	156	216	0	0	18	198	169	29
PCT7805	TO	800	618	0	0	60	558	432	126
PCT7806	MV	602	362	0	0	29	333	263	70
PCT7806	ED	153	208	0	0	24	184	154	30
PCT7806	TO	755	570	0	0	53	517	417	100
PCT7807	MV	642	363	0	0	20	343	273	70
PCT7807	ED	185	247	0	0	27	220	186	34
PCT7807	TO	827	610	0	0	47	563	459	104
PCT7808	MV	525	297	0	0	25	272	222	50
PCT7808	ED	129	170	0	0	19	151	124	27
PCT7808	TO	654	467	0	0	44	423	346	77
PCT7809	MV	624	352	0	0	22	330	273	57
PCT7809	ED	140	184	0	0	20	164	148	16
PCT7809	TO	764	536	0	0	42	494	421	73
PCT7811	MV	582	311	0	0	22	289	240	49
PCT7811	ED	176	218	0	0	18	200	167	33
PCT7811	TO	758	529	0	0	40	489	407	82
PCT7812	MV	680	371	0	0	33	338	273	65
PCT7812	ED	217	232	0	0	25	207	172	35
PCT7812	TO	897	603	0	0	58	545	445	100
PCT7813	MV	843	486	0	0	26	460	361	99
PCT7813	ED	225	300	0	0	23	277	238	39
PCT7813	TO	1068	786	0	0	49	737	599	138
PCT7814	MV	660	281	0	0	19	262	206	56
PCT7814	ED	241	191	0	0	20	171	152	19
PCT7814	TO	901	472	0	0	39	433	358	75
PCT7815	MV	749	465	0	0	49	416	321	95
PCT7815	ED	168	231	0	0	19	212	169	43
PCT7815	TO	917	696	0	0	68	628	490	138
PCT7816	MV	724	475	0	0	37	438	334	104
PCT7816	ED	148	213	0	0	19	194	144	50
PCT7816	TO	872	688	0	0	56	632	478	154
PCT7817	MV	652	396	0	0	13	383	321	62
PCT7817	ED	186	237	0	0	16	221	192	29
PCT7817	TO	838	633	0	0	29	604	513	91
PCT7818	MV	668	393	0	0	26	367	290	77
PCT7818	ED	171	205	0	0	17	188	162	26
PCT7818	TO	839	598	0	0	43	555	452	103
PCT7819	MV	635	353	0	0	29	324	249	75
PCT7819	ED	139	183	0	0	19	164	134	30
PCT7819	TO	774	536	0	0	48	488	383	105
PCT7821	MV	806	520	0	0	32	488	381	107
PCT7821	ED	170	249	0	0	16	233	168	65
PCT7821	TO	976	769	0	0	48	721	549	172
PCT7822	MV	673	396	0	1	26	369	296	73
PCT7822	ED	219	258	0	0	26	232	176	56
PCT7822	TO	892	654	0	1	52	601	472	129
PCT7823	MV	706	411	0	0	26	385	307	78
PCT7823	ED	177	275	0	0	21	254	219	35
PCT7823	TO	883	686	0	0	47	639	526	113
PCT7824	MV	615	338	0	0	30	308	231	77
PCT7824	ED	153	219	0	0	20	199	165	34
PCT7824	TO	768	557	0	0	50	507	396	111
PCT7825	MV	457	252	0	0	17	235	208	27
PCT7825	ED	151	186	0	0	7	179	151	28
PCT7825	TO	608	438	0	0	24	414	359	55
PCT7826	MV	486	263	0	0	18	245	200	45
PCT7826	ED	204	227	0	0	14	213	191	22
PCT7826	TO	690	490	0	0	32	458	391	67
PCT7827	MV	609	320	0	0	21	299	240	59
PCT7827	ED	217	222	0	0	29	193	165	28
PCT7827	TO	826	542	0	0	50	492	405	87
PCT7828	MV	857	479	0	1	33	445	328	117
PCT7828	ED	171	251	0	1	31	219	176	43
PCT7828	TO	1028	730	0	2	64	664	504	160
PCT7829	MV	742	468	0	0	35	433	296	137
PCT7829	ED	149	204	0	0	14	190	151	39
PCT7829	TO	891	672	0	0	49	623	447	176
PCT7831	MV	763	486	0	0	41	445	334	111
PCT7831	ED	139	205	0	0	17	188	142	46
PCT7831	TO	902	691	0	0	58	633	476	157
PCT7832	MV	663	415	0	0	33	382	294	88
PCT7832	ED	118	170	0	0	19	151	128	23
PCT7832	TO	781	585	0	0	52	533	422	111
PCT7833	MV	587	345	0	0	24	321	254	67
PCT7833	ED	146	191	0	0	20	171	140	31
PCT7833	TO	733	536	0	0	44	492	394	98
PCT7834	MV	700	377	0	0	28	349	297	52
PCT7834	ED	194	258	0	0	27	231	195	36
PCT7834	TO	894	635	0	0	55	580	492	88
PCT7835	MV	721	430	0	0	27	403	276	127
PCT7835	ED	142	202	0	0	19	183	139	44
PCT7835	TO	863	632	0	0	46	586	415	171
PCT7836	MV	850	507	0	0	26	481	335	146
PCT7836	ED	193	232	0	0	10	222	163	59
PCT7836	TO	1043	739	0	0	36	703	498	205
PCT7837	MV	718	425	0	0	47	378	272	106
PCT7837	ED	205	264	0	0	22	242	197	45
PCT7837	TO	923	689	0	0	69	620	469	151
PCT7838	MV	752	494	0	0	39	455	324	131
PCT7838	ED	143	210	0	0	15	195	149	46
PCT7838	TO	895	704	0	0	54	650	473	177
PCT7839	MV	731	459	0	0	40	419	308	111
PCT7839	ED	130	201	0	1	20	180	141	39
PCT7839	TO	861	660	0	1	60	599	449	150
PCT7841	MV	752	459	0	0	33	426	324	102
PCT7841	ED	198	264	0	0	17	247	198	49
PCT7841	TO	950	723	0	0	50	673	522	151
PCT7842	MV	702	396	0	0	31	365	297	68
PCT7842	ED	177	243	0	0	15	228	190	38
PCT7842	TO	879	639	0	0	46	593	487	106
PCT7843	MV	546	296	0	0	13	283	235	48
PCT7843	ED	183	220	0	0	19	201	163	38
PCT7843	TO	729	516	0	0	32	484	398	86
PCT7844	MV	499	282	0	0	27	255	214	41
PCT7844	ED	152	187	0	0	19	168	138	30
PCT7844	TO	651	469	0	0	46	423	352	71
PCT7845	MV	676	405	0	0	27	378	301	77
PCT7845	ED	204	225	0	0	22	203	157	46
PCT7845	TO	880	630	0	0	49	581	458	123
PCT7846	MV	736	467	0	0	45	422	298	124
PCT7846	ED	172	234	0	0	30	204	167	37
PCT7846	TO	908	701	0	0	75	626	465	161
PCT7847	MV	698	432	0	0	40	392	308	84
PCT7847	ED	193	231	0	0	12	219	172	47
PCT7847	TO	891	663	0	0	52	611	480	131
PCT7848	MV	665	438	0	0	29	409	312	97
PCT7848	ED	182	226	0	0	23	203	163	40
PCT7848	TO	847	664	0	0	52	612	475	137
PCT7849	MV	729	443	0	1	36	406	310	96
PCT7849	ED	172	260	0	0	32	228	187	41
PCT7849	TO	901	703	0	1	68	634	497	137
PCT7851	MV	414	272	0	0	23	249	152	97
PCT7851	ED	112	118	0	0	9	109	74	35
PCT7851	TO	526	390	0	0	32	358	226	132
PCT7852	MV	533	351	0	0	24	327	206	121
PCT7852	ED	111	133	0	0	8	125	92	33
PCT7852	TO	644	484	0	0	32	452	298	154
PCT7853	MV	694	395	0	0	32	363	252	111
PCT7853	ED	161	196	0	0	18	178	129	49
PCT7853	TO	855	591	0	0	50	541	381	160
PCT7854	MV	703	430	0	0	35	395	284	111
PCT7854	ED	175	221	0	0	19	202	155	47
PCT7854	TO	878	651	0	0	54	597	439	158
PCT7855	MV	763	451	0	0	36	415	307	108
PCT7855	ED	211	264	0	0	26	238	187	51
PCT7855	TO	974	715	0	0	62	653	494	159
PCT7856	MV	643	378	0	0	25	353	269	84
PCT7856	ED	204	250	0	0	18	232	185	47
PCT7856	TO	847	628	0	0	43	585	454	131
PCT7857	MV	748	438	0	1	36	401	305	96
PCT7857	ED	158	220	0	0	22	198	163	35
PCT7857	TO	906	658	0	1	58	599	468	131
PCT7858	MV	622	351	0	0	31	320	262	58
PCT7858	ED	157	206	0	0	20	186	161	25
PCT7858	TO	779	557	0	0	51	506	423	83
PCT7859	MV	747	465	0	0	34	431	311	120
PCT7859	ED	152	224	0	0	27	197	144	53
PCT7859	TO	899	689	0	0	61	628	455	173
PCT7861	MV	699	435	0	0	25	410	294	116
PCT7861	ED	164	217	0	0	12	205	158	47
PCT7861	TO	863	652	0	0	37	615	452	163
PCT7862	MV	669	404	0	0	28	376	273	103
PCT7862	ED	195	241	0	0	18	223	178	45
PCT7862	TO	864	645	0	0	46	599	451	148
PCT7863	MV	693	376	0	0	25	351	272	79
PCT7863	ED	208	273	0	0	17	256	189	67
PCT7863	TO	901	649	0	0	42	607	461	146
PCT7864	MV	661	376	0	0	30	346	254	92
PCT7864	ED	153	208	0	0	18	190	153	37
PCT7864	TO	814	584	0	0	48	536	407	129
PCT7865	MV	677	410	0	0	39	371	282	89
PCT7865	ED	163	201	0	0	17	184	140	44
PCT7865	TO	840	611	0	0	56	555	422	133
PCT7866	MV	690	447	0	0	21	426	263	163
PCT7866	ED	158	192	0	0	9	183	121	62
PCT7866	TO	848	639	0	0	30	609	384	225
PCT7867	MV	766	475	0	0	29	446	336	110
PCT7867	ED	212	235	0	0	25	210	165	45
PCT7867	TO	978	710	0	0	54	656	501	155
PCT7868	MV	659	376	0	0	21	355	262	93
PCT7868	ED	217	219	0	1	13	205	158	47
PCT7868	TO	876	595	0	1	34	560	420	140
PCT7869	MV	683	445	0	0	31	414	309	105
PCT7869	ED	178	225	0	0	17	208	167	41
PCT7869	TO	861	670	0	0	48	622	476	146
PCT7871	MV	702	466	0	0	35	431	330	101
PCT7871	ED	200	199	0	0	14	185	138	47
PCT7871	TO	902	665	0	0	49	616	468	148
PCT7872	MV	675	422	0	0	25	397	300	97
PCT7872	ED	199	232	0	0	19	213	159	54
PCT7872	TO	874	654	0	0	44	610	459	151
PCT7873	MV	689	445	0	1	28	416	317	99
PCT7873	ED	202	256	0	0	23	233	187	46
PCT7873	TO	891	701	0	1	51	649	504	145
PCT7874	MV	370	191	0	0	8	183	136	47
PCT7874	ED	119	131	0	0	9	122	100	22
PCT7874	TO	489	322	0	0	17	305	236	69
PCT7875	MV	500	253	0	0	16	237	177	60
PCT7875	ED	147	158	0	0	11	147	124	23
PCT7875	TO	647	411	0	0	27	384	301	83
PCT7876	MV	462	258	0	0	27	231	188	43
PCT7876	ED	106	129	0	0	14	115	95	20
PCT7876	TO	568	387	0	0	41	346	283	63
PCT7901	MV	399	192	0	0	14	178	149	29
PCT7901	ED	150	104	0	0	10	94	82	12
PCT7901	TO	549	296	0	0	24	272	231	41
PCT7902	MV	680	291	0	0	14	277	235	42
PCT7902	ED	232	208	0	0	17	191	160	31
PCT7902	TO	912	499	0	0	31	468	395	73
PCT7903	MV	623	286	0	0	23	263	221	42
PCT7903	ED	229	196	0	0	20	176	163	13
PCT7903	TO	852	482	0	0	43	439	384	55
PCT7904	MV	680	299	0	0	25	274	221	53
PCT7904	ED	157	187	0	0	17	170	149	21
PCT7904	TO	837	486	0	0	42	444	370	74
PCT7905	MV	684	356	0	0	20	336	265	71
PCT7905	ED	191	226	0	0	16	210	180	30
PCT7905	TO	875	582	0	0	36	546	445	101
PCT7906	MV	599	283	0	0	20	263	223	40
PCT7906	ED	187	206	0	0	24	182	152	30
PCT7906	TO	786	489	0	0	44	445	375	70
PCT7907	MV	704	345	0	0	15	330	270	60
PCT7907	ED	238	251	0	0	23	228	197	31
PCT7907	TO	942	596	0	0	38	558	467	91
PCT7908	MV	752	366	0	0	24	342	290	52
PCT7908	ED	240	250	0	0	21	229	202	27
PCT7908	TO	992	616	0	0	45	571	492	79
PCT7909	MV	558	311	0	0	22	289	248	41
PCT7909	ED	185	179	0	0	15	164	138	26
PCT7909	TO	743	490	0	0	37	453	386	67
PCT7911	MV	666	323	0	0	26	297	235	62
PCT7911	ED	205	207	0	0	19	188	161	27
PCT7911	TO	871	530	0	0	45	485	396	89
PCT7912	MV	800	370	0	0	26	344	301	43
PCT7912	ED	259	263	0	0	32	231	208	23
PCT7912	TO	1059	633	0	0	58	575	509	66
PCT7913	MV	661	352	0	0	14	338	279	59
PCT7913	ED	262	303	0	0	11	292	241	51
PCT7913	TO	923	655	0	0	25	630	520	110
PCT7914	MV	716	391	0	0	29	362	302	60
PCT7914	ED	186	217	0	0	19	198	168	30
PCT7914	TO	902	608	0	0	48	560	470	90
PCT7915	MV	605	290	0	0	23	267	220	47
PCT7915	ED	238	249	0	0	16	233	195	38
PCT7915	TO	843	539	0	0	39	500	415	85
PCT7916	MV	639	338	0	0	21	317	267	50
PCT7916	ED	219	231	0	0	19	212	190	22
PCT7916	TO	858	569	0	0	40	529	457	72
PCT7917	MV	716	358	0	0	20	338	288	50
PCT7917	ED	271	262	0	0	17	245	214	31
PCT7917	TO	987	620	0	0	37	583	502	81
PCT7918	MV	597	297	0	0	13	284	242	42
PCT7918	ED	227	202	0	0	17	185	156	29
PCT7918	TO	824	499	0	0	30	469	398	71
PCT7919	MV	609	309	0	0	16	293	254	39
PCT7919	ED	257	251	0	0	21	230	199	31
PCT7919	TO	866	560	0	0	37	523	453	70
PCT7921	MV	682	310	0	0	18	292	245	47
PCT7921	ED	229	181	0	0	14	167	151	16
PCT7921	TO	911	491	0	0	32	459	396	63
PCT7922	MV	648	314	0	0	14	300	248	52
PCT7922	ED	210	247	0	0	24	223	192	31
PCT7922	TO	858	561	0	0	38	523	440	83
PCT7923	MV	666	338	0	0	15	323	246	77
PCT7923	ED	214	261	0	0	26	235	200	35
PCT7923	TO	880	599	0	0	41	558	446	112
PCT7924	MV	650	305	0	0	12	293	233	60
PCT7924	ED	201	191	0	0	19	172	142	30
PCT7924	TO	851	496	0	0	31	465	375	90
PCT7925	MV	434	227	0	0	16	211	166	45
PCT7925	ED	110	127	0	0	7	120	103	17
PCT7925	TO	544	354	0	0	23	331	269	62
PCT7926	MV	610	341	0	0	25	316	256	60
PCT7926	ED	178	199	0	0	12	187	149	38
PCT7926	TO	788	540	0	0	37	503	405	98
PCT7927	MV	580	335	0	0	26	309	254	55
PCT7927	ED	162	217	0	0	17	200	173	27
PCT7927	TO	742	552	0	0	43	509	427	82
PCT7928	MV	700	397	0	0	24	373	292	81
PCT7928	ED	217	276	0	0	14	262	214	48
PCT7928	TO	917	673	0	0	38	635	506	129
PCT7929	MV	678	424	0	0	22	402	328	74
PCT7929	ED	169	225	0	0	15	210	184	26
PCT7929	TO	847	649	0	0	37	612	512	100
PCT7931	MV	610	378	0	0	34	344	266	78
PCT7931	ED	141	187	0	0	15	172	140	32
PCT7931	TO	751	565	0	0	49	516	406	110
PCT7932	MV	443	277	0	0	21	256	179	77
PCT7932	ED	118	117	0	0	10	107	88	19
PCT7932	TO	561	394	0	0	31	363	267	96
PCT7933	MV	8	6	0	0	0	6	4	2
PCT7933	ED	0	0	0	0	0	0	0	0
PCT7933	TO	8	6	0	0	0	6	4	2
PCT7934	MV	702	413	0	0	27	386	328	58
PCT7934	ED	182	202	0	0	17	185	154	31
PCT7934	TO	884	615	0	0	44	571	482	89
PCT7935	MV	716	440	0	0	27	413	327	86
PCT7935	ED	227	277	0	0	24	253	209	44
PCT7935	TO	943	717	0	0	51	666	536	130
PCT7936	MV	620	373	0	0	29	344	276	68
PCT7936	ED	236	271	0	0	21	250	202	48
PCT7936	TO	856	644	0	0	50	594	478	116
PCT7937	MV	698	406	0	0	23	383	300	83
PCT7937	ED	202	218	0	0	16	202	168	34
PCT7937	TO	900	624	0	0	39	585	468	117
PCT7938	MV	536	301	0	0	15	286	213	73
PCT7938	ED	215	153	0	0	14	139	119	20
PCT7938	TO	751	454	0	0	29	425	332	93
PCT7939	MV	481	292	0	0	16	276	230	46
PCT7939	ED	205	239	0	0	16	223	188	35
PCT7939	TO	686	531	0	0	32	499	418	81
PCT7941	MV	576	305	0	0	30	275	220	55
PCT7941	ED	196	202	0	0	12	190	147	43
PCT7941	TO	772	507	0	0	42	465	367	98
PCT7942	MV	658	333	0	0	20	313	248	65
PCT7942	ED	274	191	0	0	9	182	153	29
PCT7942	TO	932	524	0	0	29	495	401	94
PCT7943	MV	686	370	0	0	17	353	259	94
PCT7943	ED	214	241	0	0	21	220	170	50
PCT7943	TO	900	611	0	0	38	573	429	144
PCT7944	MV	584	343	0	0	25	318	248	70
PCT7944	ED	230	241	0	0	18	223	186	37
PCT7944	TO	814	584	0	0	43	541	434	107
PCT7945	MV	726	339	0	0	25	314	251	63
PCT7945	ED	228	139	0	0	12	127	113	14
PCT7945	TO	954	478	0	0	37	441	364	77
PCT7946	MV	779	369	0	1	20	348	199	149
PCT7946	ED	206	145	0	0	13	132	102	30
PCT7946	TO	985	514	0	1	33	480	301	179
PCT7947	MV	792	333	0	0	23	310	162	148
PCT7947	ED	194	150	0	0	10	140	106	34
PCT7947	TO	986	483	0	0	33	450	268	182
PCT7948	MV	730	375	0	0	25	350	196	154
PCT7948	ED	200	161	0	0	8	153	113	40
PCT7948	TO	930	536	0	0	33	503	309	194
PCT7949	MV	484	234	0	0	12	222	113	109
PCT7949	ED	106	84	0	0	10	74	59	15
PCT7949	TO	590	318	0	0	22	296	172	124
PCT7951	MV	731	366	0	0	26	340	180	160
PCT7951	ED	156	116	0	0	10	106	69	37
PCT7951	TO	887	482	0	0	36	446	249	197
PCT7952	MV	730	294	0	0	19	275	152	123
PCT7952	ED	182	132	0	0	12	120	84	36
PCT7952	TO	912	426	0	0	31	395	236	159
PCT7953	MV	669	331	0	0	17	314	177	137
PCT7953	ED	161	140	0	0	7	133	85	48
PCT7953	TO	830	471	0	0	24	447	262	185
PCT7954	MV	0	0	0	0	0	0	0	0
PCT7954	ED	0	0	0	0	0	0	0	0
PCT7954	TO	0	0	0	0	0	0	0	0
PCT7955	MV	774	351	0	0	18	333	203	130
PCT7955	ED	173	142	0	0	16	126	84	42
PCT7955	TO	947	493	0	0	34	459	287	172
PCT7956	MV	699	267	0	0	12	255	151	104
PCT7956	ED	170	84	0	0	4	80	66	14
PCT7956	TO	869	351	0	0	16	335	217	118
PCT7957	MV	538	261	0	0	15	246	165	81
PCT7957	ED	135	120	0	0	8	112	86	26
PCT7957	TO	673	381	0	0	23	358	251	107
PCT7958	MV	297	108	0	0	6	102	74	28
PCT7958	ED	0	14	0	0	2	12	9	3
PCT7958	TO	297	122	0	0	8	114	83	31
PCT7959	MV	541	230	0	0	23	207	172	35
PCT7959	ED	145	162	0	0	18	144	136	8
PCT7959	TO	686	392	0	0	41	351	308	43
PCT9001	MV	284	101	0	0	1	100	79	21
PCT9001	ED	0	7	0	0	1	6	6	0
PCT9001	TO	284	108	0	0	2	106	85	21
PCT9101	MV	712	380	0	0	23	357	242	115
PCT9101	ED	201	210	0	0	17	193	131	62
PCT9101	TO	913	590	0	0	40	550	373	177
PCT9102	MV	788	395	0	0	26	369	248	121
PCT9102	ED	204	201	0	0	21	180	138	42
PCT9102	TO	992	596	0	0	47	549	386	163
PCT9103	MV	719	382	0	0	33	349	250	99
PCT9103	ED	238	226	0	0	19	207	140	67
PCT9103	TO	957	608	0	0	52	556	390	166
PCT9104	MV	810	383	0	0	36	347	245	102
PCT9104	ED	220	205	0	0	21	184	148	36
PCT9104	TO	1030	588	0	0	57	531	393	138
PCT9105	MV	719	413	0	0	23	390	254	136
PCT9105	ED	199	241	0	0	23	218	154	64
PCT9105	TO	918	654	0	0	46	608	408	200
PCT9106	MV	748	399	0	0	30	369	258	111
PCT9106	ED	198	268	0	0	26	242	184	58
PCT9106	TO	946	667	0	0	56	611	442	169
PCT9107	MV	636	306	0	1	24	281	207	74
PCT9107	ED	208	187	0	0	18	169	139	30
PCT9107	TO	844	493	0	1	42	450	346	104
PCT9108	MV	610	338	0	0	30	308	230	78
PCT9108	ED	200	197	0	0	12	185	151	34
PCT9108	TO	810	535	0	0	42	493	381	112
PCT9109	MV	672	300	0	0	29	271	198	73
PCT9109	ED	211	213	0	0	15	198	150	48
PCT9109	TO	883	513	0	0	44	469	348	121
PCT9111	MV	639	318	0	0	25	293	195	98
PCT9111	ED	195	196	0	0	19	177	144	33
PCT9111	TO	834	514	0	0	44	470	339	131
PCT9112	MV	742	352	0	0	22	330	237	93
PCT9112	ED	219	218	0	0	16	202	159	43
PCT9112	TO	961	570	0	0	38	532	396	136
PCT9113	MV	797	373	0	0	31	342	251	91
PCT9113	ED	207	264	0	0	26	238	174	64
PCT9113	TO	1004	637	0	0	57	580	425	155
PCT9114	MV	659	294	0	0	21	273	200	73
PCT9114	ED	231	202	0	0	21	181	147	34
PCT9114	TO	890	496	0	0	42	454	347	107
PCT9115	MV	699	325	0	0	28	297	218	79
PCT9115	ED	182	198	0	0	24	174	149	25
PCT9115	TO	881	523	0	0	52	471	367	104
PCT9116	MV	782	347	0	0	20	327	229	98
PCT9116	ED	179	225	0	0	17	208	149	59
PCT9116	TO	961	572	0	0	37	535	378	157
PCT9117	MV	629	328	0	0	16	312	200	112
PCT9117	ED	171	207	0	0	18	189	128	61
PCT9117	TO	800	535	0	0	34	501	328	173
PCT9118	MV	742	341	0	0	24	317	199	118
PCT9118	ED	242	256	0	0	26	230	168	62
PCT9118	TO	984	597	0	0	50	547	367	180
PCT9119	MV	703	389	0	0	22	367	222	145
PCT9119	ED	197	171	0	0	16	155	124	31
PCT9119	TO	900	560	0	0	38	522	346	176
PCT9121	MV	735	336	0	0	19	317	210	107
PCT9121	ED	218	207	0	0	14	193	127	66
PCT9121	TO	953	543	0	0	33	510	337	173
PCT9122	MV	775	365	0	0	30	335	204	131
PCT9122	ED	192	184	0	0	23	161	117	44
PCT9122	TO	967	549	0	0	53	496	321	175
PCT9123	MV	661	319	0	0	18	301	204	97
PCT9123	ED	191	206	0	0	18	188	147	41
PCT9123	TO	852	525	0	0	36	489	351	138
PCT9124	MV	736	354	0	0	13	341	207	134
PCT9124	ED	167	175	0	0	11	164	125	39
PCT9124	TO	903	529	0	0	24	505	332	173
PCT9125	MV	681	360	0	0	19	341	233	108
PCT9125	ED	188	188	0	0	18	170	132	38
PCT9125	TO	869	548	0	0	37	511	365	146
PCT9126	MV	819	386	0	1	29	356	208	148
PCT9126	ED	194	224	0	0	17	207	162	45
PCT9126	TO	1013	610	0	1	46	563	370	193
PCT9127	MV	748	384	0	0	34	350	246	104
PCT9127	ED	223	241	0	0	15	226	167	59
PCT9127	TO	971	625	0	0	49	576	413	163
PCT9128	MV	628	336	0	0	26	310	202	108
PCT9128	ED	190	211	0	0	16	195	145	50
PCT9128	TO	818	547	0	0	42	505	347	158
PCT9129	MV	587	273	0	0	17	256	170	86
PCT9129	ED	151	170	0	0	12	158	127	31
PCT9129	TO	738	443	0	0	29	414	297	117
PCT9131	MV	596	288	0	0	13	275	184	91
PCT9131	ED	138	176	0	0	13	163	123	40
PCT9131	TO	734	464	0	0	26	438	307	131
PCT9132	MV	627	263	0	0	21	242	190	52
PCT9132	ED	194	197	0	0	19	178	147	31
PCT9132	TO	821	460	0	0	40	420	337	83
PCT9133	MV	808	383	0	0	23	360	265	95
PCT9133	ED	209	250	0	0	21	229	177	52
PCT9133	TO	1017	633	0	0	44	589	442	147
PCT9134	MV	736	328	0	0	22	306	197	109
PCT9134	ED	155	187	0	0	18	169	128	41
PCT9134	TO	891	515	0	0	40	475	325	150
PCT9135	MV	640	305	0	0	20	285	187	98
PCT9135	ED	182	173	0	0	15	158	104	54
PCT9135	TO	822	478	0	0	35	443	291	152
PCT9136	MV	706	368	0	0	36	332	224	108
PCT9136	ED	212	206	0	0	20	186	147	39
PCT9136	TO	918	574	0	0	56	518	371	147
PCT9137	MV	806	389	0	0	26	363	245	118
PCT9137	ED	209	210	0	0	17	193	148	45
PCT9137	TO	1015	599	0	0	43	556	393	163
PCT9138	MV	770	401	0	0	21	380	251	129
PCT9138	ED	175	171	0	0	11	160	120	40
PCT9138	TO	945	572	0	0	32	540	371	169
PCT9139	MV	828	424	0	0	29	395	253	142
PCT9139	ED	190	207	0	0	19	188	133	55
PCT9139	TO	1018	631	0	0	48	583	386	197
PCT9141	MV	789	419	0	0	33	386	240	146
PCT9141	ED	184	189	0	0	15	174	128	46
PCT9141	TO	973	608	0	0	48	560	368	192
PCT9142	MV	747	366	0	0	18	348	244	104
PCT9142	ED	239	236	0	0	23	213	165	48
PCT9142	TO	986	602	0	0	41	561	409	152
PCT9143	MV	706	362	0	0	23	339	206	133
PCT9143	ED	208	202	0	0	14	188	131	57
PCT9143	TO	914	564	0	0	37	527	337	190
PCT9144	MV	767	376	0	0	27	349	230	119
PCT9144	ED	203	238	0	0	14	224	176	48
PCT9144	TO	970	614	0	0	41	573	406	167
PCT9145	MV	681	335	0	0	15	320	240	80
PCT9145	ED	194	216	0	0	14	202	151	51
PCT9145	TO	875	551	0	0	29	522	391	131
PCT9146	MV	725	354	0	0	28	326	242	84
PCT9146	ED	160	215	0	0	24	191	153	38
PCT9146	TO	885	569	0	0	52	517	395	122
PCT9147	MV	765	373	0	0	32	341	248	93
PCT9147	ED	225	227	0	0	20	207	156	51
PCT9147	TO	990	600	0	0	52	548	404	144
PCT9148	MV	779	398	0	0	26	372	281	91
PCT9148	ED	235	256	0	0	26	230	188	42
PCT9148	TO	1014	654	0	0	52	602	469	133
PCT9149	MV	813	388	0	0	24	364	267	97
PCT9149	ED	178	292	0	0	18	274	211	63
PCT9149	TO	991	680	0	0	42	638	478	160
PCT9151	MV	693	352	0	0	30	322	239	83
PCT9151	ED	168	228	0	0	22	206	162	44
PCT9151	TO	861	580	0	0	52	528	401	127
PCT9152	MV	550	198	0	0	11	187	154	33
PCT9152	ED	187	356	0	0	30	326	281	45
PCT9152	TO	737	554	0	0	41	513	435	78
PCT9201	MV	785	358	0	0	30	328	278	50
PCT9201	ED	186	252	0	0	17	235	191	44
PCT9201	TO	971	610	0	0	47	563	469	94
PCT9202	MV	819	368	0	1	38	329	252	77
PCT9202	ED	177	253	0	0	23	230	169	61
PCT9202	TO	996	621	0	1	61	559	421	138
PCT9203	MV	847	374	0	0	54	320	190	130
PCT9203	ED	155	208	0	0	32	176	102	74
PCT9203	TO	1002	582	0	0	86	496	292	204
PCT9204	MV	686	309	0	0	35	274	154	120
PCT9204	ED	176	219	0	0	30	189	116	73
PCT9204	TO	862	528	0	0	65	463	270	193
PCT9205	MV	622	289	0	0	37	252	168	84
PCT9205	ED	114	171	0	0	25	146	92	54
PCT9205	TO	736	460	0	0	62	398	260	138
PCT9206	MV	741	355	0	0	30	325	180	145
PCT9206	ED	188	208	0	0	41	167	98	69
PCT9206	TO	929	563	0	0	71	492	278	214
PCT9207	MV	824	370	0	0	33	337	188	149
PCT9207	ED	165	208	0	0	22	186	121	65
PCT9207	TO	989	578	0	0	55	523	309	214
PCT9208	MV	808	359	0	0	32	327	198	129
PCT9208	ED	179	199	0	0	21	178	119	59
PCT9208	TO	987	558	0	0	53	505	317	188
PCT9209	MV	615	276	0	0	25	251	156	95
PCT9209	ED	156	190	0	0	32	158	96	62
PCT9209	TO	771	466	0	0	57	409	252	157
PCT9211	MV	730	314	0	1	35	278	162	116
PCT9211	ED	161	191	0	0	31	160	97	63
PCT9211	TO	891	505	0	1	66	438	259	179
PCT9212	MV	671	284	0	1	27	256	160	96
PCT9212	ED	137	192	0	0	35	157	103	54
PCT9212	TO	808	476	0	1	62	413	263	150
PCT9213	MV	776	350	0	0	36	314	193	121
PCT9213	ED	161	212	0	0	32	180	113	67
PCT9213	TO	937	562	0	0	68	494	306	188
PCT9214	MV	517	236	0	0	19	217	137	80
PCT9214	ED	110	157	0	0	30	127	83	44
PCT9214	TO	627	393	0	0	49	344	220	124
PCT9215	MV	524	246	0	1	15	230	133	97
PCT9215	ED	120	152	0	0	20	132	81	51
PCT9215	TO	644	398	0	1	35	362	214	148
PCT9216	MV	669	266	0	0	33	233	134	99
PCT9216	ED	155	223	0	0	30	193	131	62
PCT9216	TO	824	489	0	0	63	426	265	161
PCT9217	MV	588	269	0	0	13	256	154	102
PCT9217	ED	117	160	0	0	12	148	96	52
PCT9217	TO	705	429	0	0	25	404	250	154
PCT9218	MV	652	278	0	0	26	252	142	110
PCT9218	ED	164	188	0	0	25	163	117	46
PCT9218	TO	816	466	0	0	51	415	259	156
PCT9219	MV	646	292	0	0	36	256	177	79
PCT9219	ED	144	204	0	0	27	177	131	46
PCT9219	TO	790	496	0	0	63	433	308	125
PCT9221	MV	562	325	0	0	19	306	165	141
PCT9221	ED	89	145	0	0	19	126	89	37
PCT9221	TO	651	470	0	0	38	432	254	178
PCT9222	MV	773	374	0	0	32	342	204	138
PCT9222	ED	137	210	0	0	29	181	121	60
PCT9222	TO	910	584	0	0	61	523	325	198
PCT9223	MV	558	268	0	0	19	249	144	105
PCT9223	ED	109	127	0	0	14	113	67	46
PCT9223	TO	667	395	0	0	33	362	211	151
PCT9224	MV	768	380	0	0	32	348	227	121
PCT9224	ED	181	220	0	0	32	188	118	70
PCT9224	TO	949	600	0	0	64	536	345	191
PCT9225	MV	757	304	0	0	27	277	176	101
PCT9225	ED	169	234	0	0	31	203	141	62
PCT9225	TO	926	538	0	0	58	480	317	163
PCT9226	MV	741	357	0	0	43	314	209	105
PCT9226	ED	155	239	0	0	27	212	156	56
PCT9226	TO	896	596	0	0	70	526	365	161
PCT9227	MV	605	373	0	0	27	346	215	131
PCT9227	ED	124	156	0	0	9	147	103	44
PCT9227	TO	729	529	0	0	36	493	318	175
PCT9228	MV	578	314	0	0	21	293	170	123
PCT9228	ED	160	188	0	0	16	172	111	61
PCT9228	TO	738	502	0	0	37	465	281	184
PCT9229	MV	460	257	0	0	20	237	171	66
PCT9229	ED	119	147	0	0	13	134	89	45
PCT9229	TO	579	404	0	0	33	371	260	111
PCT9231	MV	726	354	0	0	24	330	235	95
PCT9231	ED	236	282	0	0	25	257	185	72
PCT9231	TO	962	636	0	0	49	587	420	167
PCT9232	MV	608	295	0	1	29	265	155	110
PCT9232	ED	126	183	0	0	21	162	97	65
PCT9232	TO	734	478	0	1	50	427	252	175
PCT9233	MV	668	332	0	1	31	300	177	123
PCT9233	ED	150	201	0	0	28	173	126	47
PCT9233	TO	818	533	0	1	59	473	303	170
PCT9234	MV	643	322	0	0	28	294	181	113
PCT9234	ED	91	155	0	0	25	130	85	45
PCT9234	TO	734	477	0	0	53	424	266	158
PCT9235	MV	703	368	0	0	30	338	191	147
PCT9235	ED	160	212	0	0	19	193	129	64
PCT9235	TO	863	580	0	0	49	531	320	211
PCT9236	MV	537	283	0	0	24	259	172	87
PCT9236	ED	136	148	0	0	19	129	90	39
PCT9236	TO	673	431	0	0	43	388	262	126
PCT9237	MV	779	396	0	0	35	361	235	126
PCT9237	ED	118	206	0	0	22	184	123	61
PCT9237	TO	897	602	0	0	57	545	358	187
PCT9238	MV	687	330	0	0	33	297	168	129
PCT9238	ED	118	192	0	0	26	166	110	56
PCT9238	TO	805	522	0	0	59	463	278	185
PCT9239	MV	740	391	0	0	45	346	225	121
PCT9239	ED	124	174	0	0	22	152	114	38
PCT9239	TO	864	565	0	0	67	498	339	159
PCT9241	MV	819	404	0	0	36	368	224	144
PCT9241	ED	141	211	0	0	25	186	124	62
PCT9241	TO	960	615	0	0	61	554	348	206
PCT9242	MV	771	350	0	1	39	310	216	94
PCT9242	ED	172	238	0	0	35	203	146	57
PCT9242	TO	943	588	0	1	74	513	362	151
PCT9243	MV	480	242	0	0	22	220	147	73
PCT9243	ED	123	154	0	0	25	129	94	35
PCT9243	TO	603	396	0	0	47	349	241	108
PCT9244	MV	756	399	0	0	52	347	257	90
PCT9244	ED	154	206	0	0	20	186	121	65
PCT9244	TO	910	605	0	0	72	533	378	155
PCT9245	MV	616	301	0	0	31	270	170	100
PCT9245	ED	98	145	0	0	18	127	90	37
PCT9245	TO	714	446	0	0	49	397	260	137
PCT9246	MV	815	434	0	0	37	397	260	137
PCT9246	ED	155	214	0	0	27	187	139	48
PCT9246	TO	970	648	0	0	64	584	399	185
PCT9247	MV	764	381	0	0	23	358	258	100
PCT9247	ED	148	225	0	0	30	195	136	59
PCT9247	TO	912	606	0	0	53	553	394	159
PCT9248	MV	757	360	0	0	35	325	247	78
PCT9248	ED	150	211	0	0	21	190	143	47
PCT9248	TO	907	571	0	0	56	515	390	125
PCT9249	MV	724	379	0	0	32	347	246	101
PCT9249	ED	191	235	0	0	21	214	152	62
PCT9249	TO	915	614	0	0	53	561	398	163
PCT9251	MV	792	393	0	0	34	359	234	125
PCT9251	ED	174	248	0	0	21	227	162	65
PCT9251	TO	966	641	0	0	55	586	396	190
PCT9252	MV	811	383	0	0	32	351	218	133
PCT9252	ED	142	211	0	0	21	190	134	56
PCT9252	TO	953	594	0	0	53	541	352	189
PCT9253	MV	599	300	0	0	18	282	188	94
PCT9253	ED	162	170	0	0	16	154	109	45
PCT9253	TO	761	470	0	0	34	436	297	139
PCT9254	MV	758	415	0	0	29	386	286	100
PCT9254	ED	163	229	0	0	37	192	128	64
PCT9254	TO	921	644	0	0	66	578	414	164
PCT9255	MV	437	196	0	0	25	171	112	59
PCT9255	ED	113	155	0	0	22	133	103	30
PCT9255	TO	550	351	0	0	47	304	215	89
PCT9256	MV	367	169	0	0	13	156	114	42
PCT9256	ED	95	134	0	0	17	117	86	31
PCT9256	TO	462	303	0	0	30	273	200	73
PCT9257	MV	320	165	0	0	17	148	126	22
PCT9257	ED	0	23	0	0	4	19	17	2
PCT9257	TO	320	188	0	0	21	167	143	24
PCT9258	MV	583	307	0	0	29	278	191	87
PCT9258	ED	120	162	0	0	15	147	114	33
PCT9258	TO	703	469	0	0	44	425	305	120
PCT9401	MV	796	359	0	0	19	340	266	74
PCT9401	ED	242	259	0	0	21	238	200	38
PCT9401	TO	1038	618	0	0	40	578	466	112
PCT9402	MV	775	378	0	0	16	362	255	107
PCT9402	ED	242	226	0	0	18	208	170	38
PCT9402	TO	1017	604	0	0	34	570	425	145
PCT9403	MV	731	349	0	0	14	335	225	110
PCT9403	ED	190	183	0	0	11	172	149	23
PCT9403	TO	921	532	0	0	25	507	374	133
PCT9404	MV	753	345	0	0	17	328	211	117
PCT9404	ED	191	209	0	0	18	191	140	51
PCT9404	TO	944	554	0	0	35	519	351	168
PCT9405	MV	629	278	0	0	20	258	161	97
PCT9405	ED	151	145	0	0	6	139	92	47
PCT9405	TO	780	423	0	0	26	397	253	144
PCT9406	MV	695	332	0	0	20	312	202	110
PCT9406	ED	188	198	0	0	15	183	132	51
PCT9406	TO	883	530	0	0	35	495	334	161
PCT9407	MV	712	369	0	0	13	356	265	91
PCT9407	ED	201	195	0	0	20	175	133	42
PCT9407	TO	913	564	0	0	33	531	398	133
PCT9408	MV	711	324	0	0	24	300	238	62
PCT9408	ED	152	195	0	0	19	176	140	36
PCT9408	TO	863	519	0	0	43	476	378	98
PCT9409	MV	443	227	0	0	20	207	157	50
PCT9409	ED	158	172	0	0	9	163	138	25
PCT9409	TO	601	399	0	0	29	370	295	75
PCT9411	MV	816	378	0	0	25	353	261	92
PCT9411	ED	191	239	0	0	15	224	184	40
PCT9411	TO	1007	617	0	0	40	577	445	132
PCT9412	MV	668	340	0	0	20	320	199	121
PCT9412	ED	202	199	0	0	12	187	136	51
PCT9412	TO	870	539	0	0	32	507	335	172
PCT9413	MV	757	379	0	0	37	342	206	136
PCT9413	ED	179	185	0	0	16	169	122	47
PCT9413	TO	936	564	0	0	53	511	328	183
PCT9414	MV	734	361	0	0	22	339	210	129
PCT9414	ED	186	162	0	0	8	154	114	40
PCT9414	TO	920	523	0	0	30	493	324	169
PCT9415	MV	634	315	0	0	18	297	191	106
PCT9415	ED	154	138	0	0	4	134	94	40
PCT9415	TO	788	453	0	0	22	431	285	146
PCT9416	MV	769	391	0	0	34	357	226	131
PCT9416	ED	230	206	0	0	9	197	136	61
PCT9416	TO	999	597	0	0	43	554	362	192
PCT9417	MV	629	322	0	0	21	301	167	134
PCT9417	ED	145	153	0	0	7	146	102	44
PCT9417	TO	774	475	0	0	28	447	269	178
PCT9418	MV	631	310	0	0	22	288	160	128
PCT9418	ED	188	161	0	0	10	151	101	50
PCT9418	TO	819	471	0	0	32	439	261	178
PCT9419	MV	736	371	0	0	23	348	181	167
PCT9419	ED	173	148	0	0	10	138	83	55
PCT9419	TO	909	519	0	0	33	486	264	222
PCT9421	MV	752	341	0	0	25	316	161	155
PCT9421	ED	173	172	0	0	11	161	112	49
PCT9421	TO	925	513	0	0	36	477	273	204
PCT9422	MV	831	413	0	0	27	386	226	160
PCT9422	ED	270	222	0	0	21	201	149	52
PCT9422	TO	1101	635	0	0	48	587	375	212
PCT9423	MV	714	318	0	0	22	296	183	113
PCT9423	ED	190	187	0	0	14	173	130	43
PCT9423	TO	904	505	0	0	36	469	313	156
PCT9424	MV	799	386	0	1	23	362	204	158
PCT9424	ED	210	171	0	0	17	154	109	45
PCT9424	TO	1009	557	0	1	40	516	313	203
PCT9425	MV	789	348	0	0	24	324	191	133
PCT9425	ED	187	183	0	0	13	170	117	53
PCT9425	TO	976	531	0	0	37	494	308	186
PCT9426	MV	697	326	0	0	22	304	161	143
PCT9426	ED	156	159	0	0	18	141	102	39
PCT9426	TO	853	485	0	0	40	445	263	182
PCT9427	MV	799	386	0	1	20	365	193	172
PCT9427	ED	188	171	0	0	22	149	92	57
PCT9427	TO	987	557	0	1	42	514	285	229
PCT9428	MV	811	353	0	0	27	326	196	130
PCT9428	ED	179	163	0	0	16	147	111	36
PCT9428	TO	990	516	0	0	43	473	307	166
PCT9429	MV	709	344	0	0	21	323	173	150
PCT9429	ED	197	175	0	0	23	152	95	57
PCT9429	TO	906	519	0	0	44	475	268	207
PCT9431	MV	832	413	0	0	28	385	204	181
PCT9431	ED	204	189	0	0	8	181	120	61
PCT9431	TO	1036	602	0	0	36	566	324	242
PCT9432	MV	743	361	0	0	32	329	184	145
PCT9432	ED	215	156	0	0	14	142	102	40
PCT9432	TO	958	517	0	0	46	471	286	185
PCT9433	MV	794	374	0	0	29	345	186	159
PCT9433	ED	164	137	0	1	7	129	76	53
PCT9433	TO	958	511	0	1	36	474	262	212
PCT9434	MV	785	387	0	0	28	359	229	130
PCT9434	ED	227	240	0	0	28	212	161	51
PCT9434	TO	1012	627	0	0	56	571	390	181
PCT9435	MV	779	366	0	0	25	341	188	153
PCT9435	ED	225	218	0	0	17	201	133	68
PCT9435	TO	1004	584	0	0	42	542	321	221
PCT9436	MV	842	387	0	0	20	367	204	163
PCT9436	ED	226	176	0	0	16	160	111	49
PCT9436	TO	1068	563	0	0	36	527	315	212
PCT9437	MV	736	376	0	0	18	358	209	149
PCT9437	ED	191	173	0	0	10	163	109	54
PCT9437	TO	927	549	0	0	28	521	318	203
PCT9438	MV	837	421	0	0	22	399	221	178
PCT9438	ED	152	129	0	0	10	119	88	31
PCT9438	TO	989	550	0	0	32	518	309	209
PCT9439	MV	718	344	0	0	17	327	195	132
PCT9439	ED	199	150	0	0	22	128	88	40
PCT9439	TO	917	494	0	0	39	455	283	172
PCT9441	MV	778	396	0	0	29	367	220	147
PCT9441	ED	193	188	0	0	15	173	134	39
PCT9441	TO	971	584	0	0	44	540	354	186
PCT9442	MV	830	382	0	0	37	345	189	156
PCT9442	ED	210	232	0	0	16	216	165	51
PCT9442	TO	1040	614	0	0	53	561	354	207
PCT9443	MV	760	363	0	0	21	342	213	129
PCT9443	ED	195	173	0	0	13	160	112	48
PCT9443	TO	955	536	0	0	34	502	325	177
PCT9444	MV	768	343	0	0	13	330	179	151
PCT9444	ED	197	154	0	0	16	138	93	45
PCT9444	TO	965	497	0	0	29	468	272	196
PCT9445	MV	830	407	0	0	26	381	227	154
PCT9445	ED	166	181	0	0	14	167	115	52
PCT9445	TO	996	588	0	0	40	548	342	206
PCT9446	MV	900	466	0	0	27	439	246	193
PCT9446	ED	216	185	0	0	16	169	115	54
PCT9446	TO	1116	651	0	0	43	608	361	247
PCT9447	MV	729	395	0	0	17	378	214	164
PCT9447	ED	192	203	0	0	22	181	126	55
PCT9447	TO	921	598	0	0	39	559	340	219
PCT9448	MV	742	347	0	0	21	326	190	136
PCT9448	ED	198	185	0	0	14	171	133	38
PCT9448	TO	940	532	0	0	35	497	323	174
PCT9449	MV	719	342	0	0	20	322	152	170
PCT9449	ED	162	129	0	0	11	118	76	42
PCT9449	TO	881	471	0	0	31	440	228	212
PCT9451	MV	353	178	0	0	7	171	86	85
PCT9451	ED	88	71	0	0	3	68	47	21
PCT9451	TO	441	249	0	0	10	239	133	106
PCT9452	MV	647	336	0	0	22	314	169	145
PCT9452	ED	195	199	0	0	15	184	118	66
PCT9452	TO	842	535	0	0	37	498	287	211
PCT9453	MV	409	220	0	0	13	207	107	100
PCT9453	ED	115	88	0	0	11	77	46	31
PCT9453	TO	524	308	0	0	24	284	153	131
PCT9501	MV	150	92	0	0	11	81	58	23
PCT9501	ED	0	5	0	0	1	4	3	1
PCT9501	TO	150	97	0	0	12	85	61	24
PCT9502	MV	251	136	0	0	12	124	91	33
PCT9502	ED	0	12	0	0	2	10	10	0
PCT9502	TO	251	148	0	0	14	134	101	33
PCT9503	MV	550	263	0	0	28	235	205	30
PCT9503	ED	150	139	0	0	15	124	102	22
PCT9503	TO	700	402	0	0	43	359	307	52
PCT9505	MV	589	296	0	0	23	273	203	70
PCT9505	ED	176	147	0	0	14	133	111	22
PCT9505	TO	765	443	0	0	37	406	314	92
PCT9506	MV	547	233	0	0	18	215	174	41
PCT9506	ED	207	147	0	0	12	135	114	21
PCT9506	TO	754	380	0	0	30	350	288	62
PCT9507	MV	556	306	0	0	22	284	229	55
PCT9507	ED	160	206	0	0	23	183	147	36
PCT9507	TO	716	512	0	0	45	467	376	91
PCT9508	MV	632	320	0	0	19	301	248	53
PCT9508	ED	148	212	0	0	27	185	159	26
PCT9508	TO	780	532	0	0	46	486	407	79
PCT9509	MV	585	297	0	0	19	278	207	71
PCT9509	ED	142	196	0	0	20	176	149	27
PCT9509	TO	727	493	0	0	39	454	356	98
PCT9511	MV	458	242	0	0	18	224	183	41
PCT9511	ED	176	179	0	0	15	164	132	32
PCT9511	TO	634	421	0	0	33	388	315	73
PCT9512	MV	617	328	0	0	20	308	238	70
PCT9512	ED	160	209	0	0	23	186	155	31
PCT9512	TO	777	537	0	0	43	494	393	101
PCT9513	MV	686	335	0	0	22	313	272	41
PCT9513	ED	191	202	0	0	17	185	157	28
PCT9513	TO	877	537	0	0	39	498	429	69
PCT9514	MV	713	353	0	0	31	322	258	64
PCT9514	ED	183	247	0	0	18	229	193	36
PCT9514	TO	896	600	0	0	49	551	451	100
PCT9515	MV	543	306	0	0	22	284	221	63
PCT9515	ED	169	192	0	0	22	170	137	33
PCT9515	TO	712	498	0	0	44	454	358	96
PCT9516	MV	705	367	0	0	27	340	256	84
PCT9516	ED	184	221	0	0	19	202	149	53
PCT9516	TO	889	588	0	0	46	542	405	137
PCT9517	MV	626	335	0	0	28	307	249	58
PCT9517	ED	162	200	0	0	21	179	154	25
PCT9517	TO	788	535	0	0	49	486	403	83
PCT9518	MV	642	319	0	0	29	290	239	51
PCT9518	ED	146	218	0	0	17	201	157	44
PCT9518	TO	788	537	0	0	46	491	396	95
PCT9519	MV	693	370	0	0	25	345	270	75
PCT9519	ED	198	260	0	0	23	237	178	59
PCT9519	TO	891	630	0	0	48	582	448	134
PCT9521	MV	687	352	0	0	25	327	256	71
PCT9521	ED	214	256	0	0	28	228	194	34
PCT9521	TO	901	608	0	0	53	555	450	105
PCT9701	MV	498	271	0	0	21	250	182	68
PCT9701	ED	156	163	0	0	10	153	128	25
PCT9701	TO	654	434	0	0	31	403	310	93
PCT9702	MV	554	309	0	0	17	292	208	84
PCT9702	ED	166	196	0	0	11	185	153	32
PCT9702	TO	720	505	0	0	28	477	361	116
PCT9703	MV	809	403	0	0	38	365	213	152
PCT9703	ED	182	200	0	0	12	188	137	51
PCT9703	TO	991	603	0	0	50	553	350	203
PCT9704	MV	760	426	0	0	30	396	259	137
PCT9704	ED	199	244	0	0	16	228	174	54
PCT9704	TO	959	670	0	0	46	624	433	191
PCT9705	MV	754	421	0	0	29	392	283	109
PCT9705	ED	175	203	0	0	18	185	152	33
PCT9705	TO	929	624	0	0	47	577	435	142
PCT9706	MV	49	35	0	0	3	32	25	7
PCT9706	ED	0	1	0	0	0	1	1	0
PCT9706	TO	49	36	0	0	3	33	26	7
PCT9707	MV	687	359	0	0	21	338	193	145
PCT9707	ED	139	146	0	0	15	131	87	44
PCT9707	TO	826	505	0	0	36	469	280	189
PCT9708	MV	786	432	0	1	38	393	281	112
PCT9708	ED	175	216	0	0	13	203	146	57
PCT9708	TO	961	648	0	1	51	596	427	169
PCT9709	MV	831	429	0	0	40	389	222	167
PCT9709	ED	209	230	0	0	15	215	145	70
PCT9709	TO	1040	659	0	0	55	604	367	237
PCT9711	MV	502	307	0	0	18	289	180	109
PCT9711	ED	144	168	0	0	12	156	99	57
PCT9711	TO	646	475	0	0	30	445	279	166
PCT9712	MV	534	337	0	0	21	316	183	133
PCT9712	ED	127	138	0	0	4	134	81	53
PCT9712	TO	661	475	0	0	25	450	264	186
PCT9713	MV	747	391	0	0	19	372	214	158
PCT9713	ED	203	182	0	0	12	170	112	58
PCT9713	TO	950	573	0	0	31	542	326	216
PCT9714	MV	795	447	0	0	31	416	239	177
PCT9714	ED	156	178	0	0	6	172	103	69
PCT9714	TO	951	625	0	0	37	588	342	246
PCT9715	MV	449	242	0	0	15	227	139	88
PCT9715	ED	130	157	0	0	5	152	104	48
PCT9715	TO	579	399	0	0	20	379	243	136
PCT9716	MV	745	401	0	0	30	371	221	150
PCT9716	ED	221	217	0	0	18	199	135	64
PCT9716	TO	966	618	0	0	48	570	356	214
PCT9717	MV	753	439	0	0	27	412	233	179
PCT9717	ED	224	194	0	0	18	176	109	67
PCT9717	TO	977	633	0	0	45	588	342	246
PCT9718	MV	749	451	0	0	28	423	261	162
PCT9718	ED	152	185	0	0	11	174	115	59
PCT9718	TO	901	636	0	0	39	597	376	221
PCT9719	MV	747	465	0	0	23	442	265	177
PCT9719	ED	173	191	0	0	16	175	113	62
PCT9719	TO	920	656	0	0	39	617	378	239
PCT9721	MV	498	291	0	0	20	271	144	127
PCT9721	ED	164	174	0	0	8	166	102	64
PCT9721	TO	662	465	0	0	28	437	246	191
PCT9722	MV	513	315	0	0	19	296	182	114
PCT9722	ED	84	101	0	0	11	90	58	32
PCT9722	TO	597	416	0	0	30	386	240	146
PCT9723	MV	436	224	0	0	9	215	76	139
PCT9723	ED	72	66	0	0	5	61	35	26
PCT9723	TO	508	290	0	0	14	276	111	165
PCT9724	MV	851	456	0	1	24	431	189	242
PCT9724	ED	169	144	0	0	9	135	79	56
PCT9724	TO	1020	600	0	1	33	566	268	298
PCT9725	MV	814	439	0	0	25	414	200	214
PCT9725	ED	157	166	0	0	17	149	83	66
PCT9725	TO	971	605	0	0	42	563	283	280
PCT9726	MV	630	217	0	0	19	198	153	45
PCT9726	ED	-14	280	0	0	23	257	223	34
PCT9726	TO	616	497	0	0	42	455	376	79
PCT9727	MV	404	227	0	2	11	214	117	97
PCT9727	ED	56	64	0	0	7	57	37	20
PCT9727	TO	460	291	0	2	18	271	154	117
PCT9728	MV	751	447	0	0	25	422	216	206
PCT9728	ED	212	184	0	0	10	174	107	67
PCT9728	TO	963	631	0	0	35	596	323	273
PCT9729	MV	654	338	0	0	23	315	160	155
PCT9729	ED	164	174	0	0	8	166	113	53
PCT9729	TO	818	512	0	0	31	481	273	208
PCT9731	MV	436	246	0	0	15	231	122	109
PCT9731	ED	143	145	0	0	15	130	77	53
PCT9731	TO	579	391	0	0	30	361	199	162
PCT9732	MV	73	47	0	0	6	41	22	19
PCT9732	ED	0	3	0	0	0	3	2	1
PCT9732	TO	73	50	0	0	6	44	24	20
PCT9733	MV	240	162	0	0	4	158	115	43
PCT9733	ED	0	12	0	0	2	10	8	2
PCT9733	TO	240	174	0	0	6	168	123	45
PCT9734	MV	473	290	0	0	18	272	153	119
PCT9734	ED	131	131	0	0	5	126	81	45
PCT9734	TO	604	421	0	0	23	398	234	164
PCT9735	MV	650	390	0	0	20	370	214	156
PCT9735	ED	170	187	0	0	26	161	98	63
PCT9735	TO	820	577	0	0	46	531	312	219
PCT9736	MV	586	329	0	0	21	308	201	107
PCT9736	ED	150	187	0	0	18	169	111	58
PCT9736	TO	736	516	0	0	39	477	312	165
PCT9737	MV	637	390	0	0	22	368	208	160
PCT9737	ED	154	164	0	0	13	151	109	42
PCT9737	TO	791	554	0	0	35	519	317	202
PCT9738	MV	688	320	0	0	22	298	222	76
PCT9738	ED	150	118	0	0	10	108	81	27
PCT9738	TO	838	438	0	0	32	406	303	103
PCT9739	MV	674	273	0	0	10	263	215	48
PCT9739	ED	115	249	0	0	20	229	197	32
PCT9739	TO	789	522	0	0	30	492	412	80
PCT9741	MV	842	174	0	0	15	159	148	11
PCT9741	ED	-401	453	0	0	52	401	359	42
PCT9741	TO	441	627	0	0	67	560	507	53
PCT9742	MV	530	229	0	0	10	219	112	107
PCT9742	ED	165	163	0	0	12	151	96	55
PCT9742	TO	695	392	0	0	22	370	208	162
PCT9743	MV	913	405	0	0	21	384	285	99
PCT9743	ED	227	261	0	0	24	237	194	43
PCT9743	TO	1140	666	0	0	45	621	479	142
PCT9744	MV	783	334	0	0	22	312	248	64
PCT9744	ED	160	262	0	0	36	226	195	31
PCT9744	TO	943	596	0	0	58	538	443	95
PCT9745	MV	791	321	0	0	23	298	245	53
PCT9745	ED	201	237	0	0	21	216	191	25
PCT9745	TO	992	558	0	0	44	514	436	78
PCT9746	MV	714	374	0	0	13	361	220	141
PCT9746	ED	189	154	0	0	12	142	91	51
PCT9746	TO	903	528	0	0	25	503	311	192
PCT9747	MV	772	401	0	0	18	383	257	126
PCT9747	ED	204	193	0	0	15	178	132	46
PCT9747	TO	976	594	0	0	33	561	389	172
PCT9748	MV	746	425	0	1	22	402	268	134
PCT9748	ED	167	164	0	0	9	155	98	57
PCT9748	TO	913	589	0	1	31	557	366	191
PCT9749	MV	750	289	0	0	9	280	196	84
PCT9749	ED	188	170	0	0	6	164	135	29
PCT9749	TO	938	459	0	0	15	444	331	113
PCT9751	MV	857	475	0	1	29	445	277	168
PCT9751	ED	214	205	0	0	25	180	139	41
PCT9751	TO	1071	680	0	1	54	625	416	209
PCT9752	MV	563	330	0	0	20	310	183	127
PCT9752	ED	134	156	0	0	8	148	110	38
PCT9752	TO	697	486	0	0	28	458	293	165
PCT9753	MV	617	300	0	0	18	282	206	76
PCT9753	ED	145	168	0	0	6	162	123	39
PCT9753	TO	762	468	0	0	24	444	329	115
PCT9754	MV	545	317	0	0	15	302	228	74
PCT9754	ED	162	149	0	0	13	136	111	25
PCT9754	TO	707	466	0	0	28	438	339	99
PCT9755	MV	441	240	0	0	18	222	152	70
PCT9755	ED	139	134	0	0	6	128	96	32
PCT9755	TO	580	374	0	0	24	350	248	102
PCT9756	MV	805	365	0	0	23	342	195	147
PCT9756	ED	162	153	0	0	10	143	104	39
PCT9756	TO	967	518	0	0	33	485	299	186
PCT9801	MV	320	163	0	0	12	151	109	42
PCT9801	ED	88	68	0	0	5	63	52	11
PCT9801	TO	408	231	0	0	17	214	161	53
PCT9900	MV	0	0	0	0	0	0	0	0
PCT9900	ED	0	0	0	0	0	0	0	0
PCT9900	TO	0	0	0	0	0	0	0	0
PCT9901	MV	0	0	0	0	0	0	0	0
PCT9901	ED	0	0	0	0	0	0	0	0
PCT9901	TO	0	0	0	0	0	0	0	0
PCT9902	MV	0	0	0	0	0	0	0	0
PCT9902	ED	0	0	0	0	0	0	0	0
PCT9902	TO	0	0	0	0	0	0	0	0
CONG12	MV	355625	175442	0	29	13131	162282	114895	47387
CONG12	ED	90223	96085	0	13	9201	86871	67345	19526
CONG12	TO	445848	271527	0	42	22332	249153	182240	66913
CONG14	MV	47258	22461	0	10	1228	21223	13261	7962
CONG14	ED	10793	10916	0	0	859	10057	7501	2556
CONG14	TO	58051	33377	0	10	2087	31280	20762	10518
ASSM17	MV	232812	115055	0	17	8617	106421	78304	28117
ASSM17	ED	59610	61730	0	12	5915	55803	44596	11207
ASSM17	TO	292422	176785	0	29	14532	162224	122900	39324
ASSM19	MV	170071	82848	0	22	5742	77084	49852	27232
ASSM19	ED	41406	45271	0	1	4145	41125	30250	10875
ASSM19	TO	211477	128119	0	23	9887	118209	80102	38107
SUPV1	MV	33870	16645	0	2	1152	15491	10638	4853
SUPV1	ED	9246	10132	0	0	875	9257	7061	2196
SUPV1	TO	43116	26777	0	2	2027	24748	17699	7049
SUPV2	MV	41438	20052	0	8	1841	18203	11809	6394
SUPV2	ED	8608	11685	0	0	1444	10241	7090	3151
SUPV2	TO	50046	31737	0	8	3285	28444	18899	9545
SUPV3	MV	31945	14472	0	4	1289	13179	9132	4047
SUPV3	ED	7432	7841	0	5	903	6933	5343	1590
SUPV3	TO	39377	22313	0	9	2192	20112	14475	5637
SUPV4	MV	35051	16947	0	2	1068	15877	9481	6396
SUPV4	ED	9043	8532	0	1	681	7850	5651	2199
SUPV4	TO	44094	25479	0	3	1749	23727	15132	8595
SUPV5	MV	41973	21589	0	1	1702	19886	15795	4091
SUPV5	ED	10927	13129	0	1	1282	11846	9797	2049
SUPV5	TO	52900	34718	0	2	2984	31732	25592	6140
SUPV6	MV	35759	15272	0	2	1253	14017	10265	3752
SUPV6	ED	7936	7226	0	2	865	6359	5014	1345
SUPV6	TO	43695	22498	0	4	2118	20376	15279	5097
SUPV7	MV	38894	20831	0	7	1287	19537	12333	7204
SUPV7	ED	8549	10568	0	0	821	9747	7020	2727
SUPV7	TO	47443	31399	0	7	2108	29284	19353	9931
SUPV8	MV	46374	27611	0	5	2018	25588	19355	6233
SUPV8	ED	11803	15032	0	4	1302	13726	10986	2740
SUPV8	TO	58177	42643	0	9	3320	39314	30341	8973
SUPV9	MV	33168	16843	0	1	1062	15780	12071	3709
SUPV9	ED	10095	10044	0	0	805	9239	7699	1540
SUPV9	TO	43263	26887	0	1	1867	25019	19770	5249
SUPV10	MV	33768	14153	0	2	966	13185	9142	4043
SUPV10	ED	9345	6711	0	0	617	6094	4836	1258
SUPV10	TO	43113	20864	0	2	1583	19279	13978	5301
SUPV11	MV	30643	13488	0	5	721	12762	8135	4627
SUPV11	ED	8032	6101	0	0	465	5636	4349	1287
SUPV11	TO	38675	19589	0	5	1186	18398	12484	5914
NEIG1	MV	15466	5990	0	1	397	5592	3822	1770
NEIG1	ED	5019	2611	0	0	204	2407	1932	475
NEIG1	TO	20485	8601	0	1	601	7999	5754	2245
NEIG2	MV	14029	6299	0	0	626	5673	3796	1877
NEIG2	ED	3238	3340	0	2	407	2931	2204	727
NEIG2	TO	17267	9639	0	2	1033	8604	6000	2604
NEIG3	MV	22051	9527	0	4	811	8712	6672	2040
NEIG3	ED	5968	4993	0	3	532	4458	3619	839
NEIG3	TO	28019	14520	0	7	1343	13170	10291	2879
NEIG4	MV	5630	3506	0	0	233	3273	2296	977
NEIG4	ED	1430	1651	0	1	136	1514	1112	402
NEIG4	TO	7060	5157	0	1	369	4787	3408	1379
NEIG5	MV	22699	10156	0	1	571	9584	6090	3494
NEIG5	ED	5894	4403	0	0	332	4071	3086	985
NEIG5	TO	28593	14559	0	1	903	13655	9176	4479
NEIG6	MV	11529	5996	0	1	445	5550	4485	1065
NEIG6	ED	2333	3919	0	1	371	3547	3001	546
NEIG6	TO	13862	9915	0	2	816	9097	7486	1611
NEIG7	MV	9819	4149	0	4	194	3951	2545	1406
NEIG7	ED	2576	2089	0	0	154	1935	1554	381
NEIG7	TO	12395	6238	0	4	348	5886	4099	1787
NEIG8	MV	7628	4046	0	0	315	3731	2888	843
NEIG8	ED	2030	2570	0	0	225	2345	1889	456
NEIG8	TO	9658	6616	0	0	540	6076	4777	1299
NEIG9	MV	7422	3163	0	1	190	2972	1981	991
NEIG9	ED	836	2236	0	0	217	2019	1637	382
NEIG9	TO	8258	5399	0	1	407	4991	3618	1373
NEIG10	MV	8173	3963	0	0	310	3653	2573	1080
NEIG10	ED	1849	2658	0	0	249	2409	1862	547
NEIG10	TO	10022	6621	0	0	559	6062	4435	1627
NEIG11	MV	33512	15582	0	6	1482	14094	9150	4944
NEIG11	ED	5928	9051	0	0	1173	7878	5462	2416
NEIG11	TO	39440	24633	0	6	2655	21972	14612	7360
NEIG12	MV	23578	11896	0	0	787	11109	9105	2004
NEIG12	ED	7427	7902	0	0	711	7191	6150	1041
NEIG12	TO	31005	19798	0	0	1498	18300	15255	3045
NEIG14	MV	6791	4011	0	0	274	3737	2972	765
NEIG14	ED	1942	2316	0	0	168	2148	1784	364
NEIG14	TO	8733	6327	0	0	442	5885	4756	1129
NEIG15	MV	5781	2687	0	1	181	2505	1662	843
NEIG15	ED	1307	1499	0	2	166	1331	1023	308
NEIG15	TO	7088	4186	0	3	347	3836	2685	1151
NEIG13	MV	13553	8198	0	2	628	7568	5600	1968
NEIG13	ED	3435	4443	0	0	369	4074	3200	874
NEIG13	TO	16988	12641	0	2	997	11642	8800	2842
NEIG26	MV	7830	3542	0	1	207	3334	1934	1400
NEIG26	ED	1802	1386	0	0	104	1282	935	347
NEIG26	TO	9632	4928	0	1	311	4616	2869	1747
NEIG16	MV	14624	6988	0	1	582	6405	4631	1774
NEIG16	ED	2732	3781	0	0	441	3340	2631	709
NEIG16	TO	17356	10769	0	1	1023	9745	7262	2483
NEIG17	MV	29449	14468	0	2	1006	13460	9185	4275
NEIG17	ED	8176	8551	0	0	735	7816	5935	1881
NEIG17	TO	37625	23019	0	2	1741	21276	15120	6156
NEIG19	MV	7164	4039	0	1	256	3782	2908	874
NEIG19	ED	2407	2408	0	0	181	2227	1813	414
NEIG19	TO	9571	6447	0	1	437	6009	4721	1288
NEIG18	MV	6458	3427	0	2	263	3162	2007	1155
NEIG18	ED	1563	2033	0	0	205	1828	1263	565
NEIG18	TO	8021	5460	0	2	468	4990	3270	1720
NEIG20	MV	20913	8936	0	1	715	8220	5851	2369
NEIG20	ED	4164	4219	0	0	516	3703	2834	869
NEIG20	TO	25077	13155	0	1	1231	11923	8685	3238
NEIG21	MV	34608	16720	0	2	1048	15670	9324	6346
NEIG21	ED	8885	8360	0	1	672	7687	5513	2174
NEIG21	TO	43493	25080	0	3	1720	23357	14837	8520
NEIG22	MV	15383	9329	0	2	677	8650	6604	2046
NEIG22	ED	3510	4904	0	3	423	4478	3611	867
NEIG22	TO	18893	14233	0	5	1100	13128	10215	2913
NEIG23	MV	6638	2527	0	0	138	2389	1463	926
NEIG23	ED	1850	947	0	0	84	863	672	191
NEIG23	TO	8488	3474	0	0	222	3252	2135	1117
NEIG24	MV	28440	16175	0	6	1013	15156	9387	5769
NEIG24	ED	6934	7515	0	0	554	6961	4772	2189
NEIG24	TO	35374	23690	0	6	1567	22117	14159	7958
NEIG25	MV	23715	12583	0	0	1010	11573	9225	2348
NEIG25	ED	7781	7216	0	0	731	6485	5352	1133
NEIG25	TO	31496	19799	0	0	1741	18058	14577	3481
