area_id	subtotal_type	RSReg	RSCst	RSRej	RSOvr	RSUnd	RSTot	5:YES	6:NO
ALLPCTS	TO	503899	281773	0	55	19554	262164	216304	45860
ALLPCTS	ED	101053	84584	0	15	6600	77969	66236	11733
ALLPCTS	MV	402846	197189	0	40	12954	184195	150068	34127
PCT1101	MV	448	215	0	0	14	201	155	46
PCT1101	ED	114	61	0	0	5	56	46	10
PCT1101	TO	562	276	0	0	19	257	201	56
PCT1102	MV	774	369	0	0	15	354	250	104
PCT1102	ED	230	162	0	0	10	152	120	32
PCT1102	TO	1004	531	0	0	25	506	370	136
PCT1103	MV	749	371	0	0	19	352	270	82
PCT1103	ED	222	144	0	0	6	138	111	27
PCT1103	TO	971	515	0	0	25	490	381	109
PCT1104	MV	751	343	0	0	12	331	263	68
PCT1104	ED	267	122	0	0	6	116	93	23
PCT1104	TO	1018	465	0	0	18	447	356	91
PCT1106	MV	598	255	0	0	16	239	163	76
PCT1106	ED	173	97	0	1	6	90	69	21
PCT1106	TO	771	352	0	1	22	329	232	97
PCT1107	MV	612	287	0	0	14	273	186	87
PCT1107	ED	139	76	0	0	7	69	57	12
PCT1107	TO	751	363	0	0	21	342	243	99
PCT1108	MV	725	360	0	0	17	343	272	71
PCT1108	ED	198	116	0	0	9	107	85	22
PCT1108	TO	923	476	0	0	26	450	357	93
PCT1109	MV	653	284	0	0	12	272	183	89
PCT1109	ED	169	99	0	0	4	95	76	19
PCT1109	TO	822	383	0	0	16	367	259	108
PCT1111	MV	849	354	0	0	17	337	235	102
PCT1111	ED	197	118	0	0	6	112	89	23
PCT1111	TO	1046	472	0	0	23	449	324	125
PCT1112	MV	643	278	0	0	14	264	198	66
PCT1112	ED	159	79	0	0	5	74	62	12
PCT1112	TO	802	357	0	0	19	338	260	78
PCT1113	MV	675	286	0	0	15	271	190	81
PCT1113	ED	120	65	0	0	6	59	49	10
PCT1113	TO	795	351	0	0	21	330	239	91
PCT1114	MV	769	328	0	0	22	306	240	66
PCT1114	ED	222	98	0	0	9	89	79	10
PCT1114	TO	991	426	0	0	31	395	319	76
PCT1115	MV	743	295	0	0	16	279	201	78
PCT1115	ED	193	89	0	0	2	87	71	16
PCT1115	TO	936	384	0	0	18	366	272	94
PCT1116	MV	715	308	0	0	18	290	217	73
PCT1116	ED	216	119	0	0	7	112	103	9
PCT1116	TO	931	427	0	0	25	402	320	82
PCT1117	MV	665	258	0	0	14	244	183	61
PCT1117	ED	181	72	0	0	4	68	59	9
PCT1117	TO	846	330	0	0	18	312	242	70
PCT1118	MV	846	357	0	0	15	342	245	97
PCT1118	ED	219	106	0	0	11	95	74	21
PCT1118	TO	1065	463	0	0	26	437	319	118
PCT1119	MV	659	303	0	0	12	291	226	65
PCT1119	ED	138	75	0	0	7	68	64	4
PCT1119	TO	797	378	0	0	19	359	290	69
PCT1121	MV	556	268	0	0	20	248	164	84
PCT1121	ED	149	87	0	0	6	81	59	22
PCT1121	TO	705	355	0	0	26	329	223	106
PCT1122	MV	519	245	0	0	13	232	163	69
PCT1122	ED	118	71	0	0	5	66	55	11
PCT1122	TO	637	316	0	0	18	298	218	80
PCT1123	MV	730	257	0	0	16	241	164	77
PCT1123	ED	208	89	0	0	6	83	67	16
PCT1123	TO	938	346	0	0	22	324	231	93
PCT1124	MV	630	246	0	2	7	237	180	57
PCT1124	ED	199	76	0	0	3	73	64	9
PCT1124	TO	829	322	0	2	10	310	244	66
PCT1125	MV	919	364	0	0	31	333	231	102
PCT1125	ED	178	68	0	0	7	61	55	6
PCT1125	TO	1097	432	0	0	38	394	286	108
PCT1126	MV	812	308	0	0	16	292	223	69
PCT1126	ED	200	68	0	0	1	67	53	14
PCT1126	TO	1012	376	0	0	17	359	276	83
PCT1127	MV	743	293	0	0	12	281	186	95
PCT1127	ED	222	101	0	0	3	98	76	22
PCT1127	TO	965	394	0	0	15	379	262	117
PCT1128	MV	734	287	0	0	13	274	180	94
PCT1128	ED	145	59	0	0	6	53	42	11
PCT1128	TO	879	346	0	0	19	327	222	105
PCT1129	MV	790	314	0	0	22	292	201	91
PCT1129	ED	246	109	0	0	13	96	69	27
PCT1129	TO	1036	423	0	0	35	388	270	118
PCT1131	MV	694	280	0	0	22	258	181	77
PCT1131	ED	166	61	0	0	4	57	49	8
PCT1131	TO	860	341	0	0	26	315	230	85
PCT1132	MV	839	370	0	0	24	346	252	94
PCT1132	ED	193	60	0	0	0	60	39	21
PCT1132	TO	1032	430	0	0	24	406	291	115
PCT1133	MV	716	334	0	0	12	322	243	79
PCT1133	ED	159	74	0	0	3	71	51	20
PCT1133	TO	875	408	0	0	15	393	294	99
PCT1134	MV	585	293	0	0	11	282	180	102
PCT1134	ED	182	80	0	0	7	73	64	9
PCT1134	TO	767	373	0	0	18	355	244	111
PCT1135	MV	465	218	0	0	5	213	153	60
PCT1135	ED	91	51	0	0	1	50	41	9
PCT1135	TO	556	269	0	0	6	263	194	69
PCT1136	MV	710	340	0	0	16	324	243	81
PCT1136	ED	157	79	0	0	4	75	65	10
PCT1136	TO	867	419	0	0	20	399	308	91
PCT1141	MV	836	393	0	0	19	374	269	105
PCT1141	ED	220	124	0	0	4	120	93	27
PCT1141	TO	1056	517	0	0	23	494	362	132
PCT1142	MV	721	324	0	0	26	298	238	60
PCT1142	ED	175	87	0	0	3	84	73	11
PCT1142	TO	896	411	0	0	29	382	311	71
PCT1143	MV	824	360	0	0	22	338	242	96
PCT1143	ED	225	116	0	0	7	109	94	15
PCT1143	TO	1049	476	0	0	29	447	336	111
PCT1144	MV	727	326	0	0	10	316	220	96
PCT1144	ED	220	121	0	0	9	112	86	26
PCT1144	TO	947	447	0	0	19	428	306	122
PCT1145	MV	753	411	0	0	25	386	274	112
PCT1145	ED	152	114	0	0	8	106	83	23
PCT1145	TO	905	525	0	0	33	492	357	135
PCT1146	MV	839	364	0	0	15	349	276	73
PCT1146	ED	215	110	0	0	7	103	79	24
PCT1146	TO	1054	474	0	0	22	452	355	97
PCT1147	MV	673	309	0	0	11	298	215	83
PCT1147	ED	212	108	0	0	5	103	83	20
PCT1147	TO	885	417	0	0	16	401	298	103
PCT1148	MV	804	368	0	0	16	352	245	107
PCT1148	ED	224	119	0	0	8	111	88	23
PCT1148	TO	1028	487	0	0	24	463	333	130
PCT1149	MV	710	319	0	1	22	296	212	84
PCT1149	ED	229	119	0	0	9	110	84	26
PCT1149	TO	939	438	0	1	31	406	296	110
PCT1152	MV	710	313	0	0	17	296	220	76
PCT1152	ED	180	87	0	0	7	80	60	20
PCT1152	TO	890	400	0	0	24	376	280	96
PCT1153	MV	730	285	0	0	17	268	205	63
PCT1153	ED	210	117	0	0	9	108	77	31
PCT1153	TO	940	402	0	0	26	376	282	94
PCT7001	MV	632	329	0	0	21	308	269	39
PCT7001	ED	141	105	0	0	6	99	87	12
PCT7001	TO	773	434	0	0	27	407	356	51
PCT7002	MV	598	267	0	0	21	246	211	35
PCT7002	ED	116	90	0	0	3	87	75	12
PCT7002	TO	714	357	0	0	24	333	286	47
PCT7003	MV	759	432	0	0	24	408	349	59
PCT7003	ED	147	144	0	0	12	132	108	24
PCT7003	TO	906	576	0	0	36	540	457	83
PCT7004	MV	764	416	0	0	25	391	335	56
PCT7004	ED	149	146	0	0	10	136	113	23
PCT7004	TO	913	562	0	0	35	527	448	79
PCT7005	MV	698	350	0	0	23	327	293	34
PCT7005	ED	161	163	0	0	17	146	134	12
PCT7005	TO	859	513	0	0	40	473	427	46
PCT7006	MV	729	360	0	0	26	334	294	40
PCT7006	ED	203	153	0	0	12	141	116	25
PCT7006	TO	932	513	0	0	38	475	410	65
PCT7007	MV	777	437	0	0	30	407	350	57
PCT7007	ED	180	174	0	0	14	160	139	21
PCT7007	TO	957	611	0	0	44	567	489	78
PCT7008	MV	732	367	0	0	30	337	280	57
PCT7008	ED	177	194	0	0	12	182	155	27
PCT7008	TO	909	561	0	0	42	519	435	84
PCT7009	MV	752	390	0	0	26	364	302	62
PCT7009	ED	119	95	0	0	5	90	75	15
PCT7009	TO	871	485	0	0	31	454	377	77
PCT7011	MV	704	231	0	0	18	213	184	29
PCT7011	ED	269	88	0	0	5	83	74	9
PCT7011	TO	973	319	0	0	23	296	258	38
PCT7012	MV	999	487	0	0	34	453	390	63
PCT7012	ED	227	209	0	0	11	198	173	25
PCT7012	TO	1226	696	0	0	45	651	563	88
PCT7013	MV	984	427	0	0	27	400	359	41
PCT7013	ED	155	157	0	0	11	146	136	10
PCT7013	TO	1139	584	0	0	38	546	495	51
PCT7014	MV	610	303	0	0	18	285	253	32
PCT7014	ED	109	115	0	0	15	100	87	13
PCT7014	TO	719	418	0	0	33	385	340	45
PCT7015	MV	128	40	0	0	5	35	31	4
PCT7015	ED	-18	0	0	0	0	0	0	0
PCT7015	TO	110	40	0	0	5	35	31	4
PCT7016	MV	655	239	0	0	16	223	162	61
PCT7016	ED	277	79	0	0	7	72	62	10
PCT7016	TO	932	318	0	0	23	295	224	71
PCT7017	MV	543	180	0	0	18	162	134	28
PCT7017	ED	238	53	0	0	8	45	40	5
PCT7017	TO	781	233	0	0	26	207	174	33
PCT7018	MV	847	357	0	0	20	337	247	90
PCT7018	ED	200	56	0	0	4	52	46	6
PCT7018	TO	1047	413	0	0	24	389	293	96
PCT7019	MV	734	355	0	0	25	330	242	88
PCT7019	ED	166	74	0	0	8	66	55	11
PCT7019	TO	900	429	0	0	33	396	297	99
PCT7021	MV	679	271	0	0	18	253	207	46
PCT7021	ED	288	108	0	0	9	99	86	13
PCT7021	TO	967	379	0	0	27	352	293	59
PCT7022	MV	770	312	0	0	27	285	235	50
PCT7022	ED	193	55	0	0	2	53	49	4
PCT7022	TO	963	367	0	0	29	338	284	54
PCT7023	MV	687	331	0	0	16	315	252	63
PCT7023	ED	233	72	0	0	6	66	58	8
PCT7023	TO	920	403	0	0	22	381	310	71
PCT7024	MV	251	50	0	0	3	47	42	5
PCT7024	ED	190	20	0	0	3	17	17	0
PCT7024	TO	441	70	0	0	6	64	59	5
PCT7025	MV	316	95	0	0	5	90	79	11
PCT7025	ED	167	39	0	0	1	38	34	4
PCT7025	TO	483	134	0	0	6	128	113	15
PCT7026	MV	819	336	0	1	13	322	211	111
PCT7026	ED	191	72	0	0	4	68	52	16
PCT7026	TO	1010	408	0	1	17	390	263	127
PCT7027	MV	677	270	0	0	19	251	184	67
PCT7027	ED	219	99	0	0	8	91	72	19
PCT7027	TO	896	369	0	0	27	342	256	86
PCT7028	MV	585	220	0	0	15	205	168	37
PCT7028	ED	271	100	0	0	7	93	77	16
PCT7028	TO	856	320	0	0	22	298	245	53
PCT7029	MV	642	209	0	0	20	189	149	40
PCT7029	ED	267	40	0	0	2	38	33	5
PCT7029	TO	909	249	0	0	22	227	182	45
PCT7030	MV	654	274	0	0	9	265	168	97
PCT7030	ED	141	59	0	0	2	57	37	20
PCT7030	TO	795	333	0	0	11	322	205	117
PCT7031	MV	622	263	0	1	23	239	193	46
PCT7031	ED	72	49	0	0	6	43	34	9
PCT7031	TO	694	312	0	1	29	282	227	55
PCT7032	MV	643	266	0	0	20	246	204	42
PCT7032	ED	238	54	0	0	3	51	39	12
PCT7032	TO	881	320	0	0	23	297	243	54
PCT7033	MV	549	214	0	0	17	197	154	43
PCT7033	ED	229	86	0	0	7	79	62	17
PCT7033	TO	778	300	0	0	24	276	216	60
PCT7034	MV	620	142	0	0	15	127	118	9
PCT7034	ED	318	60	0	0	3	57	49	8
PCT7034	TO	938	202	0	0	18	184	167	17
PCT7035	MV	567	237	0	0	17	220	178	42
PCT7035	ED	152	54	0	0	5	49	42	7
PCT7035	TO	719	291	0	0	22	269	220	49
PCT7036	MV	781	263	0	0	13	250	169	81
PCT7036	ED	193	39	0	0	1	38	30	8
PCT7036	TO	974	302	0	0	14	288	199	89
PCT7037	MV	434	63	0	0	4	59	48	11
PCT7037	ED	312	38	0	0	5	33	31	2
PCT7037	TO	746	101	0	0	9	92	79	13
PCT7038	MV	758	308	0	0	20	288	194	94
PCT7038	ED	203	60	0	0	8	52	42	10
PCT7038	TO	961	368	0	0	28	340	236	104
PCT7039	MV	636	243	0	0	14	229	154	75
PCT7039	ED	201	104	0	0	6	98	69	29
PCT7039	TO	837	347	0	0	20	327	223	104
PCT7041	MV	70	29	0	0	4	25	17	8
PCT7041	ED	-4	0	0	0	0	0	0	0
PCT7041	TO	66	29	0	0	4	25	17	8
PCT7042	MV	514	222	0	0	9	213	167	46
PCT7042	ED	146	62	0	0	3	59	46	13
PCT7042	TO	660	284	0	0	12	272	213	59
PCT7043	MV	754	295	0	0	17	278	198	80
PCT7043	ED	224	79	0	0	3	76	56	20
PCT7043	TO	978	374	0	0	20	354	254	100
PCT7044	MV	586	149	0	0	5	144	116	28
PCT7044	ED	266	36	0	0	2	34	29	5
PCT7044	TO	852	185	0	0	7	178	145	33
PCT7045	MV	632	267	0	0	14	253	174	79
PCT7045	ED	154	53	0	0	2	51	34	17
PCT7045	TO	786	320	0	0	16	304	208	96
PCT7046	MV	334	132	0	0	4	128	90	38
PCT7046	ED	96	48	0	0	2	46	36	10
PCT7046	TO	430	180	0	0	6	174	126	48
PCT7047	MV	733	315	0	0	20	295	193	102
PCT7047	ED	150	62	0	0	4	58	47	11
PCT7047	TO	883	377	0	0	24	353	240	113
PCT7048	MV	685	267	0	0	12	255	195	60
PCT7048	ED	196	59	0	0	6	53	40	13
PCT7048	TO	881	326	0	0	18	308	235	73
PCT7049	MV	616	247	0	0	11	236	150	86
PCT7049	ED	210	71	0	0	4	67	54	13
PCT7049	TO	826	318	0	0	15	303	204	99
PCT7051	MV	715	306	0	0	21	285	179	106
PCT7051	ED	165	70	0	0	7	63	50	13
PCT7051	TO	880	376	0	0	28	348	229	119
PCT7052	MV	722	296	0	0	9	287	200	87
PCT7052	ED	184	88	0	0	6	82	70	12
PCT7052	TO	906	384	0	0	15	369	270	99
PCT7053	MV	542	227	0	0	29	198	148	50
PCT7053	ED	43	42	0	0	4	38	34	4
PCT7053	TO	585	269	0	0	33	236	182	54
PCT7054	MV	863	310	0	0	16	294	240	54
PCT7054	ED	273	109	0	0	5	104	77	27
PCT7054	TO	1136	419	0	0	21	398	317	81
PCT7055	MV	732	292	0	0	16	276	224	52
PCT7055	ED	94	78	0	0	7	71	61	10
PCT7055	TO	826	370	0	0	23	347	285	62
PCT7056	MV	618	275	0	0	20	255	222	33
PCT7056	ED	87	122	0	0	15	107	93	14
PCT7056	TO	705	397	0	0	35	362	315	47
PCT7101	MV	162	99	0	0	6	93	88	5
PCT7101	ED	-15	4	0	0	1	3	3	0
PCT7101	TO	147	103	0	0	7	96	91	5
PCT7201	MV	788	383	0	0	23	360	298	62
PCT7201	ED	147	170	0	0	20	150	126	24
PCT7201	TO	935	553	0	0	43	510	424	86
PCT7202	MV	708	308	0	0	23	285	225	60
PCT7202	ED	143	158	0	0	15	143	122	21
PCT7202	TO	851	466	0	0	38	428	347	81
PCT7203	MV	693	321	0	0	33	288	239	49
PCT7203	ED	186	187	0	0	22	165	136	29
PCT7203	TO	879	508	0	0	55	453	375	78
PCT7204	MV	773	422	0	0	43	379	319	60
PCT7204	ED	126	157	0	0	27	130	110	20
PCT7204	TO	899	579	0	0	70	509	429	80
PCT7205	MV	724	360	0	0	26	334	274	60
PCT7205	ED	147	177	0	0	15	162	130	32
PCT7205	TO	871	537	0	0	41	496	404	92
PCT7206	MV	299	129	0	0	10	119	98	21
PCT7206	ED	78	106	0	0	11	95	83	12
PCT7206	TO	377	235	0	0	21	214	181	33
PCT7207	MV	744	333	0	0	25	308	255	53
PCT7207	ED	123	154	0	0	12	142	125	17
PCT7207	TO	867	487	0	0	37	450	380	70
PCT7208	MV	492	253	0	0	27	226	184	42
PCT7208	ED	78	97	0	0	8	89	83	6
PCT7208	TO	570	350	0	0	35	315	267	48
PCT7209	MV	595	341	0	0	28	313	270	43
PCT7209	ED	52	75	0	0	6	69	56	13
PCT7209	TO	647	416	0	0	34	382	326	56
PCT7301	MV	813	319	0	0	16	303	253	50
PCT7301	ED	201	143	0	0	15	128	104	24
PCT7301	TO	1014	462	0	0	31	431	357	74
PCT7302	MV	713	352	0	0	22	330	269	61
PCT7302	ED	136	140	0	0	10	130	118	12
PCT7302	TO	849	492	0	0	32	460	387	73
PCT7303	MV	869	376	0	0	23	353	289	64
PCT7303	ED	199	172	0	0	17	155	135	20
PCT7303	TO	1068	548	0	0	40	508	424	84
PCT7304	MV	802	366	0	0	27	339	260	79
PCT7304	ED	199	185	0	0	13	172	151	21
PCT7304	TO	1001	551	0	0	40	511	411	100
PCT7305	MV	713	386	0	0	26	360	273	87
PCT7305	ED	154	155	0	0	12	143	116	27
PCT7305	TO	867	541	0	0	38	503	389	114
PCT7306	MV	801	374	0	0	36	338	264	74
PCT7306	ED	243	194	0	1	30	163	138	25
PCT7306	TO	1044	568	0	1	66	501	402	99
PCT7307	MV	605	272	0	0	13	259	209	50
PCT7307	ED	169	130	0	0	13	117	100	17
PCT7307	TO	774	402	0	0	26	376	309	67
PCT7308	MV	520	257	0	0	10	247	196	51
PCT7308	ED	105	158	0	0	12	146	125	21
PCT7308	TO	625	415	0	0	22	393	321	72
PCT7309	MV	691	324	0	0	29	295	253	42
PCT7309	ED	167	191	0	0	17	174	151	23
PCT7309	TO	858	515	0	0	46	469	404	65
PCT7311	MV	698	333	0	0	23	310	265	45
PCT7311	ED	208	218	0	0	18	200	179	21
PCT7311	TO	906	551	0	0	41	510	444	66
PCT7312	MV	700	395	0	0	26	369	299	70
PCT7312	ED	110	162	0	0	15	147	119	28
PCT7312	TO	810	557	0	0	41	516	418	98
PCT7313	MV	819	373	0	0	23	350	283	67
PCT7313	ED	184	163	0	0	23	140	123	17
PCT7313	TO	1003	536	0	0	46	490	406	84
PCT7314	MV	612	226	0	0	19	207	158	49
PCT7314	ED	147	85	0	0	13	72	63	9
PCT7314	TO	759	311	0	0	32	279	221	58
PCT7315	MV	570	206	0	0	9	197	155	42
PCT7315	ED	195	135	0	0	9	126	103	23
PCT7315	TO	765	341	0	0	18	323	258	65
PCT7316	MV	654	261	0	0	28	233	188	45
PCT7316	ED	178	131	0	0	15	116	105	11
PCT7316	TO	832	392	0	0	43	349	293	56
PCT7317	MV	744	350	0	0	25	325	263	62
PCT7317	ED	146	114	0	0	9	105	95	10
PCT7317	TO	890	464	0	0	34	430	358	72
PCT7318	MV	605	293	0	0	24	269	232	37
PCT7318	ED	118	108	0	0	15	93	72	21
PCT7318	TO	723	401	0	0	39	362	304	58
PCT7319	MV	861	345	0	0	27	318	265	53
PCT7319	ED	188	185	0	0	22	163	138	25
PCT7319	TO	1049	530	0	0	49	481	403	78
PCT7321	MV	557	202	0	0	20	182	140	42
PCT7321	ED	102	85	0	0	7	78	64	14
PCT7321	TO	659	287	0	0	27	260	204	56
PCT7322	MV	742	294	0	0	25	269	208	61
PCT7322	ED	146	50	0	0	3	47	44	3
PCT7322	TO	888	344	0	0	28	316	252	64
PCT7323	MV	790	368	0	0	34	334	283	51
PCT7323	ED	166	160	0	0	18	142	118	24
PCT7323	TO	956	528	0	0	52	476	401	75
PCT7324	MV	587	260	0	0	24	236	193	43
PCT7324	ED	150	89	0	0	5	84	69	15
PCT7324	TO	737	349	0	0	29	320	262	58
PCT7325	MV	714	327	0	0	33	294	245	49
PCT7325	ED	172	124	0	0	11	113	95	18
PCT7325	TO	886	451	0	0	44	407	340	67
PCT7326	MV	685	304	0	0	25	279	218	61
PCT7326	ED	174	159	0	0	22	137	121	16
PCT7326	TO	859	463	0	0	47	416	339	77
PCT7327	MV	561	230	0	0	24	206	152	54
PCT7327	ED	126	49	0	0	2	47	41	6
PCT7327	TO	687	279	0	0	26	253	193	60
PCT7328	MV	829	333	0	0	36	297	242	55
PCT7328	ED	173	67	0	0	12	55	48	7
PCT7328	TO	1002	400	0	0	48	352	290	62
PCT7329	MV	556	227	0	0	20	207	171	36
PCT7329	ED	95	78	0	0	6	72	64	8
PCT7329	TO	651	305	0	0	26	279	235	44
PCT7331	MV	710	361	0	0	32	329	277	52
PCT7331	ED	160	162	0	0	20	142	117	25
PCT7331	TO	870	523	0	0	52	471	394	77
PCT7332	MV	654	264	0	0	22	242	214	28
PCT7332	ED	136	149	0	0	9	140	127	13
PCT7332	TO	790	413	0	0	31	382	341	41
PCT7333	MV	822	390	0	0	34	356	295	61
PCT7333	ED	193	224	0	0	20	204	179	25
PCT7333	TO	1015	614	0	0	54	560	474	86
PCT7334	MV	688	307	0	0	17	290	253	37
PCT7334	ED	131	135	0	0	11	124	107	17
PCT7334	TO	819	442	0	0	28	414	360	54
PCT7335	MV	788	389	0	0	34	355	295	60
PCT7335	ED	146	191	0	0	19	172	159	13
PCT7335	TO	934	580	0	0	53	527	454	73
PCT7336	MV	779	405	0	1	24	380	298	82
PCT7336	ED	175	178	0	0	21	157	134	23
PCT7336	TO	954	583	0	1	45	537	432	105
PCT7337	MV	772	386	0	0	31	355	290	65
PCT7337	ED	125	112	0	0	8	104	88	16
PCT7337	TO	897	498	0	0	39	459	378	81
PCT7338	MV	770	360	0	0	28	332	274	58
PCT7338	ED	125	91	0	0	9	82	71	11
PCT7338	TO	895	451	0	0	37	414	345	69
PCT7339	MV	605	270	0	0	19	251	212	39
PCT7339	ED	150	122	0	0	6	116	102	14
PCT7339	TO	755	392	0	0	25	367	314	53
PCT7341	MV	675	291	0	0	29	262	218	44
PCT7341	ED	178	160	0	0	7	153	138	15
PCT7341	TO	853	451	0	0	36	415	356	59
PCT7342	MV	674	324	0	0	20	304	260	44
PCT7342	ED	230	245	0	1	18	226	200	26
PCT7342	TO	904	569	0	1	38	530	460	70
PCT7343	MV	554	252	0	0	19	233	213	20
PCT7343	ED	150	150	0	0	18	132	120	12
PCT7343	TO	704	402	0	0	37	365	333	32
PCT7344	MV	863	392	0	0	28	364	308	56
PCT7344	ED	201	211	0	0	17	194	169	25
PCT7344	TO	1064	603	0	0	45	558	477	81
PCT7345	MV	904	434	0	0	24	410	367	43
PCT7345	ED	210	217	0	0	15	202	182	20
PCT7345	TO	1114	651	0	0	39	612	549	63
PCT7346	MV	681	288	0	1	15	272	239	33
PCT7346	ED	208	174	0	0	21	153	139	14
PCT7346	TO	889	462	0	1	36	425	378	47
PCT7347	MV	833	371	0	1	34	336	313	23
PCT7347	ED	170	123	0	0	10	113	105	8
PCT7347	TO	1003	494	0	1	44	449	418	31
PCT7348	MV	650	279	0	0	20	259	225	34
PCT7348	ED	193	116	0	0	7	109	96	13
PCT7348	TO	843	395	0	0	27	368	321	47
PCT7349	MV	710	316	0	0	22	294	254	40
PCT7349	ED	202	145	0	0	9	136	125	11
PCT7349	TO	912	461	0	0	31	430	379	51
PCT7501	MV	456	248	0	0	24	224	175	49
PCT7501	ED	95	116	0	0	13	103	80	23
PCT7501	TO	551	364	0	0	37	327	255	72
PCT7502	MV	668	315	0	0	24	291	231	60
PCT7502	ED	121	143	0	0	18	125	111	14
PCT7502	TO	789	458	0	0	42	416	342	74
PCT7503	MV	614	286	0	0	24	262	227	35
PCT7503	ED	148	138	0	0	21	117	95	22
PCT7503	TO	762	424	0	0	45	379	322	57
PCT7504	MV	404	175	0	0	15	160	138	22
PCT7504	ED	84	84	0	0	10	74	67	7
PCT7504	TO	488	259	0	0	25	234	205	29
PCT7505	MV	729	405	0	0	33	372	346	26
PCT7505	ED	133	130	0	0	5	125	115	10
PCT7505	TO	862	535	0	0	38	497	461	36
PCT7506	MV	842	364	0	0	34	330	285	45
PCT7506	ED	158	162	0	0	12	150	146	4
PCT7506	TO	1000	526	0	0	46	480	431	49
PCT7507	MV	694	289	0	0	18	271	236	35
PCT7507	ED	262	133	0	0	6	127	110	17
PCT7507	TO	956	422	0	0	24	398	346	52
PCT7508	MV	618	373	0	0	29	344	299	45
PCT7508	ED	126	118	0	0	8	110	96	14
PCT7508	TO	744	491	0	0	37	454	395	59
PCT7509	MV	756	399	0	0	28	371	318	53
PCT7509	ED	173	169	0	0	11	158	139	19
PCT7509	TO	929	568	0	0	39	529	457	72
PCT7512	MV	475	248	0	0	19	229	193	36
PCT7512	ED	125	89	0	0	9	80	72	8
PCT7512	TO	600	337	0	0	28	309	265	44
PCT7513	MV	575	248	0	0	23	225	207	18
PCT7513	ED	231	143	0	0	24	119	109	10
PCT7513	TO	806	391	0	0	47	344	316	28
PCT7514	MV	709	242	0	0	24	218	177	41
PCT7514	ED	207	76	0	0	13	63	56	7
PCT7514	TO	916	318	0	0	37	281	233	48
PCT7515	MV	663	322	0	0	16	306	254	52
PCT7515	ED	201	114	0	0	17	97	87	10
PCT7515	TO	864	436	0	0	33	403	341	62
PCT7516	MV	773	423	0	0	27	396	338	58
PCT7516	ED	147	131	0	0	7	124	102	22
PCT7516	TO	920	554	0	0	34	520	440	80
PCT7517	MV	645	362	0	0	28	334	296	38
PCT7517	ED	223	234	0	0	19	215	192	23
PCT7517	TO	868	596	0	0	47	549	488	61
PCT7518	MV	708	392	0	0	29	363	314	49
PCT7518	ED	218	247	0	0	18	229	213	16
PCT7518	TO	926	639	0	0	47	592	527	65
PCT7519	MV	543	260	0	0	26	234	213	21
PCT7519	ED	172	172	0	0	9	163	147	16
PCT7519	TO	715	432	0	0	35	397	360	37
PCT7521	MV	597	319	0	1	18	300	271	29
PCT7521	ED	182	205	0	0	11	194	176	18
PCT7521	TO	779	524	0	1	29	494	447	47
PCT7522	MV	588	301	0	0	18	283	254	29
PCT7522	ED	171	192	0	0	17	175	159	16
PCT7522	TO	759	493	0	0	35	458	413	45
PCT7523	MV	564	285	0	0	21	264	244	20
PCT7523	ED	180	221	0	0	14	207	190	17
PCT7523	TO	744	506	0	0	35	471	434	37
PCT7524	MV	480	228	0	0	22	206	192	14
PCT7524	ED	144	130	0	0	10	120	113	7
PCT7524	TO	624	358	0	0	32	326	305	21
PCT7525	MV	594	246	0	1	24	221	203	18
PCT7525	ED	170	130	0	0	17	113	110	3
PCT7525	TO	764	376	0	1	41	334	313	21
PCT7526	MV	826	395	0	0	39	356	331	25
PCT7526	ED	162	219	0	0	23	196	182	14
PCT7526	TO	988	614	0	0	62	552	513	39
PCT7527	MV	538	296	0	0	22	274	244	30
PCT7527	ED	172	126	0	0	7	119	109	10
PCT7527	TO	710	422	0	0	29	393	353	40
PCT7529	MV	749	366	0	0	22	344	321	23
PCT7529	ED	154	231	0	0	14	217	199	18
PCT7529	TO	903	597	0	0	36	561	520	41
PCT7531	MV	714	336	0	0	22	314	293	21
PCT7531	ED	159	179	0	0	9	170	150	20
PCT7531	TO	873	515	0	0	31	484	443	41
PCT7532	MV	668	329	0	0	23	306	281	25
PCT7532	ED	167	185	0	0	16	169	142	27
PCT7532	TO	835	514	0	0	39	475	423	52
PCT7533	MV	776	405	0	0	33	372	336	36
PCT7533	ED	194	252	0	0	21	231	213	18
PCT7533	TO	970	657	0	0	54	603	549	54
PCT7534	MV	670	376	0	0	35	341	298	43
PCT7534	ED	233	231	0	0	22	209	193	16
PCT7534	TO	903	607	0	0	57	550	491	59
PCT7535	MV	606	300	0	0	19	281	251	30
PCT7535	ED	139	199	0	0	20	179	165	14
PCT7535	TO	745	499	0	0	39	460	416	44
PCT7536	MV	670	346	0	0	13	333	294	39
PCT7536	ED	163	216	0	1	21	194	168	26
PCT7536	TO	833	562	0	1	34	527	462	65
PCT7537	MV	619	301	0	0	22	279	256	23
PCT7537	ED	126	197	0	0	17	180	166	14
PCT7537	TO	745	498	0	0	39	459	422	37
PCT7538	MV	562	322	0	0	19	303	283	20
PCT7538	ED	189	212	0	0	15	197	174	23
PCT7538	TO	751	534	0	0	34	500	457	43
PCT7539	MV	696	374	0	0	19	355	332	23
PCT7539	ED	225	215	0	0	17	198	183	15
PCT7539	TO	921	589	0	0	36	553	515	38
PCT7541	MV	600	295	0	0	24	271	244	27
PCT7541	ED	170	214	0	0	22	192	171	21
PCT7541	TO	770	509	0	0	46	463	415	48
PCT7542	MV	632	324	0	0	13	311	277	34
PCT7542	ED	192	200	0	0	11	189	170	19
PCT7542	TO	824	524	0	0	24	500	447	53
PCT7543	MV	694	371	0	0	14	357	319	38
PCT7543	ED	230	173	0	0	17	156	138	18
PCT7543	TO	924	544	0	0	31	513	457	56
PCT7544	MV	731	389	0	0	36	353	320	33
PCT7544	ED	168	207	0	0	17	190	175	15
PCT7544	TO	899	596	0	0	53	543	495	48
PCT7545	MV	723	385	0	0	24	361	325	36
PCT7545	ED	172	192	0	2	18	172	159	13
PCT7545	TO	895	577	0	2	42	533	484	49
PCT7546	MV	770	418	0	0	22	396	366	30
PCT7546	ED	183	255	0	0	24	231	205	26
PCT7546	TO	953	673	0	0	46	627	571	56
PCT7547	MV	798	427	0	0	31	396	371	25
PCT7547	ED	183	227	0	0	16	211	203	8
PCT7547	TO	981	654	0	0	47	607	574	33
PCT7548	MV	802	450	0	0	28	422	380	42
PCT7548	ED	249	259	0	0	21	238	219	19
PCT7548	TO	1051	709	0	0	49	660	599	61
PCT7549	MV	660	358	0	0	26	332	296	36
PCT7549	ED	146	170	0	0	18	152	139	13
PCT7549	TO	806	528	0	0	44	484	435	49
PCT7551	MV	587	304	0	0	15	289	265	24
PCT7551	ED	136	178	0	0	10	168	152	16
PCT7551	TO	723	482	0	0	25	457	417	40
PCT7552	MV	561	285	0	0	22	263	242	21
PCT7552	ED	124	168	0	0	22	146	125	21
PCT7552	TO	685	453	0	0	44	409	367	42
PCT7553	MV	211	95	0	1	5	89	78	11
PCT7553	ED	-20	7	0	0	1	6	5	1
PCT7553	TO	191	102	0	1	6	95	83	12
PCT7554	MV	653	381	0	0	25	356	318	38
PCT7554	ED	168	216	0	0	19	197	179	18
PCT7554	TO	821	597	0	0	44	553	497	56
PCT7555	MV	662	416	0	0	30	386	341	45
PCT7555	ED	210	244	0	0	23	221	200	21
PCT7555	TO	872	660	0	0	53	607	541	66
PCT7556	MV	812	513	0	0	30	483	433	50
PCT7556	ED	154	214	0	0	21	193	165	28
PCT7556	TO	966	727	0	0	51	676	598	78
PCT7601	MV	485	207	0	0	14	193	177	16
PCT7601	ED	192	112	0	1	11	100	87	13
PCT7601	TO	677	319	0	1	25	293	264	29
PCT7602	MV	654	276	0	0	13	263	238	25
PCT7602	ED	232	128	0	0	13	115	105	10
PCT7602	TO	886	404	0	0	26	378	343	35
PCT7603	MV	615	295	0	0	23	272	240	32
PCT7603	ED	200	174	0	0	14	160	141	19
PCT7603	TO	815	469	0	0	37	432	381	51
PCT7604	MV	685	270	0	0	11	259	235	24
PCT7604	ED	259	164	0	0	23	141	122	19
PCT7604	TO	944	434	0	0	34	400	357	43
PCT7605	MV	468	192	0	1	15	176	150	26
PCT7605	ED	193	84	0	0	8	76	70	6
PCT7605	TO	661	276	0	1	23	252	220	32
PCT7606	MV	673	267	0	0	27	240	209	31
PCT7606	ED	210	99	0	0	8	91	81	10
PCT7606	TO	883	366	0	0	35	331	290	41
PCT7607	MV	712	288	0	0	21	267	231	36
PCT7607	ED	207	127	0	0	6	121	108	13
PCT7607	TO	919	415	0	0	27	388	339	49
PCT7608	MV	279	96	0	0	6	90	74	16
PCT7608	ED	101	26	0	0	0	26	23	3
PCT7608	TO	380	122	0	0	6	116	97	19
PCT7609	MV	699	286	0	0	21	265	238	27
PCT7609	ED	185	69	0	1	8	60	51	9
PCT7609	TO	884	355	0	1	29	325	289	36
PCT7611	MV	586	235	0	0	18	217	193	24
PCT7611	ED	202	47	0	0	5	42	38	4
PCT7611	TO	788	282	0	0	23	259	231	28
PCT7612	MV	452	216	0	0	11	205	174	31
PCT7612	ED	105	47	0	0	4	43	33	10
PCT7612	TO	557	263	0	0	15	248	207	41
PCT7613	MV	634	244	0	0	19	225	202	23
PCT7613	ED	249	107	0	0	8	99	92	7
PCT7613	TO	883	351	0	0	27	324	294	30
PCT7614	MV	713	254	0	0	24	230	203	27
PCT7614	ED	203	114	0	0	7	107	91	16
PCT7614	TO	916	368	0	0	31	337	294	43
PCT7615	MV	510	165	0	0	7	158	134	24
PCT7615	ED	240	81	0	0	9	72	63	9
PCT7615	TO	750	246	0	0	16	230	197	33
PCT7616	MV	754	330	0	0	36	294	265	29
PCT7616	ED	82	144	0	0	14	130	116	14
PCT7616	TO	836	474	0	0	50	424	381	43
PCT7617	MV	583	222	0	0	21	201	178	23
PCT7617	ED	169	67	0	0	11	56	45	11
PCT7617	TO	752	289	0	0	32	257	223	34
PCT7618	MV	763	365	0	0	20	345	283	62
PCT7618	ED	151	114	0	0	13	101	89	12
PCT7618	TO	914	479	0	0	33	446	372	74
PCT7619	MV	937	439	0	0	28	411	361	50
PCT7619	ED	170	169	0	0	16	153	135	18
PCT7619	TO	1107	608	0	0	44	564	496	68
PCT7621	MV	1006	443	0	0	29	414	374	40
PCT7621	ED	149	150	0	0	18	132	115	17
PCT7621	TO	1155	593	0	0	47	546	489	57
PCT7622	MV	697	215	0	0	9	206	180	26
PCT7622	ED	263	98	0	0	11	87	81	6
PCT7622	TO	960	313	0	0	20	293	261	32
PCT7623	MV	767	256	0	2	17	237	216	21
PCT7623	ED	237	143	0	0	13	130	118	12
PCT7623	TO	1004	399	0	2	30	367	334	33
PCT7624	MV	652	209	0	0	12	197	178	19
PCT7624	ED	223	97	0	0	16	81	80	1
PCT7624	TO	875	306	0	0	28	278	258	20
PCT7625	MV	749	394	0	2	40	352	299	53
PCT7625	ED	73	39	0	0	1	38	36	2
PCT7625	TO	822	433	0	2	41	390	335	55
PCT7626	MV	944	401	0	0	42	359	309	50
PCT7626	ED	129	134	0	0	9	125	117	8
PCT7626	TO	1073	535	0	0	51	484	426	58
PCT7627	MV	457	196	0	0	18	178	140	38
PCT7627	ED	67	65	0	0	7	58	45	13
PCT7627	TO	524	261	0	0	25	236	185	51
PCT7628	MV	718	332	0	0	16	316	280	36
PCT7628	ED	220	156	0	0	7	149	129	20
PCT7628	TO	938	488	0	0	23	465	409	56
PCT7629	MV	691	276	0	0	22	254	227	27
PCT7629	ED	162	131	0	0	9	122	109	13
PCT7629	TO	853	407	0	0	31	376	336	40
PCT7631	MV	1009	441	0	0	32	409	359	50
PCT7631	ED	210	159	0	0	18	141	123	18
PCT7631	TO	1219	600	0	0	50	550	482	68
PCT7632	MV	1002	414	0	0	20	394	346	48
PCT7632	ED	169	188	0	0	15	173	156	17
PCT7632	TO	1171	602	0	0	35	567	502	65
PCT7633	MV	609	278	0	0	19	259	222	37
PCT7633	ED	126	108	0	0	8	100	91	9
PCT7633	TO	735	386	0	0	27	359	313	46
PCT7634	MV	704	344	0	0	36	308	267	41
PCT7634	ED	186	143	0	0	18	125	108	17
PCT7634	TO	890	487	0	0	54	433	375	58
PCT7635	MV	665	274	0	0	14	260	218	42
PCT7635	ED	188	83	0	0	7	76	67	9
PCT7635	TO	853	357	0	0	21	336	285	51
PCT7636	MV	798	330	0	0	24	306	260	46
PCT7636	ED	161	155	0	0	15	140	115	25
PCT7636	TO	959	485	0	0	39	446	375	71
PCT7637	MV	747	344	0	0	30	314	244	70
PCT7637	ED	121	145	0	0	22	123	106	17
PCT7637	TO	868	489	0	0	52	437	350	87
PCT7638	MV	806	372	0	0	24	348	275	73
PCT7638	ED	83	132	0	0	12	120	88	32
PCT7638	TO	889	504	0	0	36	468	363	105
PCT7639	MV	889	396	0	0	33	363	288	75
PCT7639	ED	133	154	0	0	26	128	110	18
PCT7639	TO	1022	550	0	0	59	491	398	93
PCT7641	MV	817	400	0	0	17	383	305	78
PCT7641	ED	134	141	0	0	9	132	113	19
PCT7641	TO	951	541	0	0	26	515	418	97
PCT7642	MV	647	311	0	0	35	276	248	28
PCT7642	ED	118	129	0	0	21	108	97	11
PCT7642	TO	765	440	0	0	56	384	345	39
PCT7643	MV	810	433	0	1	27	405	331	74
PCT7643	ED	131	115	0	0	13	102	91	11
PCT7643	TO	941	548	0	1	40	507	422	85
PCT7644	MV	1014	404	0	0	35	369	312	57
PCT7644	ED	162	186	0	0	16	170	153	17
PCT7644	TO	1176	590	0	0	51	539	465	74
PCT7645	MV	595	286	0	1	20	265	213	52
PCT7645	ED	61	96	0	0	11	85	69	16
PCT7645	TO	656	382	0	1	31	350	282	68
PCT7646	MV	1032	485	0	0	36	449	382	67
PCT7646	ED	121	179	0	0	24	155	138	17
PCT7646	TO	1153	664	0	0	60	604	520	84
PCT7647	MV	724	211	0	0	10	201	171	30
PCT7647	ED	263	117	0	0	8	109	98	11
PCT7647	TO	987	328	0	0	18	310	269	41
PCT7648	MV	2	1	0	0	0	1	1	0
PCT7648	TO	2	1	0	0	0	1	1	0
PCT7649	MV	723	286	0	0	12	274	233	41
PCT7649	ED	177	108	0	0	9	99	85	14
PCT7649	TO	900	394	0	0	21	373	318	55
PCT7651	MV	834	332	0	0	23	309	261	48
PCT7651	ED	113	110	0	0	10	100	83	17
PCT7651	TO	947	442	0	0	33	409	344	65
PCT7652	MV	535	208	0	0	15	193	161	32
PCT7652	ED	100	98	0	0	6	92	79	13
PCT7652	TO	635	306	0	0	21	285	240	45
PCT7653	MV	750	335	0	0	34	301	267	34
PCT7653	ED	89	95	0	0	10	85	71	14
PCT7653	TO	839	430	0	0	44	386	338	48
PCT7654	MV	413	191	0	0	11	180	150	30
PCT7654	ED	53	91	0	0	7	84	75	9
PCT7654	TO	466	282	0	0	18	264	225	39
PCT7655	MV	583	215	0	0	8	207	179	28
PCT7655	ED	96	84	0	0	14	70	59	11
PCT7655	TO	679	299	0	0	22	277	238	39
PCT7656	MV	603	308	0	0	23	285	241	44
PCT7656	ED	35	67	0	0	11	56	38	18
PCT7656	TO	638	375	0	0	34	341	279	62
PCT7657	MV	561	269	0	0	22	247	208	39
PCT7657	ED	37	89	0	0	12	77	69	8
PCT7657	TO	598	358	0	0	34	324	277	47
PCT7701	MV	868	481	0	0	37	444	382	62
PCT7701	ED	196	175	0	0	8	167	147	20
PCT7701	TO	1064	656	0	0	45	611	529	82
PCT7702	MV	623	377	0	0	18	359	278	81
PCT7702	ED	133	107	0	0	10	97	77	20
PCT7702	TO	756	484	0	0	28	456	355	101
PCT7703	MV	187	71	0	0	2	69	65	4
PCT7703	ED	-13	0	0	0	0	0	0	0
PCT7703	TO	174	71	0	0	2	69	65	4
PCT7704	MV	798	490	0	0	36	454	340	114
PCT7704	ED	204	175	0	0	3	172	126	46
PCT7704	TO	1002	665	0	0	39	626	466	160
PCT7705	MV	470	285	0	0	15	270	203	67
PCT7705	ED	125	110	0	0	9	101	80	21
PCT7705	TO	595	395	0	0	24	371	283	88
PCT7706	MV	687	447	0	0	24	423	324	99
PCT7706	ED	179	163	0	0	8	155	121	34
PCT7706	TO	866	610	0	0	32	578	445	133
PCT7707	MV	683	432	0	0	23	409	333	76
PCT7707	ED	189	179	0	0	7	172	128	44
PCT7707	TO	872	611	0	0	30	581	461	120
PCT7708	MV	710	462	0	0	34	428	334	94
PCT7708	ED	165	154	0	0	13	141	116	25
PCT7708	TO	875	616	0	0	47	569	450	119
PCT7709	MV	324	194	0	0	9	185	154	31
PCT7709	ED	82	90	0	0	7	83	71	12
PCT7709	TO	406	284	0	0	16	268	225	43
PCT7711	MV	658	379	0	0	21	358	291	67
PCT7711	ED	153	126	0	0	4	122	107	15
PCT7711	TO	811	505	0	0	25	480	398	82
PCT7712	MV	425	258	0	0	11	247	202	45
PCT7712	ED	107	109	0	0	8	101	84	17
PCT7712	TO	532	367	0	0	19	348	286	62
PCT7801	MV	823	479	0	0	23	456	379	77
PCT7801	ED	151	196	0	0	12	184	144	40
PCT7801	TO	974	675	0	0	35	640	523	117
PCT7802	MV	646	402	0	0	27	375	331	44
PCT7802	ED	152	160	0	1	7	152	139	13
PCT7802	TO	798	562	0	1	34	527	470	57
PCT7803	MV	718	476	0	0	28	448	384	64
PCT7803	ED	113	129	0	0	10	119	100	19
PCT7803	TO	831	605	0	0	38	567	484	83
PCT7804	MV	734	463	0	0	46	417	376	41
PCT7804	ED	151	182	0	0	18	164	148	16
PCT7804	TO	885	645	0	0	64	581	524	57
PCT7805	MV	644	400	0	0	38	362	313	49
PCT7805	ED	156	157	0	0	12	145	134	11
PCT7805	TO	800	557	0	0	50	507	447	60
PCT7806	MV	602	361	0	0	23	338	307	31
PCT7806	ED	153	154	0	0	11	143	124	19
PCT7806	TO	755	515	0	0	34	481	431	50
PCT7807	MV	642	363	0	1	17	345	321	24
PCT7807	ED	185	176	0	0	12	164	153	11
PCT7807	TO	827	539	0	1	29	509	474	35
PCT7808	MV	525	296	0	0	21	275	243	32
PCT7808	ED	129	132	0	0	12	120	109	11
PCT7808	TO	654	428	0	0	33	395	352	43
PCT7809	MV	624	351	0	0	22	329	302	27
PCT7809	ED	140	137	0	0	13	124	120	4
PCT7809	TO	764	488	0	0	35	453	422	31
PCT7811	MV	582	311	0	0	23	288	266	22
PCT7811	ED	176	157	0	0	10	147	132	15
PCT7811	TO	758	468	0	0	33	435	398	37
PCT7812	MV	680	369	0	0	23	346	315	31
PCT7812	ED	217	168	0	0	5	163	142	21
PCT7812	TO	897	537	0	0	28	509	457	52
PCT7813	MV	843	483	0	0	21	462	418	44
PCT7813	ED	225	217	0	0	16	201	178	23
PCT7813	TO	1068	700	0	0	37	663	596	67
PCT7814	MV	660	281	0	0	15	266	234	32
PCT7814	ED	241	120	0	0	9	111	102	9
PCT7814	TO	901	401	0	0	24	377	336	41
PCT7815	MV	749	465	0	0	48	417	369	48
PCT7815	ED	168	181	0	0	11	170	156	14
PCT7815	TO	917	646	0	0	59	587	525	62
PCT7816	MV	724	472	0	0	36	436	381	55
PCT7816	ED	148	151	0	0	7	144	122	22
PCT7816	TO	872	623	0	0	43	580	503	77
PCT7817	MV	652	396	0	0	10	386	353	33
PCT7817	ED	186	185	0	1	7	177	157	20
PCT7817	TO	838	581	0	1	17	563	510	53
PCT7818	MV	668	393	0	0	25	368	328	40
PCT7818	ED	171	150	0	0	7	143	134	9
PCT7818	TO	839	543	0	0	32	511	462	49
PCT7819	MV	635	352	0	0	22	330	280	50
PCT7819	ED	139	91	0	0	5	86	80	6
PCT7819	TO	774	443	0	0	27	416	360	56
PCT7821	MV	806	519	0	0	26	493	432	61
PCT7821	ED	170	190	0	0	10	180	162	18
PCT7821	TO	976	709	0	0	36	673	594	79
PCT7822	MV	673	395	0	1	25	369	324	45
PCT7822	ED	219	224	0	0	21	203	168	35
PCT7822	TO	892	619	0	1	46	572	492	80
PCT7823	MV	706	410	0	0	26	384	339	45
PCT7823	ED	177	189	0	0	4	185	168	17
PCT7823	TO	883	599	0	0	30	569	507	62
PCT7824	MV	615	335	0	0	24	311	277	34
PCT7824	ED	153	158	0	0	13	145	133	12
PCT7824	TO	768	493	0	0	37	456	410	46
PCT7825	MV	457	252	0	0	13	239	228	11
PCT7825	ED	151	132	0	0	3	129	113	16
PCT7825	TO	608	384	0	0	16	368	341	27
PCT7826	MV	486	263	0	1	17	245	222	23
PCT7826	ED	204	163	0	0	11	152	140	12
PCT7826	TO	690	426	0	1	28	397	362	35
PCT7827	MV	607	318	0	0	19	299	264	35
PCT7827	ED	219	147	0	0	13	134	124	10
PCT7827	TO	826	465	0	0	32	433	388	45
PCT7828	MV	857	478	0	0	34	444	370	74
PCT7828	ED	171	183	0	0	19	164	140	24
PCT7828	TO	1028	661	0	0	53	608	510	98
PCT7829	MV	742	466	0	0	24	442	371	71
PCT7829	ED	149	151	0	0	4	147	132	15
PCT7829	TO	891	617	0	0	28	589	503	86
PCT7831	MV	763	485	0	0	41	444	384	60
PCT7831	ED	139	139	0	0	7	132	113	19
PCT7831	TO	902	624	0	0	48	576	497	79
PCT7832	MV	663	413	0	0	27	386	344	42
PCT7832	ED	118	128	0	0	7	121	107	14
PCT7832	TO	781	541	0	0	34	507	451	56
PCT7833	MV	587	343	0	0	18	325	293	32
PCT7833	ED	146	146	0	0	16	130	116	14
PCT7833	TO	733	489	0	0	34	455	409	46
PCT7834	MV	700	375	0	0	29	346	321	25
PCT7834	ED	194	179	0	0	12	167	152	15
PCT7834	TO	894	554	0	0	41	513	473	40
PCT7835	MV	721	428	0	0	27	401	327	74
PCT7835	ED	142	148	0	0	10	138	118	20
PCT7835	TO	863	576	0	0	37	539	445	94
PCT7836	MV	850	505	0	0	24	481	413	68
PCT7836	ED	193	171	0	0	7	164	134	30
PCT7836	TO	1043	676	0	0	31	645	547	98
PCT7837	MV	718	424	0	0	40	384	322	62
PCT7837	ED	205	202	0	0	8	194	171	23
PCT7837	TO	923	626	0	0	48	578	493	85
PCT7838	MV	752	493	0	0	34	459	383	76
PCT7838	ED	143	158	0	0	10	148	126	22
PCT7838	TO	895	651	0	0	44	607	509	98
PCT7839	MV	731	456	0	0	32	424	359	65
PCT7839	ED	130	140	0	0	9	131	115	16
PCT7839	TO	861	596	0	0	41	555	474	81
PCT7841	MV	752	458	0	0	31	427	372	55
PCT7841	ED	198	207	0	0	9	198	176	22
PCT7841	TO	950	665	0	0	40	625	548	77
PCT7842	MV	702	394	0	0	24	370	329	41
PCT7842	ED	177	155	0	0	9	146	131	15
PCT7842	TO	879	549	0	0	33	516	460	56
PCT7843	MV	546	295	0	0	13	282	249	33
PCT7843	ED	183	165	0	0	11	154	137	17
PCT7843	TO	729	460	0	0	24	436	386	50
PCT7844	MV	499	281	0	0	25	256	237	19
PCT7844	ED	152	137	0	0	11	126	112	14
PCT7844	TO	651	418	0	0	36	382	349	33
PCT7845	MV	676	405	0	0	24	381	348	33
PCT7845	ED	204	178	0	0	10	168	141	27
PCT7845	TO	880	583	0	0	34	549	489	60
PCT7846	MV	736	464	0	0	36	428	368	60
PCT7846	ED	172	171	0	0	16	155	131	24
PCT7846	TO	908	635	0	0	52	583	499	84
PCT7847	MV	698	429	0	0	31	398	348	50
PCT7847	ED	193	183	0	0	7	176	148	28
PCT7847	TO	891	612	0	0	38	574	496	78
PCT7848	MV	665	437	0	0	23	414	353	61
PCT7848	ED	182	169	0	0	17	152	130	22
PCT7848	TO	847	606	0	0	40	566	483	83
PCT7849	MV	729	443	0	0	32	411	356	55
PCT7849	ED	172	188	0	0	12	176	160	16
PCT7849	TO	901	631	0	0	44	587	516	71
PCT7851	MV	414	272	0	0	21	251	195	56
PCT7851	ED	112	85	0	0	7	78	58	20
PCT7851	TO	526	357	0	0	28	329	253	76
PCT7852	MV	533	350	0	0	25	325	264	61
PCT7852	ED	111	103	0	0	7	96	80	16
PCT7852	TO	644	453	0	0	32	421	344	77
PCT7853	MV	694	394	0	0	27	367	305	62
PCT7853	ED	161	139	0	0	10	129	109	20
PCT7853	TO	855	533	0	0	37	496	414	82
PCT7854	MV	703	430	0	0	26	404	348	56
PCT7854	ED	175	173	0	0	11	162	142	20
PCT7854	TO	878	603	0	0	37	566	490	76
PCT7855	MV	763	451	0	0	35	416	364	52
PCT7855	ED	211	204	0	0	17	187	168	19
PCT7855	TO	974	655	0	0	52	603	532	71
PCT7856	MV	643	376	0	0	22	354	310	44
PCT7856	ED	204	193	0	0	12	181	156	25
PCT7856	TO	847	569	0	0	34	535	466	69
PCT7857	MV	748	437	0	0	33	404	350	54
PCT7857	ED	158	156	0	0	8	148	138	10
PCT7857	TO	906	593	0	0	41	552	488	64
PCT7858	MV	622	349	0	0	20	329	295	34
PCT7858	ED	157	151	0	0	8	143	124	19
PCT7858	TO	779	500	0	0	28	472	419	53
PCT7859	MV	747	464	0	0	32	432	355	77
PCT7859	ED	152	167	0	0	19	148	119	29
PCT7859	TO	899	631	0	0	51	580	474	106
PCT7861	MV	699	432	0	0	24	408	338	70
PCT7861	ED	164	171	0	0	8	163	143	20
PCT7861	TO	863	603	0	0	32	571	481	90
PCT7862	MV	669	401	0	0	21	380	337	43
PCT7862	ED	195	198	0	0	10	188	171	17
PCT7862	TO	864	599	0	0	31	568	508	60
PCT7863	MV	693	373	0	0	24	349	305	44
PCT7863	ED	208	208	0	0	11	197	167	30
PCT7863	TO	901	581	0	0	35	546	472	74
PCT7864	MV	661	374	0	0	30	344	285	59
PCT7864	ED	153	157	0	0	13	144	120	24
PCT7864	TO	814	531	0	0	43	488	405	83
PCT7865	MV	677	408	0	0	32	376	317	59
PCT7865	ED	163	160	0	0	10	150	123	27
PCT7865	TO	840	568	0	0	42	526	440	86
PCT7866	MV	690	446	0	0	16	430	329	101
PCT7866	ED	158	143	0	0	9	134	104	30
PCT7866	TO	848	589	0	0	25	564	433	131
PCT7867	MV	766	470	0	0	21	449	385	64
PCT7867	ED	212	184	0	0	12	172	145	27
PCT7867	TO	978	654	0	0	33	621	530	91
PCT7868	MV	659	376	0	0	17	359	307	52
PCT7868	ED	217	162	0	0	11	151	129	22
PCT7868	TO	876	538	0	0	28	510	436	74
PCT7869	MV	683	441	0	0	26	415	362	53
PCT7869	ED	178	191	0	0	12	179	160	19
PCT7869	TO	861	632	0	0	38	594	522	72
PCT7871	MV	702	464	0	0	37	427	374	53
PCT7871	ED	200	157	0	1	10	146	117	29
PCT7871	TO	902	621	0	1	47	573	491	82
PCT7872	MV	675	420	0	0	26	394	338	56
PCT7872	ED	199	186	0	0	8	178	150	28
PCT7872	TO	874	606	0	0	34	572	488	84
PCT7873	MV	689	444	0	0	29	415	366	49
PCT7873	ED	202	214	0	0	15	199	172	27
PCT7873	TO	891	658	0	0	44	614	538	76
PCT7874	MV	370	191	0	0	8	183	151	32
PCT7874	ED	119	108	0	0	5	103	86	17
PCT7874	TO	489	299	0	0	13	286	237	49
PCT7875	MV	500	253	0	0	16	237	194	43
PCT7875	ED	147	115	0	0	5	110	94	16
PCT7875	TO	647	368	0	0	21	347	288	59
PCT7876	MV	462	257	0	0	18	239	220	19
PCT7876	ED	106	93	0	0	11	82	76	6
PCT7876	TO	568	350	0	0	29	321	296	25
PCT7901	MV	399	191	0	0	9	182	167	15
PCT7901	ED	150	67	0	0	2	65	58	7
PCT7901	TO	549	258	0	0	11	247	225	22
PCT7902	MV	680	290	0	0	14	276	243	33
PCT7902	ED	232	145	0	0	7	138	125	13
PCT7902	TO	912	435	0	0	21	414	368	46
PCT7903	MV	623	286	0	0	21	265	245	20
PCT7903	ED	229	125	0	0	9	116	108	8
PCT7903	TO	852	411	0	0	30	381	353	28
PCT7904	MV	680	299	0	0	20	279	244	35
PCT7904	ED	157	122	0	0	9	113	102	11
PCT7904	TO	837	421	0	0	29	392	346	46
PCT7905	MV	684	356	0	0	19	337	301	36
PCT7905	ED	191	183	0	0	8	175	162	13
PCT7905	TO	875	539	0	0	27	512	463	49
PCT7906	MV	599	283	0	0	17	266	239	27
PCT7906	ED	187	118	0	0	13	105	97	8
PCT7906	TO	786	401	0	0	30	371	336	35
PCT7907	MV	704	344	0	0	18	326	295	31
PCT7907	ED	238	165	0	0	16	149	132	17
PCT7907	TO	942	509	0	0	34	475	427	48
PCT7908	MV	752	366	0	1	21	344	319	25
PCT7908	ED	240	172	0	0	14	158	153	5
PCT7908	TO	992	538	0	1	35	502	472	30
PCT7909	MV	558	311	0	0	18	293	267	26
PCT7909	ED	185	141	0	0	6	135	127	8
PCT7909	TO	743	452	0	0	24	428	394	34
PCT7911	MV	666	322	0	0	22	300	260	40
PCT7911	ED	205	129	0	0	6	123	109	14
PCT7911	TO	871	451	0	0	28	423	369	54
PCT7912	MV	800	370	0	0	22	348	331	17
PCT7912	ED	259	182	0	0	19	163	155	8
PCT7912	TO	1059	552	0	0	41	511	486	25
PCT7913	MV	660	350	0	0	11	339	288	51
PCT7913	ED	263	216	0	0	6	210	189	21
PCT7913	TO	923	566	0	0	17	549	477	72
PCT7914	MV	715	390	0	0	26	364	319	45
PCT7914	ED	187	142	0	0	13	129	109	20
PCT7914	TO	902	532	0	0	39	493	428	65
PCT7915	MV	605	290	0	0	22	268	236	32
PCT7915	ED	238	183	0	0	3	180	163	17
PCT7915	TO	843	473	0	0	25	448	399	49
PCT7916	MV	639	335	0	0	19	316	283	33
PCT7916	ED	219	162	0	0	12	150	142	8
PCT7916	TO	858	497	0	0	31	466	425	41
PCT7917	MV	716	357	0	0	21	336	304	32
PCT7917	ED	271	187	0	0	6	181	170	11
PCT7917	TO	987	544	0	0	27	517	474	43
PCT7918	MV	597	297	0	0	14	283	268	15
PCT7918	ED	227	145	0	0	6	139	125	14
PCT7918	TO	824	442	0	0	20	422	393	29
PCT7919	MV	608	309	0	0	16	293	268	25
PCT7919	ED	258	177	0	0	8	169	159	10
PCT7919	TO	866	486	0	0	24	462	427	35
PCT7921	MV	682	310	0	0	16	294	261	33
PCT7921	ED	229	103	0	0	6	97	86	11
PCT7921	TO	911	413	0	0	22	391	347	44
PCT7922	MV	648	314	0	0	10	304	273	31
PCT7922	ED	210	157	0	0	11	146	134	12
PCT7922	TO	858	471	0	0	21	450	407	43
PCT7923	MV	666	337	0	0	15	322	266	56
PCT7923	ED	214	172	0	0	10	162	144	18
PCT7923	TO	880	509	0	0	25	484	410	74
PCT7924	MV	649	303	0	0	10	293	258	35
PCT7924	ED	202	126	0	0	8	118	106	12
PCT7924	TO	851	429	0	0	18	411	364	47
PCT7925	MV	434	225	0	0	15	210	181	29
PCT7925	ED	110	89	0	0	6	83	75	8
PCT7925	TO	544	314	0	0	21	293	256	37
PCT7926	MV	610	337	0	0	21	316	279	37
PCT7926	ED	178	150	0	0	6	144	123	21
PCT7926	TO	788	487	0	0	27	460	402	58
PCT7927	MV	580	335	0	0	28	307	273	34
PCT7927	ED	162	154	0	0	5	149	133	16
PCT7927	TO	742	489	0	0	33	456	406	50
PCT7928	MV	700	395	0	0	21	374	332	42
PCT7928	ED	217	208	0	0	7	201	181	20
PCT7928	TO	917	603	0	0	28	575	513	62
PCT7929	MV	678	424	0	0	23	401	352	49
PCT7929	ED	169	172	0	0	7	165	148	17
PCT7929	TO	847	596	0	0	30	566	500	66
PCT7931	MV	610	378	0	0	30	348	300	48
PCT7931	ED	141	150	0	0	7	143	126	17
PCT7931	TO	751	528	0	0	37	491	426	65
PCT7932	MV	443	277	0	0	16	261	216	45
PCT7932	ED	118	96	0	0	8	88	77	11
PCT7932	TO	561	373	0	0	24	349	293	56
PCT7933	MV	9	6	0	0	0	6	4	2
PCT7933	ED	-1	0	0	0	0	0	0	0
PCT7933	TO	8	6	0	0	0	6	4	2
PCT7934	MV	702	409	0	0	28	381	350	31
PCT7934	ED	182	156	0	0	17	139	125	14
PCT7934	TO	884	565	0	0	45	520	475	45
PCT7935	MV	716	436	0	0	28	408	359	49
PCT7935	ED	227	227	0	0	13	214	197	17
PCT7935	TO	943	663	0	0	41	622	556	66
PCT7936	MV	620	370	0	0	24	346	305	41
PCT7936	ED	236	221	0	1	10	210	188	22
PCT7936	TO	856	591	0	1	34	556	493	63
PCT7937	MV	698	406	0	0	25	381	341	40
PCT7937	ED	202	172	0	0	7	165	146	19
PCT7937	TO	900	578	0	0	32	546	487	59
PCT7938	MV	536	301	0	0	13	288	253	35
PCT7938	ED	215	121	0	0	7	114	99	15
PCT7938	TO	751	422	0	0	20	402	352	50
PCT7939	MV	481	289	0	0	15	274	247	27
PCT7939	ED	205	191	0	0	11	180	163	17
PCT7939	TO	686	480	0	0	26	454	410	44
PCT7941	MV	576	304	0	0	24	280	243	37
PCT7941	ED	196	173	0	0	9	164	141	23
PCT7941	TO	772	477	0	0	33	444	384	60
PCT7942	MV	658	333	0	0	16	317	273	44
PCT7942	ED	274	141	0	0	4	137	121	16
PCT7942	TO	932	474	0	0	20	454	394	60
PCT7943	MV	687	368	0	0	16	352	288	64
PCT7943	ED	213	158	0	0	12	146	119	27
PCT7943	TO	900	526	0	0	28	498	407	91
PCT7944	MV	584	342	0	0	23	319	279	40
PCT7944	ED	230	197	0	0	12	185	156	29
PCT7944	TO	814	539	0	0	35	504	435	69
PCT7945	MV	726	338	0	0	25	313	272	41
PCT7945	ED	228	85	0	0	8	77	70	7
PCT7945	TO	954	423	0	0	33	390	342	48
PCT7946	MV	779	366	0	0	18	348	236	112
PCT7946	ED	206	115	0	0	7	108	83	25
PCT7946	TO	985	481	0	0	25	456	319	137
PCT7947	MV	792	332	0	0	26	306	196	110
PCT7947	ED	194	95	0	0	4	91	66	25
PCT7947	TO	986	427	0	0	30	397	262	135
PCT7948	MV	730	373	0	0	26	347	231	116
PCT7948	ED	200	119	0	0	4	115	89	26
PCT7948	TO	930	492	0	0	30	462	320	142
PCT7949	MV	484	233	0	0	12	221	138	83
PCT7949	ED	106	57	0	0	6	51	36	15
PCT7949	TO	590	290	0	0	18	272	174	98
PCT7951	MV	731	366	0	0	27	339	218	121
PCT7951	ED	156	90	0	0	4	86	66	20
PCT7951	TO	887	456	0	0	31	425	284	141
PCT7952	MV	730	292	0	0	19	273	169	104
PCT7952	ED	182	86	0	0	7	79	57	22
PCT7952	TO	912	378	0	0	26	352	226	126
PCT7953	MV	669	331	0	0	18	313	218	95
PCT7953	ED	161	106	0	0	4	102	65	37
PCT7953	TO	830	437	0	0	22	415	283	132
PCT7955	MV	774	350	0	0	15	335	227	108
PCT7955	ED	173	101	0	0	11	90	63	27
PCT7955	TO	947	451	0	0	26	425	290	135
PCT7956	MV	699	267	0	0	11	256	170	86
PCT7956	ED	170	42	0	0	2	40	34	6
PCT7956	TO	869	309	0	0	13	296	204	92
PCT7957	MV	538	261	0	0	13	248	191	57
PCT7957	ED	135	85	0	0	6	79	67	12
PCT7957	TO	673	346	0	0	19	327	258	69
PCT7958	MV	320	104	0	0	6	98	75	23
PCT7958	ED	-23	0	0	0	0	0	0	0
PCT7958	TO	297	104	0	0	6	98	75	23
PCT7959	MV	541	230	0	0	18	212	195	17
PCT7959	ED	145	68	0	0	6	62	57	5
PCT7959	TO	686	298	0	0	24	274	252	22
PCT9001	MV	314	100	0	0	3	97	85	12
PCT9001	ED	-30	0	0	0	0	0	0	0
PCT9001	TO	284	100	0	0	3	97	85	12
PCT9101	MV	712	378	0	0	23	355	276	79
PCT9101	ED	201	195	0	0	11	184	153	31
PCT9101	TO	913	573	0	0	34	539	429	110
PCT9102	MV	788	393	0	0	25	368	302	66
PCT9102	ED	204	175	0	1	8	166	138	28
PCT9102	TO	992	568	0	1	33	534	440	94
PCT9103	MV	719	381	0	0	24	357	287	70
PCT9103	ED	238	194	0	0	14	180	140	40
PCT9103	TO	957	575	0	0	38	537	427	110
PCT9104	MV	810	382	0	0	32	350	279	71
PCT9104	ED	220	181	0	0	10	171	142	29
PCT9104	TO	1030	563	0	0	42	521	421	100
PCT9105	MV	719	413	0	0	20	393	318	75
PCT9105	ED	199	223	0	0	17	206	169	37
PCT9105	TO	918	636	0	0	37	599	487	112
PCT9106	MV	748	397	0	0	24	373	303	70
PCT9106	ED	198	225	0	0	20	205	187	18
PCT9106	TO	946	622	0	0	44	578	490	88
PCT9107	MV	636	305	0	0	24	281	237	44
PCT9107	ED	208	166	0	0	16	150	137	13
PCT9107	TO	844	471	0	0	40	431	374	57
PCT9108	MV	610	337	0	0	31	306	257	49
PCT9108	ED	200	143	0	0	9	134	118	16
PCT9108	TO	810	480	0	0	40	440	375	65
PCT9109	MV	672	300	0	0	25	275	227	48
PCT9109	ED	211	199	0	0	10	189	153	36
PCT9109	TO	883	499	0	0	35	464	380	84
PCT9111	MV	639	317	0	0	23	294	250	44
PCT9111	ED	195	170	0	0	14	156	136	20
PCT9111	TO	834	487	0	0	37	450	386	64
PCT9112	MV	742	351	0	0	23	328	268	60
PCT9112	ED	219	207	0	0	15	192	172	20
PCT9112	TO	961	558	0	0	38	520	440	80
PCT9113	MV	796	371	0	0	24	347	273	74
PCT9113	ED	208	245	0	0	22	223	181	42
PCT9113	TO	1004	616	0	0	46	570	454	116
PCT9114	MV	659	291	0	0	17	274	235	39
PCT9114	ED	231	184	0	0	15	169	155	14
PCT9114	TO	890	475	0	0	32	443	390	53
PCT9115	MV	699	322	0	0	26	296	251	45
PCT9115	ED	182	180	0	0	17	163	143	20
PCT9115	TO	881	502	0	0	43	459	394	65
PCT9116	MV	782	346	0	0	18	328	265	63
PCT9116	ED	179	181	0	0	12	169	138	31
PCT9116	TO	961	527	0	0	30	497	403	94
PCT9117	MV	629	328	0	0	16	312	242	70
PCT9117	ED	171	195	0	0	11	184	147	37
PCT9117	TO	800	523	0	0	27	496	389	107
PCT9118	MV	742	340	0	0	26	314	236	78
PCT9118	ED	242	228	0	0	23	205	167	38
PCT9118	TO	984	568	0	0	49	519	403	116
PCT9119	MV	703	387	0	0	22	365	280	85
PCT9119	ED	197	160	0	0	16	144	121	23
PCT9119	TO	900	547	0	0	38	509	401	108
PCT9121	MV	735	335	0	0	18	317	249	68
PCT9121	ED	218	185	0	0	9	176	137	39
PCT9121	TO	953	520	0	0	27	493	386	107
PCT9122	MV	775	364	0	0	23	341	244	97
PCT9122	ED	192	161	0	0	20	141	115	26
PCT9122	TO	967	525	0	0	43	482	359	123
PCT9123	MV	661	319	0	0	20	299	223	76
PCT9123	ED	191	190	0	0	17	173	155	18
PCT9123	TO	852	509	0	0	37	472	378	94
PCT9124	MV	736	351	0	0	14	337	255	82
PCT9124	ED	167	161	0	0	9	152	124	28
PCT9124	TO	903	512	0	0	23	489	379	110
PCT9125	MV	681	358	0	0	17	341	271	70
PCT9125	ED	188	154	0	0	13	141	124	17
PCT9125	TO	869	512	0	0	30	482	395	87
PCT9126	MV	819	385	0	0	21	364	267	97
PCT9126	ED	194	200	0	0	12	188	152	36
PCT9126	TO	1013	585	0	0	33	552	419	133
PCT9127	MV	748	382	0	0	28	354	293	61
PCT9127	ED	223	221	0	0	13	208	170	38
PCT9127	TO	971	603	0	0	41	562	463	99
PCT9128	MV	628	333	0	0	22	311	239	72
PCT9128	ED	190	196	0	0	15	181	156	25
PCT9128	TO	818	529	0	0	37	492	395	97
PCT9129	MV	587	272	0	0	11	261	208	53
PCT9129	ED	151	154	0	0	10	144	126	18
PCT9129	TO	738	426	0	0	21	405	334	71
PCT9131	MV	596	285	0	0	11	274	209	65
PCT9131	ED	138	154	0	0	11	143	119	24
PCT9131	TO	734	439	0	0	22	417	328	89
PCT9132	MV	627	262	0	0	14	248	219	29
PCT9132	ED	194	172	0	0	13	159	138	21
PCT9132	TO	821	434	0	0	27	407	357	50
PCT9133	MV	808	382	0	0	22	360	301	59
PCT9133	ED	209	214	0	0	15	199	164	35
PCT9133	TO	1017	596	0	0	37	559	465	94
PCT9134	MV	736	327	0	0	18	309	227	82
PCT9134	ED	155	106	0	0	9	97	78	19
PCT9134	TO	891	433	0	0	27	406	305	101
PCT9135	MV	640	305	0	0	19	286	232	54
PCT9135	ED	182	159	0	0	10	149	113	36
PCT9135	TO	822	464	0	0	29	435	345	90
PCT9136	MV	706	368	0	0	26	342	270	72
PCT9136	ED	212	165	0	0	18	147	122	25
PCT9136	TO	918	533	0	0	44	489	392	97
PCT9137	MV	806	389	0	0	27	362	281	81
PCT9137	ED	209	176	0	0	10	166	142	24
PCT9137	TO	1015	565	0	0	37	528	423	105
PCT9138	MV	770	398	0	0	23	375	287	88
PCT9138	ED	175	150	0	0	13	137	124	13
PCT9138	TO	945	548	0	0	36	512	411	101
PCT9139	MV	828	423	0	0	26	397	293	104
PCT9139	ED	190	178	0	0	16	162	132	30
PCT9139	TO	1018	601	0	0	42	559	425	134
PCT9141	MV	789	418	0	0	31	387	291	96
PCT9141	ED	184	173	0	0	14	159	131	28
PCT9141	TO	973	591	0	0	45	546	422	124
PCT9142	MV	747	364	0	0	21	343	283	60
PCT9142	ED	239	210	0	0	18	192	161	31
PCT9142	TO	986	574	0	0	39	535	444	91
PCT9143	MV	705	360	0	0	21	339	263	76
PCT9143	ED	209	172	0	0	7	165	129	36
PCT9143	TO	914	532	0	0	28	504	392	112
PCT9144	MV	767	376	0	0	22	354	271	83
PCT9144	ED	203	215	0	0	12	203	181	22
PCT9144	TO	970	591	0	0	34	557	452	105
PCT9145	MV	681	334	0	0	18	316	255	61
PCT9145	ED	194	178	0	0	9	169	135	34
PCT9145	TO	875	512	0	0	27	485	390	95
PCT9146	MV	725	353	0	0	26	327	281	46
PCT9146	ED	160	194	0	0	20	174	142	32
PCT9146	TO	885	547	0	0	46	501	423	78
PCT9147	MV	765	373	0	0	20	353	292	61
PCT9147	ED	225	211	0	0	13	198	167	31
PCT9147	TO	990	584	0	0	33	551	459	92
PCT9148	MV	779	397	0	0	19	378	322	56
PCT9148	ED	235	230	0	0	21	209	181	28
PCT9148	TO	1014	627	0	0	40	587	503	84
PCT9149	MV	813	385	0	0	21	364	298	66
PCT9149	ED	178	252	0	0	14	238	206	32
PCT9149	TO	991	637	0	0	35	602	504	98
PCT9151	MV	693	351	0	0	25	326	282	44
PCT9151	ED	168	116	0	0	5	111	92	19
PCT9151	TO	861	467	0	0	30	437	374	63
PCT9152	MV	550	196	0	0	10	186	161	25
PCT9152	ED	187	143	0	0	9	134	120	14
PCT9152	TO	737	339	0	0	19	320	281	39
PCT9201	MV	785	358	0	0	25	333	308	25
PCT9201	ED	186	228	0	0	10	218	192	26
PCT9201	TO	971	586	0	0	35	551	500	51
PCT9202	MV	819	368	0	0	33	335	292	43
PCT9202	ED	177	228	0	0	17	211	178	33
PCT9202	TO	996	596	0	0	50	546	470	76
PCT9203	MV	847	373	0	0	52	321	246	75
PCT9203	ED	155	191	0	0	24	167	114	53
PCT9203	TO	1002	564	0	0	76	488	360	128
PCT9204	MV	686	309	0	0	30	279	211	68
PCT9204	ED	176	198	0	0	21	177	141	36
PCT9204	TO	862	507	0	0	51	456	352	104
PCT9205	MV	621	288	0	0	36	252	219	33
PCT9205	ED	115	154	0	0	20	134	104	30
PCT9205	TO	736	442	0	0	56	386	323	63
PCT9206	MV	741	351	0	0	22	329	246	83
PCT9206	ED	188	194	0	0	35	159	124	35
PCT9206	TO	929	545	0	0	57	488	370	118
PCT9207	MV	824	370	0	0	29	341	265	76
PCT9207	ED	165	194	0	0	19	175	139	36
PCT9207	TO	989	564	0	0	48	516	404	112
PCT9208	MV	808	357	0	0	26	331	271	60
PCT9208	ED	179	179	0	0	16	163	137	26
PCT9208	TO	987	536	0	0	42	494	408	86
PCT9209	MV	615	276	0	0	24	252	196	56
PCT9209	ED	156	172	0	0	30	142	115	27
PCT9209	TO	771	448	0	0	54	394	311	83
PCT9211	MV	730	314	0	0	31	283	223	60
PCT9211	ED	161	155	0	0	19	136	105	31
PCT9211	TO	891	469	0	0	50	419	328	91
PCT9212	MV	671	284	0	1	24	259	205	54
PCT9212	ED	137	175	0	0	33	142	120	22
PCT9212	TO	808	459	0	1	57	401	325	76
PCT9213	MV	776	350	0	0	35	315	248	67
PCT9213	ED	161	200	0	0	26	174	148	26
PCT9213	TO	937	550	0	0	61	489	396	93
PCT9214	MV	517	236	0	0	16	220	179	41
PCT9214	ED	110	136	0	0	16	120	94	26
PCT9214	TO	627	372	0	0	32	340	273	67
PCT9215	MV	524	246	0	0	15	231	184	47
PCT9215	ED	120	131	0	0	13	118	91	27
PCT9215	TO	644	377	0	0	28	349	275	74
PCT9216	MV	669	264	0	0	31	233	171	62
PCT9216	ED	155	173	0	0	15	158	127	31
PCT9216	TO	824	437	0	0	46	391	298	93
PCT9217	MV	588	268	0	0	11	257	207	50
PCT9217	ED	117	134	0	0	8	126	99	27
PCT9217	TO	705	402	0	0	19	383	306	77
PCT9218	MV	652	278	0	0	26	252	191	61
PCT9218	ED	164	160	0	0	13	147	120	27
PCT9218	TO	816	438	0	0	39	399	311	88
PCT9219	MV	646	288	0	0	28	260	228	32
PCT9219	ED	144	172	0	0	21	151	123	28
PCT9219	TO	790	460	0	0	49	411	351	60
PCT9221	MV	562	322	0	0	19	303	220	83
PCT9221	ED	89	140	0	0	14	126	100	26
PCT9221	TO	651	462	0	0	33	429	320	109
PCT9222	MV	773	373	0	0	29	344	277	67
PCT9222	ED	137	176	0	0	21	155	122	33
PCT9222	TO	910	549	0	0	50	499	399	100
PCT9223	MV	558	266	0	0	16	250	197	53
PCT9223	ED	109	115	0	0	12	103	77	26
PCT9223	TO	667	381	0	0	28	353	274	79
PCT9224	MV	768	380	0	0	25	355	286	69
PCT9224	ED	181	168	0	0	19	149	114	35
PCT9224	TO	949	548	0	0	44	504	400	104
PCT9225	MV	757	303	0	0	19	284	234	50
PCT9225	ED	169	219	0	0	24	195	166	29
PCT9225	TO	926	522	0	0	43	479	400	79
PCT9226	MV	741	355	0	0	36	319	276	43
PCT9226	ED	155	179	0	0	16	163	143	20
PCT9226	TO	896	534	0	0	52	482	419	63
PCT9227	MV	605	372	0	0	27	345	263	82
PCT9227	ED	124	149	0	0	6	143	114	29
PCT9227	TO	729	521	0	0	33	488	377	111
PCT9228	MV	578	314	0	3	19	292	219	73
PCT9228	ED	160	180	0	0	14	166	141	25
PCT9228	TO	738	494	0	3	33	458	360	98
PCT9229	MV	460	257	0	0	21	236	205	31
PCT9229	ED	119	122	0	0	7	115	98	17
PCT9229	TO	579	379	0	0	28	351	303	48
PCT9231	MV	726	352	0	0	21	331	267	64
PCT9231	ED	236	264	0	0	18	246	211	35
PCT9231	TO	962	616	0	0	39	577	478	99
PCT9232	MV	608	293	0	0	25	268	207	61
PCT9232	ED	126	157	0	0	12	145	112	33
PCT9232	TO	734	450	0	0	37	413	319	94
PCT9233	MV	668	332	0	0	28	304	232	72
PCT9233	ED	150	188	0	0	25	163	137	26
PCT9233	TO	818	520	0	0	53	467	369	98
PCT9234	MV	643	319	0	0	19	300	236	64
PCT9234	ED	91	145	0	0	19	126	99	27
PCT9234	TO	734	464	0	0	38	426	335	91
PCT9235	MV	703	365	0	0	26	339	243	96
PCT9235	ED	160	195	0	0	16	179	145	34
PCT9235	TO	863	560	0	0	42	518	388	130
PCT9236	MV	537	283	0	0	20	263	221	42
PCT9236	ED	136	137	0	0	18	119	97	22
PCT9236	TO	673	420	0	0	38	382	318	64
PCT9237	MV	779	395	0	0	27	368	293	75
PCT9237	ED	118	183	0	0	14	169	143	26
PCT9237	TO	897	578	0	0	41	537	436	101
PCT9238	MV	687	330	0	0	35	295	246	49
PCT9238	ED	118	174	0	0	27	147	127	20
PCT9238	TO	805	504	0	0	62	442	373	69
PCT9239	MV	740	391	0	0	41	350	292	58
PCT9239	ED	124	161	0	0	19	142	121	21
PCT9239	TO	864	552	0	0	60	492	413	79
PCT9241	MV	819	403	0	0	31	372	305	67
PCT9241	ED	141	196	0	0	19	177	157	20
PCT9241	TO	960	599	0	0	50	549	462	87
PCT9242	MV	771	349	0	0	36	313	263	50
PCT9242	ED	172	215	0	0	29	186	159	27
PCT9242	TO	943	564	0	0	65	499	422	77
PCT9243	MV	480	242	0	0	23	219	183	36
PCT9243	ED	123	141	0	0	17	124	107	17
PCT9243	TO	603	383	0	0	40	343	290	53
PCT9244	MV	756	396	0	0	43	353	300	53
PCT9244	ED	154	186	0	0	16	170	146	24
PCT9244	TO	910	582	0	0	59	523	446	77
PCT9245	MV	616	300	0	0	29	271	223	48
PCT9245	ED	98	129	0	0	16	113	90	23
PCT9245	TO	714	429	0	0	45	384	313	71
PCT9246	MV	815	430	0	0	31	399	319	80
PCT9246	ED	155	196	0	0	19	177	154	23
PCT9246	TO	970	626	0	0	50	576	473	103
PCT9247	MV	764	381	0	0	23	358	296	62
PCT9247	ED	148	205	0	0	26	179	151	28
PCT9247	TO	912	586	0	0	49	537	447	90
PCT9248	MV	757	358	0	0	29	329	287	42
PCT9248	ED	150	192	0	0	20	172	153	19
PCT9248	TO	907	550	0	0	49	501	440	61
PCT9249	MV	724	379	0	0	29	350	302	48
PCT9249	ED	191	214	0	0	16	198	161	37
PCT9249	TO	915	593	0	0	45	548	463	85
PCT9251	MV	792	392	0	0	28	364	304	60
PCT9251	ED	174	236	0	0	17	219	177	42
PCT9251	TO	966	628	0	0	45	583	481	102
PCT9252	MV	811	382	0	0	27	355	283	72
PCT9252	ED	142	179	0	0	16	163	138	25
PCT9252	TO	953	561	0	0	43	518	421	97
PCT9253	MV	599	300	0	0	16	284	239	45
PCT9253	ED	162	150	0	0	12	138	118	20
PCT9253	TO	761	450	0	0	28	422	357	65
PCT9254	MV	758	415	0	0	24	391	326	65
PCT9254	ED	163	197	0	0	27	170	149	21
PCT9254	TO	921	612	0	0	51	561	475	86
PCT9255	MV	436	196	0	0	20	176	153	23
PCT9255	ED	114	135	0	0	14	121	101	20
PCT9255	TO	550	331	0	0	34	297	254	43
PCT9256	MV	367	169	0	0	9	160	135	25
PCT9256	ED	95	119	0	0	9	110	96	14
PCT9256	TO	462	288	0	0	18	270	231	39
PCT9257	MV	359	162	0	0	14	148	130	18
PCT9257	ED	-39	13	0	0	2	11	11	0
PCT9257	TO	320	175	0	0	16	159	141	18
PCT9258	MV	583	307	0	0	29	278	230	48
PCT9258	ED	120	148	0	0	10	138	129	9
PCT9258	TO	703	455	0	0	39	416	359	57
PCT9401	MV	796	358	0	0	21	337	289	48
PCT9401	ED	242	226	0	0	21	205	184	21
PCT9401	TO	1038	584	0	0	42	542	473	69
PCT9402	MV	775	377	0	0	15	362	295	67
PCT9402	ED	242	207	0	0	16	191	164	27
PCT9402	TO	1017	584	0	0	31	553	459	94
PCT9403	MV	731	348	0	0	13	335	256	79
PCT9403	ED	190	168	0	0	11	157	143	14
PCT9403	TO	921	516	0	0	24	492	399	93
PCT9404	MV	753	345	0	0	20	325	247	78
PCT9404	ED	191	197	0	0	17	180	145	35
PCT9404	TO	944	542	0	0	37	505	392	113
PCT9405	MV	629	276	0	0	19	257	192	65
PCT9405	ED	151	131	0	0	6	125	98	27
PCT9405	TO	780	407	0	0	25	382	290	92
PCT9406	MV	695	330	0	0	20	310	235	75
PCT9406	ED	188	169	0	0	10	159	124	35
PCT9406	TO	883	499	0	0	30	469	359	110
PCT9407	MV	712	368	0	0	16	352	294	58
PCT9407	ED	201	174	0	0	17	157	128	29
PCT9407	TO	913	542	0	0	33	509	422	87
PCT9408	MV	711	321	0	0	24	297	263	34
PCT9408	ED	152	171	0	0	12	159	142	17
PCT9408	TO	863	492	0	0	36	456	405	51
PCT9409	MV	443	226	0	0	19	207	179	28
PCT9409	ED	158	146	0	0	7	139	126	13
PCT9409	TO	601	372	0	0	26	346	305	41
PCT9411	MV	816	378	0	0	24	354	302	52
PCT9411	ED	191	212	0	0	15	197	174	23
PCT9411	TO	1007	590	0	0	39	551	476	75
PCT9412	MV	668	339	0	0	16	323	240	83
PCT9412	ED	202	186	0	0	11	175	141	34
PCT9412	TO	870	525	0	0	27	498	381	117
PCT9413	MV	757	375	0	0	24	351	260	91
PCT9413	ED	179	170	0	0	14	156	128	28
PCT9413	TO	936	545	0	0	38	507	388	119
PCT9414	MV	734	361	0	1	24	336	248	88
PCT9414	ED	186	142	0	0	8	134	112	22
PCT9414	TO	920	503	0	1	32	470	360	110
PCT9415	MV	634	315	0	0	16	299	233	66
PCT9415	ED	154	135	0	0	7	128	112	16
PCT9415	TO	788	450	0	0	23	427	345	82
PCT9416	MV	769	391	0	0	31	360	273	87
PCT9416	ED	230	151	0	0	5	146	116	30
PCT9416	TO	999	542	0	0	36	506	389	117
PCT9417	MV	629	321	0	0	15	306	222	84
PCT9417	ED	145	125	0	0	4	121	91	30
PCT9417	TO	774	446	0	0	19	427	313	114
PCT9418	MV	631	310	0	0	25	285	201	84
PCT9418	ED	188	141	0	0	9	132	94	38
PCT9418	TO	819	451	0	0	34	417	295	122
PCT9419	MV	736	369	0	0	19	350	251	99
PCT9419	ED	173	140	0	0	10	130	93	37
PCT9419	TO	909	509	0	0	29	480	344	136
PCT9421	MV	752	338	0	0	21	317	214	103
PCT9421	ED	173	154	0	0	7	147	107	40
PCT9421	TO	925	492	0	0	28	464	321	143
PCT9422	MV	831	413	0	0	25	388	284	104
PCT9422	ED	270	209	0	0	17	192	161	31
PCT9422	TO	1101	622	0	0	42	580	445	135
PCT9423	MV	714	316	0	0	22	294	210	84
PCT9423	ED	190	158	0	0	14	144	116	28
PCT9423	TO	904	474	0	0	36	438	326	112
PCT9424	MV	799	385	0	0	18	367	259	108
PCT9424	ED	210	154	0	0	12	142	108	34
PCT9424	TO	1009	539	0	0	30	509	367	142
PCT9425	MV	789	346	0	0	23	323	236	87
PCT9425	ED	187	171	0	0	14	157	119	38
PCT9425	TO	976	517	0	0	37	480	355	125
PCT9426	MV	697	324	0	0	21	303	214	89
PCT9426	ED	156	139	0	0	16	123	87	36
PCT9426	TO	853	463	0	0	37	426	301	125
PCT9427	MV	799	383	0	0	18	365	229	136
PCT9427	ED	188	149	0	0	19	130	99	31
PCT9427	TO	987	532	0	0	37	495	328	167
PCT9428	MV	811	351	0	0	25	326	240	86
PCT9428	ED	179	144	0	0	14	130	107	23
PCT9428	TO	990	495	0	0	39	456	347	109
PCT9429	MV	709	343	0	1	20	322	220	102
PCT9429	ED	197	146	0	0	15	131	99	32
PCT9429	TO	906	489	0	1	35	453	319	134
PCT9431	MV	832	412	0	0	35	377	247	130
PCT9431	ED	204	171	0	0	8	163	121	42
PCT9431	TO	1036	583	0	0	43	540	368	172
PCT9432	MV	743	358	0	0	30	328	243	85
PCT9432	ED	215	136	0	0	12	124	100	24
PCT9432	TO	958	494	0	0	42	452	343	109
PCT9433	MV	794	373	0	0	28	345	225	120
PCT9433	ED	164	124	0	0	5	119	84	35
PCT9433	TO	958	497	0	0	33	464	309	155
PCT9434	MV	785	387	0	0	27	360	268	92
PCT9434	ED	227	210	0	0	23	187	157	30
PCT9434	TO	1012	597	0	0	50	547	425	122
PCT9435	MV	779	366	0	0	15	351	246	105
PCT9435	ED	225	186	0	0	12	174	128	46
PCT9435	TO	1004	552	0	0	27	525	374	151
PCT9436	MV	842	386	0	0	15	371	263	108
PCT9436	ED	226	149	0	0	12	137	104	33
PCT9436	TO	1068	535	0	0	27	508	367	141
PCT9437	MV	736	376	0	0	20	356	243	113
PCT9437	ED	191	149	0	0	7	142	108	34
PCT9437	TO	927	525	0	0	27	498	351	147
PCT9438	MV	837	419	0	0	23	396	273	123
PCT9438	ED	152	108	0	0	8	100	74	26
PCT9438	TO	989	527	0	0	31	496	347	149
PCT9439	MV	718	343	0	0	19	324	233	91
PCT9439	ED	199	141	0	0	15	126	98	28
PCT9439	TO	917	484	0	0	34	450	331	119
PCT9441	MV	778	396	0	0	25	371	265	106
PCT9441	ED	193	166	0	0	15	151	123	28
PCT9441	TO	971	562	0	0	40	522	388	134
PCT9442	MV	830	379	0	0	34	345	225	120
PCT9442	ED	210	212	0	0	15	197	157	40
PCT9442	TO	1040	591	0	0	49	542	382	160
PCT9443	MV	759	362	0	1	18	343	262	81
PCT9443	ED	196	152	0	0	14	138	103	35
PCT9443	TO	955	514	0	1	32	481	365	116
PCT9444	MV	768	340	0	0	15	325	219	106
PCT9444	ED	197	134	0	0	10	124	98	26
PCT9444	TO	965	474	0	0	25	449	317	132
PCT9445	MV	829	406	0	0	26	380	278	102
PCT9445	ED	167	147	0	0	12	135	102	33
PCT9445	TO	996	553	0	0	38	515	380	135
PCT9446	MV	900	465	0	0	29	436	287	149
PCT9446	ED	216	178	0	0	15	163	130	33
PCT9446	TO	1116	643	0	0	44	599	417	182
PCT9447	MV	729	392	0	0	19	373	261	112
PCT9447	ED	192	181	0	0	15	166	139	27
PCT9447	TO	921	573	0	0	34	539	400	139
PCT9448	MV	742	347	0	0	18	329	226	103
PCT9448	ED	198	157	0	0	12	145	123	22
PCT9448	TO	940	504	0	0	30	474	349	125
PCT9449	MV	719	340	0	0	19	321	204	117
PCT9449	ED	162	119	0	0	7	112	82	30
PCT9449	TO	881	459	0	0	26	433	286	147
PCT9451	MV	353	178	0	0	7	171	111	60
PCT9451	ED	88	69	0	0	4	65	48	17
PCT9451	TO	441	247	0	0	11	236	159	77
PCT9452	MV	647	334	0	0	18	316	226	90
PCT9452	ED	195	186	0	0	12	174	125	49
PCT9452	TO	842	520	0	0	30	490	351	139
PCT9453	MV	409	217	0	0	9	208	138	70
PCT9453	ED	115	84	0	0	7	77	55	22
PCT9453	TO	524	301	0	0	16	285	193	92
PCT9501	MV	158	92	0	2	7	83	67	16
PCT9501	ED	-8	3	0	0	1	2	1	1
PCT9501	TO	150	95	0	2	8	85	68	17
PCT9502	MV	294	136	0	0	9	127	110	17
PCT9502	ED	-43	6	0	0	0	6	6	0
PCT9502	TO	251	142	0	0	9	133	116	17
PCT9503	MV	550	263	0	0	28	235	216	19
PCT9503	ED	150	122	0	0	12	110	102	8
PCT9503	TO	700	385	0	0	40	345	318	27
PCT9505	MV	589	296	0	0	25	271	234	37
PCT9505	ED	176	136	0	0	9	127	114	13
PCT9505	TO	765	432	0	0	34	398	348	50
PCT9506	MV	547	232	0	0	15	217	196	21
PCT9506	ED	207	138	0	0	9	129	116	13
PCT9506	TO	754	370	0	0	24	346	312	34
PCT9507	MV	556	306	0	0	21	285	259	26
PCT9507	ED	160	182	0	0	17	165	146	19
PCT9507	TO	716	488	0	0	38	450	405	45
PCT9508	MV	632	317	0	0	20	297	276	21
PCT9508	ED	148	185	0	0	25	160	148	12
PCT9508	TO	780	502	0	0	45	457	424	33
PCT9509	MV	585	296	0	0	21	275	248	27
PCT9509	ED	142	167	0	0	17	150	143	7
PCT9509	TO	727	463	0	0	38	425	391	34
PCT9511	MV	458	240	0	0	16	224	198	26
PCT9511	ED	176	163	0	0	13	150	130	20
PCT9511	TO	634	403	0	0	29	374	328	46
PCT9512	MV	617	327	0	1	17	309	274	35
PCT9512	ED	160	179	0	0	11	168	154	14
PCT9512	TO	777	506	0	1	28	477	428	49
PCT9513	MV	686	334	0	0	23	311	295	16
PCT9513	ED	191	188	0	0	13	175	159	16
PCT9513	TO	877	522	0	0	36	486	454	32
PCT9514	MV	713	352	0	0	31	321	287	34
PCT9514	ED	183	213	0	0	16	197	181	16
PCT9514	TO	896	565	0	0	47	518	468	50
PCT9515	MV	543	305	0	0	20	285	245	40
PCT9515	ED	169	164	0	0	18	146	125	21
PCT9515	TO	712	469	0	0	38	431	370	61
PCT9516	MV	705	366	0	0	22	344	299	45
PCT9516	ED	184	190	0	0	12	178	143	35
PCT9516	TO	889	556	0	0	34	522	442	80
PCT9517	MV	626	335	0	0	25	310	281	29
PCT9517	ED	162	173	0	0	17	156	136	20
PCT9517	TO	788	508	0	0	42	466	417	49
PCT9518	MV	642	316	0	0	25	291	266	25
PCT9518	ED	146	195	0	0	10	185	166	19
PCT9518	TO	788	511	0	0	35	476	432	44
PCT9519	MV	693	368	0	0	17	351	313	38
PCT9519	ED	198	239	0	0	31	208	183	25
PCT9519	TO	891	607	0	0	48	559	496	63
PCT9521	MV	687	352	0	0	25	327	293	34
PCT9521	ED	214	242	0	0	20	222	202	20
PCT9521	TO	901	594	0	0	45	549	495	54
PCT9701	MV	498	269	0	0	19	250	201	49
PCT9701	ED	156	139	0	0	4	135	120	15
PCT9701	TO	654	408	0	0	23	385	321	64
PCT9702	MV	554	305	0	0	14	291	244	47
PCT9702	ED	166	148	0	0	3	145	126	19
PCT9702	TO	720	453	0	0	17	436	370	66
PCT9703	MV	809	403	0	0	30	373	261	112
PCT9703	ED	182	147	0	0	7	140	112	28
PCT9703	TO	991	550	0	0	37	513	373	140
PCT9704	MV	760	422	0	0	31	391	306	85
PCT9704	ED	199	199	0	0	13	186	155	31
PCT9704	TO	959	621	0	0	44	577	461	116
PCT9705	MV	754	421	0	0	29	392	319	73
PCT9705	ED	175	146	0	0	9	137	123	14
PCT9705	TO	929	567	0	0	38	529	442	87
PCT9706	MV	57	34	0	0	1	33	33	0
PCT9706	ED	-8	0	0	0	0	0	0	0
PCT9706	TO	49	34	0	0	1	33	33	0
PCT9707	MV	687	358	0	0	19	339	233	106
PCT9707	ED	139	103	0	0	8	95	73	22
PCT9707	TO	826	461	0	0	27	434	306	128
PCT9708	MV	786	429	0	0	40	389	315	74
PCT9708	ED	175	159	0	0	5	154	129	25
PCT9708	TO	961	588	0	0	45	543	444	99
PCT9709	MV	831	427	0	1	35	391	278	113
PCT9709	ED	209	183	0	0	5	178	130	48
PCT9709	TO	1040	610	0	1	40	569	408	161
PCT9711	MV	502	307	0	0	16	291	224	67
PCT9711	ED	144	162	0	0	12	150	108	42
PCT9711	TO	646	469	0	0	28	441	332	109
PCT9712	MV	534	335	0	0	23	312	229	83
PCT9712	ED	127	118	0	0	1	117	87	30
PCT9712	TO	661	453	0	0	24	429	316	113
PCT9713	MV	747	389	0	0	21	368	254	114
PCT9713	ED	203	171	0	0	12	159	111	48
PCT9713	TO	950	560	0	0	33	527	365	162
PCT9714	MV	795	447	0	0	31	416	292	124
PCT9714	ED	156	137	0	0	4	133	98	35
PCT9714	TO	951	584	0	0	35	549	390	159
PCT9715	MV	449	241	0	0	11	230	165	65
PCT9715	ED	130	135	0	0	5	130	101	29
PCT9715	TO	579	376	0	0	16	360	266	94
PCT9716	MV	745	398	0	0	21	377	282	95
PCT9716	ED	221	167	0	0	12	155	118	37
PCT9716	TO	966	565	0	0	33	532	400	132
PCT9717	MV	753	437	0	0	20	417	322	95
PCT9717	ED	224	173	0	0	14	159	117	42
PCT9717	TO	977	610	0	0	34	576	439	137
PCT9718	MV	749	449	0	0	24	425	334	91
PCT9718	ED	152	145	0	0	4	141	105	36
PCT9718	TO	901	594	0	0	28	566	439	127
PCT9719	MV	747	463	0	1	25	437	328	109
PCT9719	ED	173	151	0	0	6	145	108	37
PCT9719	TO	920	614	0	1	31	582	436	146
PCT9721	MV	498	288	0	0	16	272	202	70
PCT9721	ED	164	135	0	1	4	130	97	33
PCT9721	TO	662	423	0	1	20	402	299	103
PCT9722	MV	513	315	0	0	19	296	224	72
PCT9722	ED	84	76	0	0	5	71	57	14
PCT9722	TO	597	391	0	0	24	367	281	86
PCT9723	MV	436	224	0	0	9	215	112	103
PCT9723	ED	72	46	0	0	4	42	26	16
PCT9723	TO	508	270	0	0	13	257	138	119
PCT9724	MV	851	451	0	0	24	427	246	181
PCT9724	ED	169	100	0	1	5	94	65	29
PCT9724	TO	1020	551	0	1	29	521	311	210
PCT9725	MV	814	437	0	0	24	413	260	153
PCT9725	ED	157	97	0	0	7	90	54	36
PCT9725	TO	971	534	0	0	31	503	314	189
PCT9726	MV	630	217	0	0	18	199	169	30
PCT9726	ED	-14	103	0	0	7	96	83	13
PCT9726	TO	616	320	0	0	25	295	252	43
PCT9727	MV	404	227	0	2	12	213	151	62
PCT9727	ED	56	35	0	0	2	33	24	9
PCT9727	TO	460	262	0	2	14	246	175	71
PCT9728	MV	751	446	0	0	21	425	289	136
PCT9728	ED	212	137	0	0	8	129	91	38
PCT9728	TO	963	583	0	0	29	554	380	174
PCT9729	MV	654	335	0	0	18	317	215	102
PCT9729	ED	164	131	0	0	5	126	93	33
PCT9729	TO	818	466	0	0	23	443	308	135
PCT9731	MV	436	245	0	0	12	233	161	72
PCT9731	ED	143	111	0	0	3	108	82	26
PCT9731	TO	579	356	0	0	15	341	243	98
PCT9732	MV	78	47	0	0	5	42	29	13
PCT9732	ED	-5	0	0	0	0	0	0	0
PCT9732	TO	73	47	0	0	5	42	29	13
PCT9733	MV	261	162	0	0	3	159	138	21
PCT9733	ED	-21	1	0	0	0	1	1	0
PCT9733	TO	240	163	0	0	3	160	139	21
PCT9734	MV	473	286	0	0	16	270	195	75
PCT9734	ED	131	110	0	0	3	107	78	29
PCT9734	TO	604	396	0	0	19	377	273	104
PCT9735	MV	650	386	0	2	23	361	269	92
PCT9735	ED	170	133	0	0	18	115	90	25
PCT9735	TO	820	519	0	2	41	476	359	117
PCT9736	MV	586	325	0	0	18	307	230	77
PCT9736	ED	150	155	0	0	11	144	114	30
PCT9736	TO	736	480	0	0	29	451	344	107
PCT9737	MV	637	388	0	0	20	368	265	103
PCT9737	ED	154	137	0	0	6	131	110	21
PCT9737	TO	791	525	0	0	26	499	375	124
PCT9738	MV	688	320	0	0	23	297	244	53
PCT9738	ED	150	66	0	0	5	61	51	10
PCT9738	TO	838	386	0	0	28	358	295	63
PCT9739	MV	674	270	0	0	10	260	235	25
PCT9739	ED	115	88	0	0	2	86	82	4
PCT9739	TO	789	358	0	0	12	346	317	29
PCT9741	MV	837	173	0	0	15	158	149	9
PCT9741	ED	-396	10	0	0	2	8	8	0
PCT9741	TO	441	183	0	0	17	166	157	9
PCT9742	MV	530	229	0	0	6	223	148	75
PCT9742	ED	165	101	0	0	4	97	74	23
PCT9742	TO	695	330	0	0	10	320	222	98
PCT9743	MV	913	400	0	0	21	379	315	64
PCT9743	ED	227	174	0	0	13	161	143	18
PCT9743	TO	1140	574	0	0	34	540	458	82
PCT9744	MV	783	333	0	0	24	309	264	45
PCT9744	ED	160	126	0	0	14	112	97	15
PCT9744	TO	943	459	0	0	38	421	361	60
PCT9745	MV	790	317	0	0	22	295	263	32
PCT9745	ED	202	129	0	0	11	118	112	6
PCT9745	TO	992	446	0	0	33	413	375	38
PCT9746	MV	714	373	0	0	10	363	266	97
PCT9746	ED	189	120	0	0	7	113	89	24
PCT9746	TO	903	493	0	0	17	476	355	121
PCT9747	MV	772	401	0	0	18	383	280	103
PCT9747	ED	204	146	0	0	11	135	107	28
PCT9747	TO	976	547	0	0	29	518	387	131
PCT9748	MV	746	425	0	0	25	400	318	82
PCT9748	ED	167	119	0	0	7	112	83	29
PCT9748	TO	913	544	0	0	32	512	401	111
PCT9749	MV	750	289	0	0	11	278	218	60
PCT9749	ED	188	109	0	0	2	107	84	23
PCT9749	TO	938	398	0	0	13	385	302	83
PCT9751	MV	857	472	0	0	31	441	329	112
PCT9751	ED	214	153	0	0	15	138	106	32
PCT9751	TO	1071	625	0	0	46	579	435	144
PCT9752	MV	563	328	0	0	19	309	223	86
PCT9752	ED	134	109	0	0	4	105	80	25
PCT9752	TO	697	437	0	0	23	414	303	111
PCT9753	MV	617	300	0	0	13	287	230	57
PCT9753	ED	145	123	0	0	1	122	101	21
PCT9753	TO	762	423	0	0	14	409	331	78
PCT9754	MV	545	317	0	2	17	298	253	45
PCT9754	ED	162	115	0	0	7	108	94	14
PCT9754	TO	707	432	0	2	24	406	347	59
PCT9755	MV	441	239	0	0	16	223	175	48
PCT9755	ED	139	99	0	0	3	96	75	21
PCT9755	TO	580	338	0	0	19	319	250	69
PCT9756	MV	805	364	0	0	27	337	220	117
PCT9756	ED	162	107	0	0	7	100	78	22
PCT9756	TO	967	471	0	0	34	437	298	139
PCT9801	MV	320	163	0	0	12	151	119	32
PCT9801	ED	88	53	0	0	5	48	42	6
PCT9801	TO	408	216	0	0	17	199	161	38
CONG12	MV	355594	174824	0	31	11753	163040	134501	28539
CONG12	ED	90254	77529	0	12	6186	71331	60955	10376
CONG12	TO	445848	252353	0	43	17939	234371	195456	38915
CONG14	MV	47252	22365	0	9	1201	21155	15567	5588
CONG14	ED	10799	7055	0	3	414	6638	5281	1357
CONG14	TO	58051	29420	0	12	1615	27793	20848	6945
ASSM17	MV	232787	114654	0	20	7686	106948	90317	16631
ASSM17	ED	59635	47539	0	11	3693	43835	38188	5647
ASSM17	TO	292422	162193	0	31	11379	150783	128505	22278
ASSM19	MV	170059	82535	0	20	5268	77247	59751	17496
ASSM19	ED	41418	37045	0	4	2907	34134	28048	6086
ASSM19	TO	211477	119580	0	24	8175	111381	87799	23582
SUPV1	MV	33868	16583	0	0	1023	15560	12441	3119
SUPV1	ED	9248	8645	0	1	636	8008	6736	1272
SUPV1	TO	43116	25228	0	1	1659	23568	19177	4391
SUPV2	MV	41435	19991	0	4	1626	18361	14944	3417
SUPV2	ED	8611	10358	0	0	1078	9280	7706	1574
SUPV2	TO	50046	30349	0	4	2704	27641	22650	4991
SUPV3	MV	31943	14432	0	3	1099	13330	11031	2299
SUPV3	ED	7434	6535	0	2	609	5924	5157	767
SUPV3	TO	39377	20967	0	5	1708	19254	16188	3066
SUPV4	MV	35049	16883	0	3	1003	15877	11529	4348
SUPV4	ED	9045	7574	0	0	568	7006	5577	1429
SUPV4	TO	44094	24457	0	3	1571	22883	17106	5777
SUPV5	MV	41966	21520	0	6	1524	19990	17863	2127
SUPV5	ED	10934	11548	0	3	1002	10543	9489	1054
SUPV5	TO	52900	33068	0	9	2526	30533	27352	3181
SUPV6	MV	35755	15237	0	7	1100	14130	12130	2000
SUPV6	ED	7940	5858	0	2	591	5265	4602	663
SUPV6	TO	43695	21095	0	9	1691	19395	16732	2663
SUPV7	MV	38887	20739	0	8	1206	19525	14811	4714
SUPV7	ED	8556	7372	0	2	404	6966	5507	1459
SUPV7	TO	47443	28111	0	10	1610	26491	20318	6173
SUPV8	MV	46370	27513	0	3	1785	25725	22346	3379
SUPV8	ED	11807	11215	0	3	724	10488	9165	1323
SUPV8	TO	58177	38728	0	6	2509	36213	31511	4702
SUPV9	MV	33165	16788	0	1	981	15806	13346	2460
SUPV9	ED	10098	7144	0	1	415	6728	5926	802
SUPV9	TO	43263	23932	0	2	1396	22534	19272	3262
SUPV10	MV	33765	14063	0	2	905	13156	10390	2766
SUPV10	ED	9348	4282	0	0	318	3964	3315	649
SUPV10	TO	43113	18345	0	2	1223	17120	13705	3415
SUPV11	MV	30643	13440	0	3	702	12735	9237	3498
SUPV11	ED	8032	4053	0	1	255	3797	3056	741
SUPV11	TO	38675	17493	0	4	957	16532	12293	4239
NEIG1	MV	15464	5944	0	2	397	5545	4264	1281
NEIG1	ED	5021	1583	0	0	115	1468	1210	258
NEIG1	TO	20485	7527	0	2	512	7013	5474	1539
NEIG2	MV	14029	6280	0	0	528	5752	4681	1071
NEIG2	ED	3238	2815	0	1	292	2522	2169	353
NEIG2	TO	17267	9095	0	1	820	8274	6850	1424
NEIG3	MV	22050	9508	0	4	707	8797	7629	1168
NEIG3	ED	5969	4204	0	3	372	3829	3385	444
NEIG3	TO	28019	13712	0	7	1079	12626	11014	1612
NEIG4	MV	5630	3494	0	0	207	3287	2716	571
NEIG4	ED	1430	1249	0	1	93	1155	945	210
NEIG4	TO	7060	4743	0	1	300	4442	3661	781
NEIG5	MV	22700	10125	0	1	553	9571	6923	2648
NEIG5	ED	5893	3002	0	0	190	2812	2236	576
NEIG5	TO	28593	13127	0	1	743	12383	9159	3224
NEIG6	MV	11526	5973	0	1	407	5565	5015	550
NEIG6	ED	2336	3502	0	1	296	3205	2905	300
NEIG6	TO	13862	9475	0	2	703	8770	7920	850
NEIG7	MV	9818	4131	0	2	199	3930	2871	1059
NEIG7	ED	2577	1320	0	1	79	1240	1024	216
NEIG7	TO	12395	5451	0	3	278	5170	3895	1275
NEIG8	MV	7628	4028	0	1	273	3754	3300	454
NEIG8	ED	2030	2242	0	0	176	2066	1831	235
NEIG8	TO	9658	6270	0	1	449	5820	5131	689
NEIG9	MV	7416	3142	0	0	190	2952	2257	695
NEIG9	ED	842	939	0	1	70	868	721	147
NEIG9	TO	8258	4081	0	1	260	3820	2978	842
NEIG10	MV	8172	3953	0	0	274	3679	3096	583
NEIG10	ED	1850	2034	0	0	156	1878	1615	263
NEIG10	TO	10022	5987	0	0	430	5557	4711	846
NEIG11	MV	33509	15534	0	1	1316	14217	11603	2614
NEIG11	ED	5931	7964	0	0	890	7074	5855	1219
NEIG11	TO	39440	23498	0	1	2206	21291	17458	3833
NEIG12	MV	23572	11865	0	2	688	11175	9987	1188
NEIG12	ED	7433	5385	0	0	343	5042	4580	462
NEIG12	TO	31005	17250	0	2	1031	16217	14567	1650
NEIG14	MV	6791	3992	0	0	259	3733	3288	445
NEIG14	ED	1942	1795	0	1	93	1701	1519	182
NEIG14	TO	8733	5787	0	1	352	5434	4807	627
NEIG15	MV	5779	2678	0	0	162	2516	2012	504
NEIG15	ED	1309	1197	0	0	101	1096	944	152
NEIG15	TO	7088	3875	0	0	263	3612	2956	656
NEIG13	MV	13553	8168	0	0	549	7619	6544	1075
NEIG13	ED	3435	3395	0	0	206	3189	2763	426
NEIG13	TO	16988	11563	0	0	755	10808	9307	1501
NEIG26	MV	7830	3526	0	0	204	3322	2253	1069
NEIG26	ED	1802	958	0	0	58	900	672	228
NEIG26	TO	9632	4484	0	0	262	4222	2925	1297
NEIG16	MV	14623	6960	0	1	492	6467	5546	921
NEIG16	ED	2733	2592	0	0	224	2368	2061	307
NEIG16	TO	17356	9552	0	1	716	8835	7607	1228
NEIG17	MV	29447	14415	0	0	899	13516	10764	2752
NEIG17	ED	8178	7576	0	1	561	7014	5881	1133
NEIG17	TO	37625	21991	0	1	1460	20530	16645	3885
NEIG19	MV	7165	4024	0	0	237	3787	3266	521
NEIG19	ED	2406	1880	0	0	108	1772	1531	241
NEIG19	TO	9571	5904	0	0	345	5559	4797	762
NEIG18	MV	6458	3414	0	3	230	3181	2493	688
NEIG18	ED	1563	1848	0	0	154	1694	1413	281
NEIG18	TO	8021	5262	0	3	384	4875	3906	969
NEIG20	MV	20910	8912	0	5	628	8279	7056	1223
NEIG20	ED	4167	3399	0	0	347	3052	2650	402
NEIG20	TO	25077	12311	0	5	975	11331	9706	1625
NEIG21	MV	34606	16657	0	3	984	15670	11350	4320
NEIG21	ED	8887	7428	0	0	561	6867	5451	1416
NEIG21	TO	43493	24085	0	3	1545	22537	16801	5736
NEIG22	MV	15381	9297	0	2	612	8683	7624	1059
NEIG22	ED	3512	3650	0	2	228	3420	3025	395
NEIG22	TO	18893	12947	0	4	840	12103	10649	1454
NEIG23	MV	6638	2511	0	0	136	2375	1631	744
NEIG23	ED	1850	604	0	0	45	559	433	126
NEIG23	TO	8488	3115	0	0	181	2934	2064	870
NEIG24	MV	28439	16112	0	8	934	15170	11469	3701
NEIG24	ED	6935	5821	0	1	310	5510	4294	1216
NEIG24	TO	35374	21933	0	9	1244	20680	15763	4917
NEIG25	MV	23712	12546	0	4	889	11653	10430	1223
NEIG25	ED	7784	6202	0	2	532	5668	5123	545
NEIG25	TO	31496	18748	0	6	1421	17321	15553	1768
