area_id	subtotal_type	RSReg	RSCst	RSRej	RSOvr	RSUnd	RSTot	5:YES	6:NO
ALLPCTS	TO	503899	275013	0	54	18632	256327	211226	45101
ALLPCTS	ED	101053	78221	0	14	5708	72499	61485	11014
ALLPCTS	MV	402846	196792	0	40	12924	183828	149741	34087
PCT1101	MV	448	214	0	0	14	200	154	46
PCT1101	ED	114	60	0	0	5	55	45	10
PCT1101	TO	562	274	0	0	19	255	199	56
PCT1102	MV	774	368	0	0	15	353	249	104
PCT1102	ED	230	159	0	0	9	150	118	32
PCT1102	TO	1004	527	0	0	24	503	367	136
PCT1103	MV	749	371	0	0	19	352	270	82
PCT1103	ED	222	142	0	0	6	136	109	27
PCT1103	TO	971	513	0	0	25	488	379	109
PCT1104	MV	751	343	0	0	12	331	263	68
PCT1104	ED	267	120	0	0	5	115	93	22
PCT1104	TO	1018	463	0	0	17	446	356	90
PCT1106	MV	598	255	0	0	16	239	163	76
PCT1106	ED	173	96	0	1	6	89	68	21
PCT1106	TO	771	351	0	1	22	328	231	97
PCT1107	MV	612	287	0	0	14	273	186	87
PCT1107	ED	139	76	0	0	7	69	57	12
PCT1107	TO	751	363	0	0	21	342	243	99
PCT1108	MV	725	360	0	0	17	343	272	71
PCT1108	ED	198	115	0	0	9	106	84	22
PCT1108	TO	923	475	0	0	26	449	356	93
PCT1109	MV	653	284	0	0	12	272	183	89
PCT1109	ED	169	97	0	0	4	93	74	19
PCT1109	TO	822	381	0	0	16	365	257	108
PCT1111	MV	849	354	0	0	17	337	235	102
PCT1111	ED	197	118	0	0	6	112	89	23
PCT1111	TO	1046	472	0	0	23	449	324	125
PCT1112	MV	643	276	0	0	14	262	196	66
PCT1112	ED	159	77	0	0	5	72	60	12
PCT1112	TO	802	353	0	0	19	334	256	78
PCT1113	MV	675	286	0	0	15	271	190	81
PCT1113	ED	120	65	0	0	6	59	49	10
PCT1113	TO	795	351	0	0	21	330	239	91
PCT1114	MV	769	328	0	0	22	306	240	66
PCT1114	ED	222	97	0	0	9	88	78	10
PCT1114	TO	991	425	0	0	31	394	318	76
PCT1115	MV	743	295	0	0	16	279	201	78
PCT1115	ED	193	86	0	0	2	84	68	16
PCT1115	TO	936	381	0	0	18	363	269	94
PCT1116	MV	715	308	0	0	18	290	217	73
PCT1116	ED	216	118	0	0	7	111	102	9
PCT1116	TO	931	426	0	0	25	401	319	82
PCT1117	MV	665	257	0	0	14	243	182	61
PCT1117	ED	181	71	0	0	3	68	59	9
PCT1117	TO	846	328	0	0	17	311	241	70
PCT1118	MV	846	356	0	0	14	342	245	97
PCT1118	ED	219	104	0	0	10	94	74	20
PCT1118	TO	1065	460	0	0	24	436	319	117
PCT1119	MV	659	303	0	0	12	291	226	65
PCT1119	ED	138	74	0	0	6	68	64	4
PCT1119	TO	797	377	0	0	18	359	290	69
PCT1121	MV	556	268	0	0	20	248	164	84
PCT1121	ED	149	82	0	0	6	76	55	21
PCT1121	TO	705	350	0	0	26	324	219	105
PCT1122	MV	519	245	0	0	13	232	163	69
PCT1122	ED	118	71	0	0	5	66	55	11
PCT1122	TO	637	316	0	0	18	298	218	80
PCT1123	MV	730	257	0	0	16	241	164	77
PCT1123	ED	208	89	0	0	6	83	67	16
PCT1123	TO	938	346	0	0	22	324	231	93
PCT1124	MV	630	246	0	2	7	237	180	57
PCT1124	ED	199	73	0	0	3	70	61	9
PCT1124	TO	829	319	0	2	10	307	241	66
PCT1125	MV	919	364	0	0	31	333	231	102
PCT1125	ED	178	67	0	0	7	60	54	6
PCT1125	TO	1097	431	0	0	38	393	285	108
PCT1126	MV	812	308	0	0	16	292	223	69
PCT1126	ED	200	68	0	0	1	67	53	14
PCT1126	TO	1012	376	0	0	17	359	276	83
PCT1127	MV	743	293	0	0	12	281	186	95
PCT1127	ED	222	100	0	0	3	97	75	22
PCT1127	TO	965	393	0	0	15	378	261	117
PCT1128	MV	734	286	0	0	13	273	180	93
PCT1128	ED	145	59	0	0	6	53	42	11
PCT1128	TO	879	345	0	0	19	326	222	104
PCT1129	MV	790	314	0	0	22	292	201	91
PCT1129	ED	246	108	0	0	13	95	68	27
PCT1129	TO	1036	422	0	0	35	387	269	118
PCT1131	MV	694	279	0	0	22	257	180	77
PCT1131	ED	166	60	0	0	4	56	49	7
PCT1131	TO	860	339	0	0	26	313	229	84
PCT1132	MV	839	370	0	0	24	346	252	94
PCT1132	ED	193	59	0	0	0	59	38	21
PCT1132	TO	1032	429	0	0	24	405	290	115
PCT1133	MV	716	334	0	0	12	322	243	79
PCT1133	ED	159	74	0	0	3	71	51	20
PCT1133	TO	875	408	0	0	15	393	294	99
PCT1134	MV	585	292	0	0	11	281	180	101
PCT1134	ED	182	80	0	0	7	73	64	9
PCT1134	TO	767	372	0	0	18	354	244	110
PCT1135	MV	465	218	0	0	5	213	153	60
PCT1135	ED	91	51	0	0	1	50	41	9
PCT1135	TO	556	269	0	0	6	263	194	69
PCT1136	MV	710	340	0	0	16	324	243	81
PCT1136	ED	157	77	0	0	4	73	63	10
PCT1136	TO	867	417	0	0	20	397	306	91
PCT1141	MV	836	392	0	0	19	373	268	105
PCT1141	ED	220	123	0	0	4	119	92	27
PCT1141	TO	1056	515	0	0	23	492	360	132
PCT1142	MV	721	324	0	0	26	298	238	60
PCT1142	ED	175	87	0	0	3	84	73	11
PCT1142	TO	896	411	0	0	29	382	311	71
PCT1143	MV	824	360	0	0	22	338	242	96
PCT1143	ED	225	114	0	0	7	107	92	15
PCT1143	TO	1049	474	0	0	29	445	334	111
PCT1144	MV	727	326	0	0	10	316	220	96
PCT1144	ED	220	121	0	0	9	112	86	26
PCT1144	TO	947	447	0	0	19	428	306	122
PCT1145	MV	753	411	0	0	25	386	274	112
PCT1145	ED	152	114	0	0	8	106	83	23
PCT1145	TO	905	525	0	0	33	492	357	135
PCT1146	MV	839	364	0	0	15	349	276	73
PCT1146	ED	215	110	0	0	7	103	79	24
PCT1146	TO	1054	474	0	0	22	452	355	97
PCT1147	MV	673	309	0	0	11	298	215	83
PCT1147	ED	212	107	0	0	5	102	82	20
PCT1147	TO	885	416	0	0	16	400	297	103
PCT1148	MV	804	367	0	0	16	351	244	107
PCT1148	ED	224	116	0	0	8	108	85	23
PCT1148	TO	1028	483	0	0	24	459	329	130
PCT1149	MV	710	319	0	1	22	296	212	84
PCT1149	ED	229	118	0	0	9	109	83	26
PCT1149	TO	939	437	0	1	31	405	295	110
PCT1151	MV	0	0	0	0	0	0	0	0
PCT1151	ED	0	0	0	0	0	0	0	0
PCT1151	TO	0	0	0	0	0	0	0	0
PCT1152	MV	710	312	0	0	17	295	219	76
PCT1152	ED	180	85	0	0	7	78	58	20
PCT1152	TO	890	397	0	0	24	373	277	96
PCT1153	MV	730	285	0	0	17	268	205	63
PCT1153	ED	210	117	0	0	9	108	77	31
PCT1153	TO	940	402	0	0	26	376	282	94
PCT1154	MV	0	0	0	0	0	0	0	0
PCT1154	ED	0	0	0	0	0	0	0	0
PCT1154	TO	0	0	0	0	0	0	0	0
PCT7001	MV	632	328	0	0	21	307	268	39
PCT7001	ED	141	103	0	0	6	97	85	12
PCT7001	TO	773	431	0	0	27	404	353	51
PCT7002	MV	598	267	0	0	21	246	211	35
PCT7002	ED	116	88	0	0	3	85	73	12
PCT7002	TO	714	355	0	0	24	331	284	47
PCT7003	MV	759	430	0	0	24	406	347	59
PCT7003	ED	147	144	0	0	12	132	108	24
PCT7003	TO	906	574	0	0	36	538	455	83
PCT7004	MV	764	416	0	0	25	391	335	56
PCT7004	ED	149	143	0	0	9	134	111	23
PCT7004	TO	913	559	0	0	34	525	446	79
PCT7005	MV	698	350	0	0	23	327	293	34
PCT7005	ED	161	162	0	0	17	145	133	12
PCT7005	TO	859	512	0	0	40	472	426	46
PCT7006	MV	729	359	0	0	26	333	293	40
PCT7006	ED	203	149	0	0	11	138	114	24
PCT7006	TO	932	508	0	0	37	471	407	64
PCT7007	MV	777	437	0	0	30	407	350	57
PCT7007	ED	180	169	0	0	13	156	135	21
PCT7007	TO	957	606	0	0	43	563	485	78
PCT7008	MV	732	367	0	0	30	337	280	57
PCT7008	ED	177	192	0	0	12	180	154	26
PCT7008	TO	909	559	0	0	42	517	434	83
PCT7009	MV	752	389	0	0	26	363	301	62
PCT7009	ED	119	91	0	0	4	87	73	14
PCT7009	TO	871	480	0	0	30	450	374	76
PCT7011	MV	704	231	0	0	18	213	184	29
PCT7011	ED	269	87	0	0	4	83	74	9
PCT7011	TO	973	318	0	0	22	296	258	38
PCT7012	MV	999	487	0	0	34	453	390	63
PCT7012	ED	227	206	0	0	11	195	170	25
PCT7012	TO	1226	693	0	0	45	648	560	88
PCT7013	MV	984	280	0	0	16	264	236	28
PCT7013	ED	155	151	0	0	10	141	131	10
PCT7013	TO	1139	431	0	0	26	405	367	38
PCT7014	MV	610	298	0	0	18	280	250	30
PCT7014	ED	109	112	0	0	14	98	85	13
PCT7014	TO	719	410	0	0	32	378	335	43
PCT7015	MV	128	40	0	0	5	35	31	4
PCT7015	ED	-18	0	0	0	0	0	0	0
PCT7015	TO	110	40	0	0	5	35	31	4
PCT7016	MV	655	238	0	0	16	222	162	60
PCT7016	ED	277	75	0	0	7	68	58	10
PCT7016	TO	932	313	0	0	23	290	220	70
PCT7017	MV	543	180	0	0	18	162	134	28
PCT7017	ED	238	53	0	0	8	45	40	5
PCT7017	TO	781	233	0	0	26	207	174	33
PCT7018	MV	847	357	0	0	20	337	247	90
PCT7018	ED	200	56	0	0	4	52	46	6
PCT7018	TO	1047	413	0	0	24	389	293	96
PCT7019	MV	734	355	0	0	25	330	242	88
PCT7019	ED	166	74	0	0	8	66	55	11
PCT7019	TO	900	429	0	0	33	396	297	99
PCT7021	MV	679	271	0	0	18	253	207	46
PCT7021	ED	288	106	0	0	9	97	84	13
PCT7021	TO	967	377	0	0	27	350	291	59
PCT7022	MV	770	311	0	0	27	284	235	49
PCT7022	ED	193	55	0	0	2	53	49	4
PCT7022	TO	963	366	0	0	29	337	284	53
PCT7023	MV	687	331	0	0	16	315	252	63
PCT7023	ED	233	71	0	0	6	65	57	8
PCT7023	TO	920	402	0	0	22	380	309	71
PCT7024	MV	251	50	0	0	3	47	42	5
PCT7024	ED	190	20	0	0	3	17	17	0
PCT7024	TO	441	70	0	0	6	64	59	5
PCT7025	MV	316	95	0	0	5	90	79	11
PCT7025	ED	167	39	0	0	1	38	34	4
PCT7025	TO	483	134	0	0	6	128	113	15
PCT7026	MV	819	336	0	1	13	322	211	111
PCT7026	ED	191	72	0	0	4	68	52	16
PCT7026	TO	1010	408	0	1	17	390	263	127
PCT7027	MV	677	270	0	0	19	251	184	67
PCT7027	ED	219	96	0	0	8	88	69	19
PCT7027	TO	896	366	0	0	27	339	253	86
PCT7028	MV	585	220	0	0	15	205	168	37
PCT7028	ED	271	97	0	0	7	90	74	16
PCT7028	TO	856	317	0	0	22	295	242	53
PCT7029	MV	642	208	0	0	20	188	149	39
PCT7029	ED	267	39	0	0	2	37	32	5
PCT7029	TO	909	247	0	0	22	225	181	44
PCT7030	MV	654	274	0	0	9	265	168	97
PCT7030	ED	141	58	0	0	2	56	36	20
PCT7030	TO	795	332	0	0	11	321	204	117
PCT7031	MV	622	263	0	1	23	239	193	46
PCT7031	ED	72	48	0	0	6	42	33	9
PCT7031	TO	694	311	0	1	29	281	226	55
PCT7032	MV	643	266	0	0	20	246	204	42
PCT7032	ED	238	53	0	0	3	50	39	11
PCT7032	TO	881	319	0	0	23	296	243	53
PCT7033	MV	549	214	0	0	17	197	154	43
PCT7033	ED	229	86	0	0	7	79	62	17
PCT7033	TO	778	300	0	0	24	276	216	60
PCT7034	MV	620	140	0	0	15	125	117	8
PCT7034	ED	318	58	0	0	3	55	47	8
PCT7034	TO	938	198	0	0	18	180	164	16
PCT7035	MV	567	237	0	0	17	220	178	42
PCT7035	ED	152	52	0	0	5	47	41	6
PCT7035	TO	719	289	0	0	22	267	219	48
PCT7036	MV	781	262	0	0	13	249	168	81
PCT7036	ED	193	39	0	0	1	38	30	8
PCT7036	TO	974	301	0	0	14	287	198	89
PCT7037	MV	434	63	0	0	4	59	48	11
PCT7037	ED	312	38	0	0	5	33	31	2
PCT7037	TO	746	101	0	0	9	92	79	13
PCT7038	MV	758	308	0	0	20	288	194	94
PCT7038	ED	203	58	0	0	8	50	40	10
PCT7038	TO	961	366	0	0	28	338	234	104
PCT7039	MV	636	243	0	0	14	229	154	75
PCT7039	ED	201	104	0	0	6	98	69	29
PCT7039	TO	837	347	0	0	20	327	223	104
PCT7041	MV	70	29	0	0	4	25	17	8
PCT7041	ED	-4	0	0	0	0	0	0	0
PCT7041	TO	66	29	0	0	4	25	17	8
PCT7042	MV	514	221	0	0	9	212	166	46
PCT7042	ED	146	59	0	0	3	56	43	13
PCT7042	TO	660	280	0	0	12	268	209	59
PCT7043	MV	754	295	0	0	17	278	198	80
PCT7043	ED	224	78	0	0	3	75	56	19
PCT7043	TO	978	373	0	0	20	353	254	99
PCT7044	MV	586	148	0	0	5	143	115	28
PCT7044	ED	266	33	0	0	2	31	27	4
PCT7044	TO	852	181	0	0	7	174	142	32
PCT7045	MV	632	266	0	0	14	252	173	79
PCT7045	ED	154	53	0	0	2	51	34	17
PCT7045	TO	786	319	0	0	16	303	207	96
PCT7046	MV	334	132	0	0	4	128	90	38
PCT7046	ED	96	48	0	0	2	46	36	10
PCT7046	TO	430	180	0	0	6	174	126	48
PCT7047	MV	733	314	0	0	20	294	192	102
PCT7047	ED	150	62	0	0	4	58	47	11
PCT7047	TO	883	376	0	0	24	352	239	113
PCT7048	MV	685	267	0	0	12	255	195	60
PCT7048	ED	196	56	0	0	6	50	38	12
PCT7048	TO	881	323	0	0	18	305	233	72
PCT7049	MV	616	247	0	0	11	236	150	86
PCT7049	ED	210	70	0	0	4	66	53	13
PCT7049	TO	826	317	0	0	15	302	203	99
PCT7051	MV	715	306	0	0	21	285	179	106
PCT7051	ED	165	70	0	0	7	63	50	13
PCT7051	TO	880	376	0	0	28	348	229	119
PCT7052	MV	722	296	0	0	9	287	200	87
PCT7052	ED	184	84	0	0	5	79	68	11
PCT7052	TO	906	380	0	0	14	366	268	98
PCT7053	MV	542	227	0	0	29	198	148	50
PCT7053	ED	43	42	0	0	4	38	34	4
PCT7053	TO	585	269	0	0	33	236	182	54
PCT7054	MV	863	308	0	0	16	292	238	54
PCT7054	ED	273	106	0	0	5	101	74	27
PCT7054	TO	1136	414	0	0	21	393	312	81
PCT7055	MV	732	291	0	0	16	275	223	52
PCT7055	ED	94	77	0	0	7	70	60	10
PCT7055	TO	826	368	0	0	23	345	283	62
PCT7056	MV	618	273	0	0	20	253	220	33
PCT7056	ED	87	119	0	0	13	106	92	14
PCT7056	TO	705	392	0	0	33	359	312	47
PCT7101	MV	162	99	0	0	6	93	88	5
PCT7101	ED	-15	4	0	0	1	3	3	0
PCT7101	TO	147	103	0	0	7	96	91	5
PCT7201	MV	788	383	0	0	23	360	298	62
PCT7201	ED	147	168	0	0	20	148	124	24
PCT7201	TO	935	551	0	0	43	508	422	86
PCT7202	MV	708	308	0	0	23	285	225	60
PCT7202	ED	143	156	0	0	15	141	120	21
PCT7202	TO	851	464	0	0	38	426	345	81
PCT7203	MV	693	321	0	0	33	288	239	49
PCT7203	ED	186	186	0	0	22	164	135	29
PCT7203	TO	879	507	0	0	55	452	374	78
PCT7204	MV	773	421	0	0	43	378	318	60
PCT7204	ED	126	122	0	0	20	102	88	14
PCT7204	TO	899	543	0	0	63	480	406	74
PCT7205	MV	724	360	0	0	26	334	274	60
PCT7205	ED	147	175	0	0	15	160	129	31
PCT7205	TO	871	535	0	0	41	494	403	91
PCT7206	MV	299	129	0	0	10	119	98	21
PCT7206	ED	78	102	0	0	10	92	82	10
PCT7206	TO	377	231	0	0	20	211	180	31
PCT7207	MV	744	333	0	0	25	308	255	53
PCT7207	ED	123	151	0	0	12	139	122	17
PCT7207	TO	867	484	0	0	37	447	377	70
PCT7208	MV	492	253	0	0	27	226	184	42
PCT7208	ED	78	94	0	0	7	87	81	6
PCT7208	TO	570	347	0	0	34	313	265	48
PCT7209	MV	595	341	0	0	28	313	270	43
PCT7209	ED	52	75	0	0	6	69	56	13
PCT7209	TO	647	416	0	0	34	382	326	56
PCT7301	MV	813	317	0	0	16	301	251	50
PCT7301	ED	201	141	0	0	15	126	102	24
PCT7301	TO	1014	458	0	0	31	427	353	74
PCT7302	MV	713	351	0	0	22	329	268	61
PCT7302	ED	136	137	0	0	10	127	116	11
PCT7302	TO	849	488	0	0	32	456	384	72
PCT7303	MV	869	376	0	0	23	353	289	64
PCT7303	ED	199	155	0	0	12	143	125	18
PCT7303	TO	1068	531	0	0	35	496	414	82
PCT7304	MV	802	366	0	0	27	339	260	79
PCT7304	ED	199	184	0	0	13	171	150	21
PCT7304	TO	1001	550	0	0	40	510	410	100
PCT7305	MV	713	386	0	0	26	360	273	87
PCT7305	ED	154	154	0	0	12	142	115	27
PCT7305	TO	867	540	0	0	38	502	388	114
PCT7306	MV	801	373	0	0	36	337	263	74
PCT7306	ED	243	193	0	1	30	162	138	24
PCT7306	TO	1044	566	0	1	66	499	401	98
PCT7307	MV	605	272	0	0	13	259	209	50
PCT7307	ED	169	126	0	0	12	114	97	17
PCT7307	TO	774	398	0	0	25	373	306	67
PCT7308	MV	520	256	0	0	10	246	195	51
PCT7308	ED	105	157	0	0	12	145	124	21
PCT7308	TO	625	413	0	0	22	391	319	72
PCT7309	MV	691	324	0	0	29	295	253	42
PCT7309	ED	167	190	0	0	17	173	150	23
PCT7309	TO	858	514	0	0	46	468	403	65
PCT7311	MV	698	333	0	0	23	310	265	45
PCT7311	ED	208	215	0	0	18	197	177	20
PCT7311	TO	906	548	0	0	41	507	442	65
PCT7312	MV	700	394	0	0	26	368	298	70
PCT7312	ED	110	160	0	0	15	145	117	28
PCT7312	TO	810	554	0	0	41	513	415	98
PCT7313	MV	819	373	0	0	23	350	283	67
PCT7313	ED	184	160	0	0	23	137	120	17
PCT7313	TO	1003	533	0	0	46	487	403	84
PCT7314	MV	612	226	0	0	19	207	158	49
PCT7314	ED	147	83	0	0	12	71	62	9
PCT7314	TO	759	309	0	0	31	278	220	58
PCT7315	MV	570	206	0	0	9	197	155	42
PCT7315	ED	195	134	0	0	9	125	102	23
PCT7315	TO	765	340	0	0	18	322	257	65
PCT7316	MV	654	261	0	0	28	233	188	45
PCT7316	ED	178	130	0	0	15	115	104	11
PCT7316	TO	832	391	0	0	43	348	292	56
PCT7317	MV	744	348	0	0	25	323	261	62
PCT7317	ED	146	111	0	0	8	103	93	10
PCT7317	TO	890	459	0	0	33	426	354	72
PCT7318	MV	605	293	0	0	24	269	232	37
PCT7318	ED	118	106	0	0	15	91	70	21
PCT7318	TO	723	399	0	0	39	360	302	58
PCT7319	MV	861	344	0	0	27	317	264	53
PCT7319	ED	188	180	0	0	19	161	136	25
PCT7319	TO	1049	524	0	0	46	478	400	78
PCT7321	MV	557	202	0	0	20	182	140	42
PCT7321	ED	102	84	0	0	6	78	64	14
PCT7321	TO	659	286	0	0	26	260	204	56
PCT7322	MV	742	294	0	0	25	269	208	61
PCT7322	ED	146	49	0	0	3	46	43	3
PCT7322	TO	888	343	0	0	28	315	251	64
PCT7323	MV	790	368	0	0	34	334	283	51
PCT7323	ED	166	157	0	0	17	140	116	24
PCT7323	TO	956	525	0	0	51	474	399	75
PCT7324	MV	587	259	0	0	24	235	192	43
PCT7324	ED	150	89	0	0	5	84	69	15
PCT7324	TO	737	348	0	0	29	319	261	58
PCT7325	MV	714	326	0	0	33	293	245	48
PCT7325	ED	172	123	0	0	11	112	94	18
PCT7325	TO	886	449	0	0	44	405	339	66
PCT7326	MV	685	303	0	0	25	278	217	61
PCT7326	ED	174	155	0	0	20	135	119	16
PCT7326	TO	859	458	0	0	45	413	336	77
PCT7327	MV	561	230	0	0	24	206	152	54
PCT7327	ED	126	49	0	0	2	47	41	6
PCT7327	TO	687	279	0	0	26	253	193	60
PCT7328	MV	829	333	0	0	36	297	242	55
PCT7328	ED	173	67	0	0	12	55	48	7
PCT7328	TO	1002	400	0	0	48	352	290	62
PCT7329	MV	556	227	0	0	20	207	171	36
PCT7329	ED	95	76	0	0	6	70	62	8
PCT7329	TO	651	303	0	0	26	277	233	44
PCT7331	MV	710	360	0	0	32	328	276	52
PCT7331	ED	160	158	0	0	20	138	113	25
PCT7331	TO	870	518	0	0	52	466	389	77
PCT7332	MV	654	262	0	0	22	240	212	28
PCT7332	ED	136	147	0	0	9	138	125	13
PCT7332	TO	790	409	0	0	31	378	337	41
PCT7333	MV	822	389	0	0	34	355	294	61
PCT7333	ED	193	219	0	0	19	200	176	24
PCT7333	TO	1015	608	0	0	53	555	470	85
PCT7334	MV	688	306	0	0	17	289	252	37
PCT7334	ED	131	131	0	0	11	120	104	16
PCT7334	TO	819	437	0	0	28	409	356	53
PCT7335	MV	788	389	0	0	34	355	295	60
PCT7335	ED	146	189	0	0	19	170	157	13
PCT7335	TO	934	578	0	0	53	525	452	73
PCT7336	MV	779	404	0	1	24	379	297	82
PCT7336	ED	175	174	0	0	19	155	132	23
PCT7336	TO	954	578	0	1	43	534	429	105
PCT7337	MV	772	386	0	0	31	355	290	65
PCT7337	ED	125	111	0	0	8	103	87	16
PCT7337	TO	897	497	0	0	39	458	377	81
PCT7338	MV	770	360	0	0	28	332	274	58
PCT7338	ED	125	90	0	0	9	81	70	11
PCT7338	TO	895	450	0	0	37	413	344	69
PCT7339	MV	605	270	0	0	19	251	212	39
PCT7339	ED	150	122	0	0	6	116	102	14
PCT7339	TO	755	392	0	0	25	367	314	53
PCT7341	MV	675	291	0	0	29	262	218	44
PCT7341	ED	178	159	0	0	7	152	137	15
PCT7341	TO	853	450	0	0	36	414	355	59
PCT7342	MV	674	323	0	0	20	303	259	44
PCT7342	ED	230	238	0	1	18	219	193	26
PCT7342	TO	904	561	0	1	38	522	452	70
PCT7343	MV	554	251	0	0	19	232	212	20
PCT7343	ED	150	146	0	0	17	129	117	12
PCT7343	TO	704	397	0	0	36	361	329	32
PCT7344	MV	863	392	0	0	28	364	308	56
PCT7344	ED	201	161	0	0	7	154	134	20
PCT7344	TO	1064	553	0	0	35	518	442	76
PCT7345	MV	904	432	0	0	24	408	365	43
PCT7345	ED	210	214	0	0	13	201	181	20
PCT7345	TO	1114	646	0	0	37	609	546	63
PCT7346	MV	681	288	0	1	15	272	239	33
PCT7346	ED	208	169	0	0	19	150	136	14
PCT7346	TO	889	457	0	1	34	422	375	47
PCT7347	MV	833	370	0	1	34	335	312	23
PCT7347	ED	170	109	0	0	7	102	94	8
PCT7347	TO	1003	479	0	1	41	437	406	31
PCT7348	MV	650	279	0	0	20	259	225	34
PCT7348	ED	193	115	0	0	7	108	95	13
PCT7348	TO	843	394	0	0	27	367	320	47
PCT7349	MV	710	315	0	0	22	293	253	40
PCT7349	ED	202	143	0	0	9	134	123	11
PCT7349	TO	912	458	0	0	31	427	376	51
PCT7501	MV	456	248	0	0	24	224	175	49
PCT7501	ED	95	116	0	0	13	103	80	23
PCT7501	TO	551	364	0	0	37	327	255	72
PCT7502	MV	668	314	0	0	23	291	231	60
PCT7502	ED	121	135	0	0	17	118	104	14
PCT7502	TO	789	449	0	0	40	409	335	74
PCT7503	MV	614	286	0	0	24	262	227	35
PCT7503	ED	148	134	0	0	20	114	93	21
PCT7503	TO	762	420	0	0	44	376	320	56
PCT7504	MV	404	175	0	0	15	160	138	22
PCT7504	ED	84	57	0	0	7	50	45	5
PCT7504	TO	488	232	0	0	22	210	183	27
PCT7505	MV	729	405	0	0	33	372	346	26
PCT7505	ED	133	96	0	0	2	94	87	7
PCT7505	TO	862	501	0	0	35	466	433	33
PCT7506	MV	842	363	0	0	34	329	284	45
PCT7506	ED	158	117	0	0	10	107	103	4
PCT7506	TO	1000	480	0	0	44	436	387	49
PCT7507	MV	694	289	0	0	18	271	236	35
PCT7507	ED	262	102	0	0	4	98	82	16
PCT7507	TO	956	391	0	0	22	369	318	51
PCT7508	MV	618	373	0	0	29	344	299	45
PCT7508	ED	126	106	0	0	7	99	87	12
PCT7508	TO	744	479	0	0	36	443	386	57
PCT7509	MV	756	399	0	0	28	371	318	53
PCT7509	ED	173	148	0	0	9	139	123	16
PCT7509	TO	929	547	0	0	37	510	441	69
PCT7512	MV	475	248	0	0	19	229	193	36
PCT7512	ED	125	86	0	0	7	79	72	7
PCT7512	TO	600	334	0	0	26	308	265	43
PCT7513	MV	575	248	0	0	23	225	207	18
PCT7513	ED	231	112	0	0	16	96	87	9
PCT7513	TO	806	360	0	0	39	321	294	27
PCT7514	MV	709	242	0	0	24	218	177	41
PCT7514	ED	207	61	0	0	11	50	44	6
PCT7514	TO	916	303	0	0	35	268	221	47
PCT7515	MV	663	321	0	0	16	305	253	52
PCT7515	ED	201	90	0	0	12	78	70	8
PCT7515	TO	864	411	0	0	28	383	323	60
PCT7516	MV	773	423	0	0	27	396	338	58
PCT7516	ED	147	118	0	0	6	112	93	19
PCT7516	TO	920	541	0	0	33	508	431	77
PCT7517	MV	645	362	0	0	28	334	296	38
PCT7517	ED	223	179	0	0	12	167	147	20
PCT7517	TO	868	541	0	0	40	501	443	58
PCT7518	MV	708	392	0	0	29	363	314	49
PCT7518	ED	218	186	0	0	11	175	161	14
PCT7518	TO	926	578	0	0	40	538	475	63
PCT7519	MV	543	259	0	0	26	233	212	21
PCT7519	ED	172	136	0	0	5	131	118	13
PCT7519	TO	715	395	0	0	31	364	330	34
PCT7521	MV	597	318	0	1	18	299	270	29
PCT7521	ED	182	149	0	0	4	145	132	13
PCT7521	TO	779	467	0	1	22	444	402	42
PCT7522	MV	588	301	0	0	18	283	254	29
PCT7522	ED	171	159	0	0	15	144	132	12
PCT7522	TO	759	460	0	0	33	427	386	41
PCT7523	MV	564	285	0	0	21	264	244	20
PCT7523	ED	180	169	0	0	9	160	147	13
PCT7523	TO	744	454	0	0	30	424	391	33
PCT7524	MV	480	228	0	0	22	206	192	14
PCT7524	ED	144	102	0	0	6	96	90	6
PCT7524	TO	624	330	0	0	28	302	282	20
PCT7525	MV	594	246	0	1	24	221	203	18
PCT7525	ED	170	96	0	0	11	85	83	2
PCT7525	TO	764	342	0	1	35	306	286	20
PCT7526	MV	826	395	0	0	39	356	331	25
PCT7526	ED	162	149	0	0	14	135	127	8
PCT7526	TO	988	544	0	0	53	491	458	33
PCT7527	MV	538	296	0	0	22	274	244	30
PCT7527	ED	172	113	0	0	4	109	100	9
PCT7527	TO	710	409	0	0	26	383	344	39
PCT7529	MV	749	366	0	0	22	344	321	23
PCT7529	ED	154	187	0	0	8	179	167	12
PCT7529	TO	903	553	0	0	30	523	488	35
PCT7531	MV	714	336	0	0	22	314	293	21
PCT7531	ED	159	135	0	0	4	131	115	16
PCT7531	TO	873	471	0	0	26	445	408	37
PCT7532	MV	668	328	0	0	23	305	280	25
PCT7532	ED	167	139	0	0	12	127	108	19
PCT7532	TO	835	467	0	0	35	432	388	44
PCT7533	MV	776	405	0	0	33	372	336	36
PCT7533	ED	194	189	0	0	14	175	161	14
PCT7533	TO	970	594	0	0	47	547	497	50
PCT7534	MV	670	375	0	0	35	340	297	43
PCT7534	ED	233	187	0	0	16	171	158	13
PCT7534	TO	903	562	0	0	51	511	455	56
PCT7535	MV	606	300	0	0	19	281	251	30
PCT7535	ED	139	162	0	0	15	147	135	12
PCT7535	TO	745	462	0	0	34	428	386	42
PCT7536	MV	670	346	0	0	13	333	294	39
PCT7536	ED	163	172	0	1	14	157	139	18
PCT7536	TO	833	518	0	1	27	490	433	57
PCT7537	MV	619	301	0	0	22	279	256	23
PCT7537	ED	126	150	0	0	11	139	130	9
PCT7537	TO	745	451	0	0	33	418	386	32
PCT7538	MV	562	321	0	0	19	302	282	20
PCT7538	ED	189	175	0	0	11	164	144	20
PCT7538	TO	751	496	0	0	30	466	426	40
PCT7539	MV	696	374	0	0	19	355	332	23
PCT7539	ED	225	195	0	0	13	182	169	13
PCT7539	TO	921	569	0	0	32	537	501	36
PCT7541	MV	600	295	0	0	24	271	244	27
PCT7541	ED	170	164	0	0	12	152	135	17
PCT7541	TO	770	459	0	0	36	423	379	44
PCT7542	MV	632	323	0	0	13	310	277	33
PCT7542	ED	192	171	0	0	7	164	146	18
PCT7542	TO	824	494	0	0	20	474	423	51
PCT7543	MV	694	371	0	0	14	357	319	38
PCT7543	ED	230	141	0	0	10	131	115	16
PCT7543	TO	924	512	0	0	24	488	434	54
PCT7544	MV	731	389	0	0	36	353	320	33
PCT7544	ED	168	164	0	0	10	154	143	11
PCT7544	TO	899	553	0	0	46	507	463	44
PCT7545	MV	723	384	0	0	24	360	324	36
PCT7545	ED	172	149	0	1	12	136	124	12
PCT7545	TO	895	533	0	1	36	496	448	48
PCT7546	MV	770	417	0	0	22	395	365	30
PCT7546	ED	183	219	0	0	18	201	179	22
PCT7546	TO	953	636	0	0	40	596	544	52
PCT7547	MV	798	426	0	0	31	395	370	25
PCT7547	ED	183	180	0	0	13	167	160	7
PCT7547	TO	981	606	0	0	44	562	530	32
PCT7548	MV	802	447	0	0	28	419	379	40
PCT7548	ED	249	204	0	0	11	193	177	16
PCT7548	TO	1051	651	0	0	39	612	556	56
PCT7549	MV	660	357	0	0	26	331	295	36
PCT7549	ED	146	143	0	0	14	129	118	11
PCT7549	TO	806	500	0	0	40	460	413	47
PCT7551	MV	587	303	0	0	15	288	264	24
PCT7551	ED	136	175	0	0	9	166	150	16
PCT7551	TO	723	478	0	0	24	454	414	40
PCT7552	MV	561	285	0	0	22	263	242	21
PCT7552	ED	124	130	0	0	12	118	101	17
PCT7552	TO	685	415	0	0	34	381	343	38
PCT7553	MV	211	95	0	1	5	89	78	11
PCT7553	ED	-20	0	0	0	0	0	0	0
PCT7553	TO	191	95	0	1	5	89	78	11
PCT7554	MV	653	381	0	0	25	356	318	38
PCT7554	ED	168	180	0	0	16	164	148	16
PCT7554	TO	821	561	0	0	41	520	466	54
PCT7555	MV	662	416	0	0	30	386	341	45
PCT7555	ED	210	210	0	0	18	192	174	18
PCT7555	TO	872	626	0	0	48	578	515	63
PCT7556	MV	812	512	0	0	30	482	432	50
PCT7556	ED	154	168	0	0	12	156	130	26
PCT7556	TO	966	680	0	0	42	638	562	76
PCT7601	MV	485	207	0	0	14	193	177	16
PCT7601	ED	192	91	0	1	10	80	69	11
PCT7601	TO	677	298	0	1	24	273	246	27
PCT7602	MV	654	276	0	0	13	263	238	25
PCT7602	ED	232	104	0	0	9	95	86	9
PCT7602	TO	886	380	0	0	22	358	324	34
PCT7603	MV	615	295	0	0	23	272	240	32
PCT7603	ED	200	168	0	0	12	156	138	18
PCT7603	TO	815	463	0	0	35	428	378	50
PCT7604	MV	685	270	0	0	11	259	235	24
PCT7604	ED	259	135	0	0	14	121	104	17
PCT7604	TO	944	405	0	0	25	380	339	41
PCT7605	MV	468	191	0	1	15	175	149	26
PCT7605	ED	193	62	0	0	6	56	52	4
PCT7605	TO	661	253	0	1	21	231	201	30
PCT7606	MV	673	267	0	0	27	240	209	31
PCT7606	ED	210	80	0	0	6	74	65	9
PCT7606	TO	883	347	0	0	33	314	274	40
PCT7607	MV	712	288	0	0	21	267	231	36
PCT7607	ED	207	101	0	0	4	97	86	11
PCT7607	TO	919	389	0	0	25	364	317	47
PCT7608	MV	279	96	0	0	6	90	74	16
PCT7608	ED	101	19	0	0	0	19	18	1
PCT7608	TO	380	115	0	0	6	109	92	17
PCT7609	MV	699	286	0	0	21	265	238	27
PCT7609	ED	185	49	0	1	5	43	37	6
PCT7609	TO	884	335	0	1	26	308	275	33
PCT7611	MV	586	235	0	0	18	217	193	24
PCT7611	ED	202	43	0	0	2	41	37	4
PCT7611	TO	788	278	0	0	20	258	230	28
PCT7612	MV	452	216	0	0	11	205	174	31
PCT7612	ED	105	31	0	0	1	30	21	9
PCT7612	TO	557	247	0	0	12	235	195	40
PCT7613	MV	634	244	0	0	19	225	202	23
PCT7613	ED	249	89	0	0	5	84	77	7
PCT7613	TO	883	333	0	0	24	309	279	30
PCT7614	MV	713	253	0	0	24	229	202	27
PCT7614	ED	203	81	0	0	5	76	60	16
PCT7614	TO	916	334	0	0	29	305	262	43
PCT7615	MV	510	165	0	0	7	158	134	24
PCT7615	ED	240	58	0	0	4	54	46	8
PCT7615	TO	750	223	0	0	11	212	180	32
PCT7616	MV	754	330	0	0	36	294	265	29
PCT7616	ED	82	86	0	0	7	79	73	6
PCT7616	TO	836	416	0	0	43	373	338	35
PCT7617	MV	583	222	0	0	21	201	178	23
PCT7617	ED	169	42	0	0	7	35	28	7
PCT7617	TO	752	264	0	0	28	236	206	30
PCT7618	MV	763	365	0	0	20	345	283	62
PCT7618	ED	151	85	0	0	9	76	66	10
PCT7618	TO	914	450	0	0	29	421	349	72
PCT7619	MV	937	439	0	0	28	411	361	50
PCT7619	ED	170	119	0	0	10	109	97	12
PCT7619	TO	1107	558	0	0	38	520	458	62
PCT7621	MV	1006	443	0	0	29	414	374	40
PCT7621	ED	149	104	0	0	11	93	79	14
PCT7621	TO	1155	547	0	0	40	507	453	54
PCT7622	MV	697	215	0	0	9	206	180	26
PCT7622	ED	263	74	0	0	9	65	60	5
PCT7622	TO	960	289	0	0	18	271	240	31
PCT7623	MV	767	256	0	2	17	237	216	21
PCT7623	ED	237	98	0	0	9	89	81	8
PCT7623	TO	1004	354	0	2	26	326	297	29
PCT7624	MV	652	209	0	0	12	197	178	19
PCT7624	ED	223	73	0	0	11	62	61	1
PCT7624	TO	875	282	0	0	23	259	239	20
PCT7625	MV	749	394	0	2	40	352	299	53
PCT7625	ED	73	34	0	0	1	33	32	1
PCT7625	TO	822	428	0	2	41	385	331	54
PCT7626	MV	944	401	0	0	42	359	309	50
PCT7626	ED	129	108	0	0	5	103	96	7
PCT7626	TO	1073	509	0	0	47	462	405	57
PCT7627	MV	457	196	0	0	18	178	140	38
PCT7627	ED	67	59	0	0	6	53	43	10
PCT7627	TO	524	255	0	0	24	231	183	48
PCT7628	MV	718	331	0	0	16	315	280	35
PCT7628	ED	220	111	0	0	2	109	96	13
PCT7628	TO	938	442	0	0	18	424	376	48
PCT7629	MV	691	276	0	0	22	254	227	27
PCT7629	ED	162	87	0	0	5	82	73	9
PCT7629	TO	853	363	0	0	27	336	300	36
PCT7631	MV	1009	440	0	0	32	408	358	50
PCT7631	ED	210	111	0	0	8	103	90	13
PCT7631	TO	1219	551	0	0	40	511	448	63
PCT7632	MV	1002	413	0	0	20	393	345	48
PCT7632	ED	169	130	0	0	8	122	109	13
PCT7632	TO	1171	543	0	0	28	515	454	61
PCT7633	MV	609	278	0	0	19	259	222	37
PCT7633	ED	126	97	0	0	7	90	83	7
PCT7633	TO	735	375	0	0	26	349	305	44
PCT7634	MV	704	344	0	0	36	308	267	41
PCT7634	ED	186	105	0	0	10	95	83	12
PCT7634	TO	890	449	0	0	46	403	350	53
PCT7635	MV	665	273	0	0	14	259	217	42
PCT7635	ED	188	62	0	0	4	58	49	9
PCT7635	TO	853	335	0	0	18	317	266	51
PCT7636	MV	798	330	0	0	24	306	260	46
PCT7636	ED	161	107	0	0	7	100	81	19
PCT7636	TO	959	437	0	0	31	406	341	65
PCT7637	MV	747	344	0	0	30	314	244	70
PCT7637	ED	121	99	0	0	10	89	77	12
PCT7637	TO	868	443	0	0	40	403	321	82
PCT7638	MV	806	372	0	0	24	348	275	73
PCT7638	ED	83	89	0	0	8	81	57	24
PCT7638	TO	889	461	0	0	32	429	332	97
PCT7639	MV	889	396	0	0	33	363	288	75
PCT7639	ED	133	134	0	0	23	111	94	17
PCT7639	TO	1022	530	0	0	56	474	382	92
PCT7641	MV	817	399	0	0	17	382	304	78
PCT7641	ED	134	93	0	0	4	89	76	13
PCT7641	TO	951	492	0	0	21	471	380	91
PCT7642	MV	647	311	0	0	35	276	248	28
PCT7642	ED	118	82	0	0	15	67	61	6
PCT7642	TO	765	393	0	0	50	343	309	34
PCT7643	MV	810	433	0	1	27	405	331	74
PCT7643	ED	131	106	0	0	10	96	85	11
PCT7643	TO	941	539	0	1	37	501	416	85
PCT7644	MV	1014	403	0	0	35	368	312	56
PCT7644	ED	162	142	0	0	10	132	120	12
PCT7644	TO	1176	545	0	0	45	500	432	68
PCT7645	MV	595	286	0	1	20	265	213	52
PCT7645	ED	61	56	0	0	6	50	43	7
PCT7645	TO	656	342	0	1	26	315	256	59
PCT7646	MV	1032	484	0	0	36	448	381	67
PCT7646	ED	121	134	0	0	17	117	105	12
PCT7646	TO	1153	618	0	0	53	565	486	79
PCT7647	MV	724	210	0	0	10	200	170	30
PCT7647	ED	263	79	0	0	5	74	69	5
PCT7647	TO	987	289	0	0	15	274	239	35
PCT7648	MV	2	1	0	0	0	1	1	0
PCT7648	ED	0	0	0	0	0	0	0	0
PCT7648	TO	2	1	0	0	0	1	1	0
PCT7649	MV	723	286	0	0	12	274	233	41
PCT7649	ED	177	81	0	0	5	76	63	13
PCT7649	TO	900	367	0	0	17	350	296	54
PCT7651	MV	834	332	0	0	23	309	261	48
PCT7651	ED	113	73	0	0	5	68	58	10
PCT7651	TO	947	405	0	0	28	377	319	58
PCT7652	MV	535	207	0	0	15	192	160	32
PCT7652	ED	100	87	0	0	6	81	73	8
PCT7652	TO	635	294	0	0	21	273	233	40
PCT7653	MV	750	334	0	0	33	301	267	34
PCT7653	ED	89	80	0	0	7	73	60	13
PCT7653	TO	839	414	0	0	40	374	327	47
PCT7654	MV	413	191	0	0	11	180	150	30
PCT7654	ED	53	84	0	0	7	77	70	7
PCT7654	TO	466	275	0	0	18	257	220	37
PCT7655	MV	583	215	0	0	8	207	179	28
PCT7655	ED	96	60	0	0	9	51	45	6
PCT7655	TO	679	275	0	0	17	258	224	34
PCT7656	MV	603	308	0	0	23	285	241	44
PCT7656	ED	35	40	0	0	3	37	24	13
PCT7656	TO	638	348	0	0	26	322	265	57
PCT7657	MV	561	269	0	0	22	247	208	39
PCT7657	ED	37	61	0	0	5	56	49	7
PCT7657	TO	598	330	0	0	27	303	257	46
PCT7701	MV	868	481	0	0	37	444	382	62
PCT7701	ED	196	174	0	0	8	166	147	19
PCT7701	TO	1064	655	0	0	45	610	529	81
PCT7702	MV	623	375	0	0	18	357	278	79
PCT7702	ED	133	104	0	0	9	95	75	20
PCT7702	TO	756	479	0	0	27	452	353	99
PCT7703	MV	187	71	0	0	2	69	65	4
PCT7703	ED	-13	0	0	0	0	0	0	0
PCT7703	TO	174	71	0	0	2	69	65	4
PCT7704	MV	798	489	0	0	36	453	339	114
PCT7704	ED	204	173	0	0	2	171	125	46
PCT7704	TO	1002	662	0	0	38	624	464	160
PCT7705	MV	470	285	0	0	15	270	203	67
PCT7705	ED	125	110	0	0	9	101	80	21
PCT7705	TO	595	395	0	0	24	371	283	88
PCT7706	MV	687	447	0	0	24	423	324	99
PCT7706	ED	179	162	0	0	8	154	120	34
PCT7706	TO	866	609	0	0	32	577	444	133
PCT7707	MV	683	432	0	0	23	409	333	76
PCT7707	ED	189	179	0	0	7	172	128	44
PCT7707	TO	872	611	0	0	30	581	461	120
PCT7708	MV	710	461	0	0	34	427	333	94
PCT7708	ED	165	154	0	0	13	141	116	25
PCT7708	TO	875	615	0	0	47	568	449	119
PCT7709	MV	324	193	0	0	9	184	153	31
PCT7709	ED	82	90	0	0	7	83	71	12
PCT7709	TO	406	283	0	0	16	267	224	43
PCT7711	MV	658	379	0	0	21	358	291	67
PCT7711	ED	153	125	0	0	4	121	106	15
PCT7711	TO	811	504	0	0	25	479	397	82
PCT7712	MV	425	258	0	0	11	247	202	45
PCT7712	ED	107	106	0	0	7	99	82	17
PCT7712	TO	532	364	0	0	18	346	284	62
PCT7801	MV	823	478	0	0	22	456	379	77
PCT7801	ED	151	190	0	0	11	179	140	39
PCT7801	TO	974	668	0	0	33	635	519	116
PCT7802	MV	646	401	0	0	27	374	330	44
PCT7802	ED	152	158	0	1	6	151	138	13
PCT7802	TO	798	559	0	1	33	525	468	57
PCT7803	MV	718	476	0	0	28	448	384	64
PCT7803	ED	113	128	0	0	10	118	100	18
PCT7803	TO	831	604	0	0	38	566	484	82
PCT7804	MV	734	463	0	0	46	417	376	41
PCT7804	ED	151	181	0	0	17	164	148	16
PCT7804	TO	885	644	0	0	63	581	524	57
PCT7805	MV	644	399	0	0	38	361	312	49
PCT7805	ED	156	156	0	0	11	145	134	11
PCT7805	TO	800	555	0	0	49	506	446	60
PCT7806	MV	602	361	0	0	23	338	307	31
PCT7806	ED	153	152	0	0	11	141	122	19
PCT7806	TO	755	513	0	0	34	479	429	50
PCT7807	MV	642	361	0	1	16	344	320	24
PCT7807	ED	185	174	0	0	12	162	151	11
PCT7807	TO	827	535	0	1	28	506	471	35
PCT7808	MV	525	296	0	0	21	275	243	32
PCT7808	ED	129	129	0	0	12	117	106	11
PCT7808	TO	654	425	0	0	33	392	349	43
PCT7809	MV	624	351	0	0	22	329	302	27
PCT7809	ED	140	136	0	0	13	123	119	4
PCT7809	TO	764	487	0	0	35	452	421	31
PCT7811	MV	582	311	0	0	23	288	266	22
PCT7811	ED	176	155	0	0	10	145	130	15
PCT7811	TO	758	466	0	0	33	433	396	37
PCT7812	MV	680	369	0	0	23	346	315	31
PCT7812	ED	217	163	0	0	5	158	137	21
PCT7812	TO	897	532	0	0	28	504	452	52
PCT7813	MV	843	483	0	0	21	462	418	44
PCT7813	ED	225	215	0	0	16	199	176	23
PCT7813	TO	1068	698	0	0	37	661	594	67
PCT7814	MV	660	279	0	0	15	264	233	31
PCT7814	ED	241	118	0	0	8	110	102	8
PCT7814	TO	901	397	0	0	23	374	335	39
PCT7815	MV	749	465	0	0	48	417	369	48
PCT7815	ED	168	179	0	0	10	169	155	14
PCT7815	TO	917	644	0	0	58	586	524	62
PCT7816	MV	724	472	0	0	36	436	381	55
PCT7816	ED	148	149	0	0	6	143	121	22
PCT7816	TO	872	621	0	0	42	579	502	77
PCT7817	MV	652	396	0	0	10	386	353	33
PCT7817	ED	186	183	0	1	7	175	155	20
PCT7817	TO	838	579	0	1	17	561	508	53
PCT7818	MV	668	393	0	0	25	368	328	40
PCT7818	ED	171	149	0	0	7	142	133	9
PCT7818	TO	839	542	0	0	32	510	461	49
PCT7819	MV	635	352	0	0	22	330	280	50
PCT7819	ED	139	89	0	0	5	84	79	5
PCT7819	TO	774	441	0	0	27	414	359	55
PCT7821	MV	806	519	0	0	26	493	432	61
PCT7821	ED	170	190	0	0	10	180	162	18
PCT7821	TO	976	709	0	0	36	673	594	79
PCT7822	MV	673	395	0	1	25	369	324	45
PCT7822	ED	219	223	0	0	21	202	167	35
PCT7822	TO	892	618	0	1	46	571	491	80
PCT7823	MV	706	410	0	0	26	384	339	45
PCT7823	ED	177	189	0	0	4	185	168	17
PCT7823	TO	883	599	0	0	30	569	507	62
PCT7824	MV	615	334	0	0	24	310	276	34
PCT7824	ED	153	158	0	0	13	145	133	12
PCT7824	TO	768	492	0	0	37	455	409	46
PCT7825	MV	457	252	0	0	13	239	228	11
PCT7825	ED	151	130	0	0	3	127	111	16
PCT7825	TO	608	382	0	0	16	366	339	27
PCT7826	MV	486	263	0	1	17	245	222	23
PCT7826	ED	204	162	0	0	11	151	139	12
PCT7826	TO	690	425	0	1	28	396	361	35
PCT7827	MV	607	318	0	0	19	299	264	35
PCT7827	ED	219	146	0	0	13	133	123	10
PCT7827	TO	826	464	0	0	32	432	387	45
PCT7828	MV	857	477	0	0	34	443	369	74
PCT7828	ED	171	179	0	0	18	161	138	23
PCT7828	TO	1028	656	0	0	52	604	507	97
PCT7829	MV	742	466	0	0	24	442	371	71
PCT7829	ED	149	151	0	0	4	147	132	15
PCT7829	TO	891	617	0	0	28	589	503	86
PCT7831	MV	763	485	0	0	41	444	384	60
PCT7831	ED	139	138	0	0	7	131	112	19
PCT7831	TO	902	623	0	0	48	575	496	79
PCT7832	MV	663	412	0	0	27	385	343	42
PCT7832	ED	118	127	0	0	7	120	106	14
PCT7832	TO	781	539	0	0	34	505	449	56
PCT7833	MV	587	343	0	0	18	325	293	32
PCT7833	ED	146	145	0	0	15	130	116	14
PCT7833	TO	733	488	0	0	33	455	409	46
PCT7834	MV	700	374	0	0	29	345	320	25
PCT7834	ED	194	177	0	0	12	165	150	15
PCT7834	TO	894	551	0	0	41	510	470	40
PCT7835	MV	721	427	0	0	27	400	327	73
PCT7835	ED	142	147	0	0	10	137	117	20
PCT7835	TO	863	574	0	0	37	537	444	93
PCT7836	MV	850	505	0	0	24	481	413	68
PCT7836	ED	193	170	0	0	6	164	134	30
PCT7836	TO	1043	675	0	0	30	645	547	98
PCT7837	MV	718	424	0	0	40	384	322	62
PCT7837	ED	205	199	0	0	7	192	169	23
PCT7837	TO	923	623	0	0	47	576	491	85
PCT7838	MV	752	492	0	0	34	458	382	76
PCT7838	ED	143	156	0	0	9	147	126	21
PCT7838	TO	895	648	0	0	43	605	508	97
PCT7839	MV	731	456	0	0	32	424	359	65
PCT7839	ED	130	137	0	0	9	128	113	15
PCT7839	TO	861	593	0	0	41	552	472	80
PCT7841	MV	752	457	0	0	31	426	371	55
PCT7841	ED	198	207	0	0	9	198	176	22
PCT7841	TO	950	664	0	0	40	624	547	77
PCT7842	MV	702	393	0	0	24	369	328	41
PCT7842	ED	177	155	0	0	9	146	131	15
PCT7842	TO	879	548	0	0	33	515	459	56
PCT7843	MV	546	295	0	0	13	282	249	33
PCT7843	ED	183	165	0	0	11	154	137	17
PCT7843	TO	729	460	0	0	24	436	386	50
PCT7844	MV	499	281	0	0	25	256	237	19
PCT7844	ED	152	136	0	0	11	125	111	14
PCT7844	TO	651	417	0	0	36	381	348	33
PCT7845	MV	676	405	0	0	24	381	348	33
PCT7845	ED	204	177	0	0	10	167	140	27
PCT7845	TO	880	582	0	0	34	548	488	60
PCT7846	MV	736	463	0	0	35	428	368	60
PCT7846	ED	172	167	0	0	13	154	130	24
PCT7846	TO	908	630	0	0	48	582	498	84
PCT7847	MV	698	427	0	0	31	396	347	49
PCT7847	ED	193	183	0	0	7	176	148	28
PCT7847	TO	891	610	0	0	38	572	495	77
PCT7848	MV	665	437	0	0	23	414	353	61
PCT7848	ED	182	169	0	0	17	152	130	22
PCT7848	TO	847	606	0	0	40	566	483	83
PCT7849	MV	729	441	0	0	32	409	354	55
PCT7849	ED	172	186	0	0	12	174	158	16
PCT7849	TO	901	627	0	0	44	583	512	71
PCT7851	MV	414	272	0	0	21	251	195	56
PCT7851	ED	112	84	0	0	7	77	57	20
PCT7851	TO	526	356	0	0	28	328	252	76
PCT7852	MV	533	350	0	0	25	325	264	61
PCT7852	ED	111	103	0	0	7	96	80	16
PCT7852	TO	644	453	0	0	32	421	344	77
PCT7853	MV	694	394	0	0	27	367	305	62
PCT7853	ED	161	137	0	0	9	128	108	20
PCT7853	TO	855	531	0	0	36	495	413	82
PCT7854	MV	703	430	0	0	26	404	348	56
PCT7854	ED	175	172	0	0	10	162	142	20
PCT7854	TO	878	602	0	0	36	566	490	76
PCT7855	MV	763	450	0	0	35	415	363	52
PCT7855	ED	211	202	0	0	16	186	167	19
PCT7855	TO	974	652	0	0	51	601	530	71
PCT7856	MV	643	372	0	0	21	351	307	44
PCT7856	ED	204	193	0	0	12	181	156	25
PCT7856	TO	847	565	0	0	33	532	463	69
PCT7857	MV	748	435	0	0	33	402	348	54
PCT7857	ED	158	154	0	0	8	146	136	10
PCT7857	TO	906	589	0	0	41	548	484	64
PCT7858	MV	622	349	0	0	20	329	295	34
PCT7858	ED	157	148	0	0	8	140	121	19
PCT7858	TO	779	497	0	0	28	469	416	53
PCT7859	MV	747	464	0	0	32	432	355	77
PCT7859	ED	152	166	0	0	19	147	118	29
PCT7859	TO	899	630	0	0	51	579	473	106
PCT7861	MV	699	431	0	0	23	408	338	70
PCT7861	ED	164	171	0	0	8	163	143	20
PCT7861	TO	863	602	0	0	31	571	481	90
PCT7862	MV	669	400	0	0	21	379	336	43
PCT7862	ED	195	198	0	0	10	188	171	17
PCT7862	TO	864	598	0	0	31	567	507	60
PCT7863	MV	693	371	0	0	24	347	303	44
PCT7863	ED	208	205	0	0	11	194	165	29
PCT7863	TO	901	576	0	0	35	541	468	73
PCT7864	MV	661	374	0	0	30	344	285	59
PCT7864	ED	153	157	0	0	13	144	120	24
PCT7864	TO	814	531	0	0	43	488	405	83
PCT7865	MV	677	408	0	0	32	376	317	59
PCT7865	ED	163	157	0	0	9	148	121	27
PCT7865	TO	840	565	0	0	41	524	438	86
PCT7866	MV	690	446	0	0	16	430	329	101
PCT7866	ED	158	141	0	0	8	133	103	30
PCT7866	TO	848	587	0	0	24	563	432	131
PCT7867	MV	766	470	0	0	21	449	385	64
PCT7867	ED	212	182	0	0	11	171	145	26
PCT7867	TO	978	652	0	0	32	620	530	90
PCT7868	MV	659	374	0	0	17	357	305	52
PCT7868	ED	217	161	0	0	11	150	128	22
PCT7868	TO	876	535	0	0	28	507	433	74
PCT7869	MV	683	440	0	0	26	414	361	53
PCT7869	ED	178	190	0	0	12	178	160	18
PCT7869	TO	861	630	0	0	38	592	521	71
PCT7871	MV	702	463	0	0	37	426	373	53
PCT7871	ED	200	157	0	1	10	146	117	29
PCT7871	TO	902	620	0	1	47	572	490	82
PCT7872	MV	675	420	0	0	26	394	338	56
PCT7872	ED	199	185	0	0	8	177	149	28
PCT7872	TO	874	605	0	0	34	571	487	84
PCT7873	MV	689	444	0	0	29	415	366	49
PCT7873	ED	202	213	0	0	15	198	172	26
PCT7873	TO	891	657	0	0	44	613	538	75
PCT7874	MV	370	189	0	0	8	181	149	32
PCT7874	ED	119	107	0	0	5	102	85	17
PCT7874	TO	489	296	0	0	13	283	234	49
PCT7875	MV	500	252	0	0	16	236	193	43
PCT7875	ED	147	115	0	0	5	110	94	16
PCT7875	TO	647	367	0	0	21	346	287	59
PCT7876	MV	462	256	0	0	18	238	219	19
PCT7876	ED	106	91	0	0	10	81	75	6
PCT7876	TO	568	347	0	0	28	319	294	25
PCT7901	MV	399	191	0	0	9	182	167	15
PCT7901	ED	150	65	0	0	2	63	56	7
PCT7901	TO	549	256	0	0	11	245	223	22
PCT7902	MV	680	290	0	0	14	276	243	33
PCT7902	ED	232	141	0	0	7	134	121	13
PCT7902	TO	912	431	0	0	21	410	364	46
PCT7903	MV	623	284	0	0	20	264	244	20
PCT7903	ED	229	123	0	0	9	114	106	8
PCT7903	TO	852	407	0	0	29	378	350	28
PCT7904	MV	680	297	0	0	20	277	242	35
PCT7904	ED	157	118	0	0	9	109	98	11
PCT7904	TO	837	415	0	0	29	386	340	46
PCT7905	MV	684	356	0	0	19	337	301	36
PCT7905	ED	191	183	0	0	8	175	162	13
PCT7905	TO	875	539	0	0	27	512	463	49
PCT7906	MV	599	283	0	0	17	266	239	27
PCT7906	ED	187	117	0	0	12	105	97	8
PCT7906	TO	786	400	0	0	29	371	336	35
PCT7907	MV	704	343	0	0	18	325	294	31
PCT7907	ED	238	164	0	0	16	148	131	17
PCT7907	TO	942	507	0	0	34	473	425	48
PCT7908	MV	752	365	0	1	21	343	318	25
PCT7908	ED	240	169	0	0	14	155	150	5
PCT7908	TO	992	534	0	1	35	498	468	30
PCT7909	MV	558	310	0	0	18	292	266	26
PCT7909	ED	185	140	0	0	5	135	127	8
PCT7909	TO	743	450	0	0	23	427	393	34
PCT7911	MV	666	320	0	0	22	298	258	40
PCT7911	ED	205	129	0	0	6	123	109	14
PCT7911	TO	871	449	0	0	28	421	367	54
PCT7912	MV	800	370	0	0	22	348	331	17
PCT7912	ED	259	177	0	0	18	159	151	8
PCT7912	TO	1059	547	0	0	40	507	482	25
PCT7913	MV	660	350	0	0	11	339	288	51
PCT7913	ED	263	214	0	0	6	208	187	21
PCT7913	TO	923	564	0	0	17	547	475	72
PCT7914	MV	715	389	0	0	26	363	318	45
PCT7914	ED	187	142	0	0	13	129	109	20
PCT7914	TO	902	531	0	0	39	492	427	65
PCT7915	MV	605	290	0	0	22	268	236	32
PCT7915	ED	238	181	0	0	3	178	161	17
PCT7915	TO	843	471	0	0	25	446	397	49
PCT7916	MV	639	334	0	0	18	316	283	33
PCT7916	ED	219	161	0	0	11	150	142	8
PCT7916	TO	858	495	0	0	29	466	425	41
PCT7917	MV	716	356	0	0	21	335	304	31
PCT7917	ED	271	187	0	0	6	181	170	11
PCT7917	TO	987	543	0	0	27	516	474	42
PCT7918	MV	597	297	0	0	14	283	268	15
PCT7918	ED	227	144	0	0	6	138	124	14
PCT7918	TO	824	441	0	0	20	421	392	29
PCT7919	MV	608	309	0	0	16	293	268	25
PCT7919	ED	258	176	0	0	8	168	158	10
PCT7919	TO	866	485	0	0	24	461	426	35
PCT7921	MV	682	309	0	0	16	293	260	33
PCT7921	ED	229	102	0	0	6	96	85	11
PCT7921	TO	911	411	0	0	22	389	345	44
PCT7922	MV	648	314	0	0	10	304	273	31
PCT7922	ED	210	155	0	0	10	145	133	12
PCT7922	TO	858	469	0	0	20	449	406	43
PCT7923	MV	666	336	0	0	15	321	265	56
PCT7923	ED	214	171	0	0	10	161	143	18
PCT7923	TO	880	507	0	0	25	482	408	74
PCT7924	MV	649	302	0	0	10	292	257	35
PCT7924	ED	202	124	0	0	8	116	104	12
PCT7924	TO	851	426	0	0	18	408	361	47
PCT7925	MV	434	225	0	0	15	210	181	29
PCT7925	ED	110	89	0	0	6	83	75	8
PCT7925	TO	544	314	0	0	21	293	256	37
PCT7926	MV	610	337	0	0	21	316	279	37
PCT7926	ED	178	150	0	0	6	144	123	21
PCT7926	TO	788	487	0	0	27	460	402	58
PCT7927	MV	580	334	0	0	28	306	272	34
PCT7927	ED	162	153	0	0	5	148	132	16
PCT7927	TO	742	487	0	0	33	454	404	50
PCT7928	MV	700	395	0	0	21	374	332	42
PCT7928	ED	217	208	0	0	7	201	181	20
PCT7928	TO	917	603	0	0	28	575	513	62
PCT7929	MV	678	422	0	0	22	400	351	49
PCT7929	ED	169	171	0	0	7	164	147	17
PCT7929	TO	847	593	0	0	29	564	498	66
PCT7931	MV	610	376	0	0	30	346	298	48
PCT7931	ED	141	150	0	0	7	143	126	17
PCT7931	TO	751	526	0	0	37	489	424	65
PCT7932	MV	443	277	0	0	16	261	216	45
PCT7932	ED	118	96	0	0	8	88	77	11
PCT7932	TO	561	373	0	0	24	349	293	56
PCT7933	MV	9	6	0	0	0	6	4	2
PCT7933	ED	-1	0	0	0	0	0	0	0
PCT7933	TO	8	6	0	0	0	6	4	2
PCT7934	MV	702	408	0	0	28	380	349	31
PCT7934	ED	182	155	0	0	17	138	125	13
PCT7934	TO	884	563	0	0	45	518	474	44
PCT7935	MV	716	435	0	0	28	407	358	49
PCT7935	ED	227	225	0	0	13	212	195	17
PCT7935	TO	943	660	0	0	41	619	553	66
PCT7936	MV	620	369	0	0	24	345	304	41
PCT7936	ED	236	220	0	1	10	209	187	22
PCT7936	TO	856	589	0	1	34	554	491	63
PCT7937	MV	698	406	0	0	25	381	341	40
PCT7937	ED	202	171	0	0	7	164	145	19
PCT7937	TO	900	577	0	0	32	545	486	59
PCT7938	MV	536	301	0	0	13	288	253	35
PCT7938	ED	215	121	0	0	7	114	99	15
PCT7938	TO	751	422	0	0	20	402	352	50
PCT7939	MV	481	289	0	0	15	274	247	27
PCT7939	ED	205	191	0	0	11	180	163	17
PCT7939	TO	686	480	0	0	26	454	410	44
PCT7941	MV	576	304	0	0	24	280	243	37
PCT7941	ED	196	171	0	0	9	162	140	22
PCT7941	TO	772	475	0	0	33	442	383	59
PCT7942	MV	658	330	0	0	15	315	271	44
PCT7942	ED	274	141	0	0	4	137	121	16
PCT7942	TO	932	471	0	0	19	452	392	60
PCT7943	MV	687	367	0	0	16	351	287	64
PCT7943	ED	213	156	0	0	12	144	117	27
PCT7943	TO	900	523	0	0	28	495	404	91
PCT7944	MV	584	340	0	0	23	317	277	40
PCT7944	ED	230	196	0	0	12	184	155	29
PCT7944	TO	814	536	0	0	35	501	432	69
PCT7945	MV	726	337	0	0	25	312	271	41
PCT7945	ED	228	83	0	0	8	75	68	7
PCT7945	TO	954	420	0	0	33	387	339	48
PCT7946	MV	779	365	0	0	18	347	235	112
PCT7946	ED	206	115	0	0	7	108	83	25
PCT7946	TO	985	480	0	0	25	455	318	137
PCT7947	MV	792	332	0	0	26	306	196	110
PCT7947	ED	194	94	0	0	4	90	66	24
PCT7947	TO	986	426	0	0	30	396	262	134
PCT7948	MV	730	373	0	0	26	347	231	116
PCT7948	ED	200	119	0	0	4	115	89	26
PCT7948	TO	930	492	0	0	30	462	320	142
PCT7949	MV	484	233	0	0	12	221	138	83
PCT7949	ED	106	56	0	0	6	50	35	15
PCT7949	TO	590	289	0	0	18	271	173	98
PCT7951	MV	731	365	0	0	27	338	217	121
PCT7951	ED	156	90	0	0	4	86	66	20
PCT7951	TO	887	455	0	0	31	424	283	141
PCT7952	MV	730	292	0	0	19	273	169	104
PCT7952	ED	182	86	0	0	7	79	57	22
PCT7952	TO	912	378	0	0	26	352	226	126
PCT7953	MV	669	331	0	0	18	313	218	95
PCT7953	ED	161	106	0	0	4	102	65	37
PCT7953	TO	830	437	0	0	22	415	283	132
PCT7954	MV	0	0	0	0	0	0	0	0
PCT7954	ED	0	0	0	0	0	0	0	0
PCT7954	TO	0	0	0	0	0	0	0	0
PCT7955	MV	774	350	0	0	15	335	227	108
PCT7955	ED	173	98	0	0	11	87	62	25
PCT7955	TO	947	448	0	0	26	422	289	133
PCT7956	MV	699	266	0	0	11	255	169	86
PCT7956	ED	170	39	0	0	2	37	31	6
PCT7956	TO	869	305	0	0	13	292	200	92
PCT7957	MV	538	261	0	0	13	248	191	57
PCT7957	ED	135	85	0	0	6	79	67	12
PCT7957	TO	673	346	0	0	19	327	258	69
PCT7958	MV	320	104	0	0	6	98	75	23
PCT7958	ED	-23	0	0	0	0	0	0	0
PCT7958	TO	297	104	0	0	6	98	75	23
PCT7959	MV	541	230	0	0	18	212	195	17
PCT7959	ED	145	68	0	0	6	62	57	5
PCT7959	TO	686	298	0	0	24	274	252	22
PCT9001	MV	314	100	0	0	3	97	85	12
PCT9001	ED	-30	0	0	0	0	0	0	0
PCT9001	TO	284	100	0	0	3	97	85	12
PCT9101	MV	712	377	0	0	23	354	275	79
PCT9101	ED	201	193	0	0	11	182	151	31
PCT9101	TO	913	570	0	0	34	536	426	110
PCT9102	MV	788	393	0	0	25	368	302	66
PCT9102	ED	204	173	0	1	7	165	137	28
PCT9102	TO	992	566	0	1	32	533	439	94
PCT9103	MV	719	381	0	0	24	357	287	70
PCT9103	ED	238	190	0	0	14	176	136	40
PCT9103	TO	957	571	0	0	38	533	423	110
PCT9104	MV	810	381	0	0	31	350	279	71
PCT9104	ED	220	178	0	0	10	168	141	27
PCT9104	TO	1030	559	0	0	41	518	420	98
PCT9105	MV	719	413	0	0	20	393	318	75
PCT9105	ED	199	221	0	0	17	204	167	37
PCT9105	TO	918	634	0	0	37	597	485	112
PCT9106	MV	748	397	0	0	24	373	303	70
PCT9106	ED	198	223	0	0	20	203	185	18
PCT9106	TO	946	620	0	0	44	576	488	88
PCT9107	MV	636	305	0	0	24	281	237	44
PCT9107	ED	208	165	0	0	16	149	136	13
PCT9107	TO	844	470	0	0	40	430	373	57
PCT9108	MV	610	336	0	0	31	305	256	49
PCT9108	ED	200	140	0	0	9	131	117	14
PCT9108	TO	810	476	0	0	40	436	373	63
PCT9109	MV	672	300	0	0	25	275	227	48
PCT9109	ED	211	196	0	0	8	188	152	36
PCT9109	TO	883	496	0	0	33	463	379	84
PCT9111	MV	639	316	0	0	23	293	249	44
PCT9111	ED	195	169	0	0	14	155	135	20
PCT9111	TO	834	485	0	0	37	448	384	64
PCT9112	MV	742	351	0	0	23	328	268	60
PCT9112	ED	219	204	0	0	14	190	170	20
PCT9112	TO	961	555	0	0	37	518	438	80
PCT9113	MV	796	371	0	0	24	347	273	74
PCT9113	ED	208	241	0	0	21	220	178	42
PCT9113	TO	1004	612	0	0	45	567	451	116
PCT9114	MV	659	290	0	0	16	274	235	39
PCT9114	ED	231	182	0	0	15	167	153	14
PCT9114	TO	890	472	0	0	31	441	388	53
PCT9115	MV	699	322	0	0	26	296	251	45
PCT9115	ED	182	179	0	0	17	162	142	20
PCT9115	TO	881	501	0	0	43	458	393	65
PCT9116	MV	782	345	0	0	18	327	264	63
PCT9116	ED	179	174	0	0	12	162	131	31
PCT9116	TO	961	519	0	0	30	489	395	94
PCT9117	MV	629	326	0	0	16	310	240	70
PCT9117	ED	171	195	0	0	11	184	147	37
PCT9117	TO	800	521	0	0	27	494	387	107
PCT9118	MV	742	340	0	0	26	314	236	78
PCT9118	ED	242	223	0	0	22	201	163	38
PCT9118	TO	984	563	0	0	48	515	399	116
PCT9119	MV	703	387	0	0	22	365	280	85
PCT9119	ED	197	156	0	0	16	140	118	22
PCT9119	TO	900	543	0	0	38	505	398	107
PCT9121	MV	735	335	0	0	18	317	249	68
PCT9121	ED	218	184	0	0	9	175	136	39
PCT9121	TO	953	519	0	0	27	492	385	107
PCT9122	MV	775	364	0	0	23	341	244	97
PCT9122	ED	192	160	0	0	20	140	115	25
PCT9122	TO	967	524	0	0	43	481	359	122
PCT9123	MV	661	319	0	0	20	299	223	76
PCT9123	ED	191	187	0	0	17	170	152	18
PCT9123	TO	852	506	0	0	37	469	375	94
PCT9124	MV	736	351	0	0	14	337	255	82
PCT9124	ED	167	159	0	0	9	150	123	27
PCT9124	TO	903	510	0	0	23	487	378	109
PCT9125	MV	681	358	0	0	17	341	271	70
PCT9125	ED	188	152	0	0	13	139	122	17
PCT9125	TO	869	510	0	0	30	480	393	87
PCT9126	MV	819	385	0	0	21	364	267	97
PCT9126	ED	194	200	0	0	12	188	152	36
PCT9126	TO	1013	585	0	0	33	552	419	133
PCT9127	MV	748	380	0	0	27	353	292	61
PCT9127	ED	223	220	0	0	13	207	169	38
PCT9127	TO	971	600	0	0	40	560	461	99
PCT9128	MV	628	333	0	0	22	311	239	72
PCT9128	ED	190	195	0	0	15	180	155	25
PCT9128	TO	818	528	0	0	37	491	394	97
PCT9129	MV	587	271	0	0	11	260	207	53
PCT9129	ED	151	153	0	0	10	143	125	18
PCT9129	TO	738	424	0	0	21	403	332	71
PCT9131	MV	596	285	0	0	11	274	209	65
PCT9131	ED	138	152	0	0	10	142	118	24
PCT9131	TO	734	437	0	0	21	416	327	89
PCT9132	MV	627	262	0	0	14	248	219	29
PCT9132	ED	194	172	0	0	13	159	138	21
PCT9132	TO	821	434	0	0	27	407	357	50
PCT9133	MV	808	381	0	0	22	359	300	59
PCT9133	ED	209	211	0	0	15	196	162	34
PCT9133	TO	1017	592	0	0	37	555	462	93
PCT9134	MV	736	327	0	0	18	309	227	82
PCT9134	ED	155	103	0	0	9	94	75	19
PCT9134	TO	891	430	0	0	27	403	302	101
PCT9135	MV	640	304	0	0	19	285	231	54
PCT9135	ED	182	154	0	0	10	144	110	34
PCT9135	TO	822	458	0	0	29	429	341	88
PCT9136	MV	706	368	0	0	26	342	270	72
PCT9136	ED	212	162	0	0	18	144	120	24
PCT9136	TO	918	530	0	0	44	486	390	96
PCT9137	MV	806	387	0	0	27	360	280	80
PCT9137	ED	209	175	0	0	10	165	141	24
PCT9137	TO	1015	562	0	0	37	525	421	104
PCT9138	MV	770	398	0	0	23	375	287	88
PCT9138	ED	175	149	0	0	13	136	123	13
PCT9138	TO	945	547	0	0	36	511	410	101
PCT9139	MV	828	422	0	0	26	396	292	104
PCT9139	ED	190	174	0	0	14	160	130	30
PCT9139	TO	1018	596	0	0	40	556	422	134
PCT9141	MV	789	418	0	0	31	387	291	96
PCT9141	ED	184	172	0	0	14	158	130	28
PCT9141	TO	973	590	0	0	45	545	421	124
PCT9142	MV	747	364	0	0	21	343	283	60
PCT9142	ED	239	204	0	0	17	187	157	30
PCT9142	TO	986	568	0	0	38	530	440	90
PCT9143	MV	705	359	0	0	21	338	262	76
PCT9143	ED	209	170	0	0	6	164	128	36
PCT9143	TO	914	529	0	0	27	502	390	112
PCT9144	MV	767	376	0	0	22	354	271	83
PCT9144	ED	203	213	0	0	11	202	180	22
PCT9144	TO	970	589	0	0	33	556	451	105
PCT9145	MV	681	334	0	0	18	316	255	61
PCT9145	ED	194	176	0	0	9	167	133	34
PCT9145	TO	875	510	0	0	27	483	388	95
PCT9146	MV	725	353	0	0	26	327	281	46
PCT9146	ED	160	189	0	0	20	169	138	31
PCT9146	TO	885	542	0	0	46	496	419	77
PCT9147	MV	765	373	0	0	20	353	292	61
PCT9147	ED	225	208	0	0	13	195	164	31
PCT9147	TO	990	581	0	0	33	548	456	92
PCT9148	MV	779	397	0	0	19	378	322	56
PCT9148	ED	235	226	0	0	19	207	179	28
PCT9148	TO	1014	623	0	0	38	585	501	84
PCT9149	MV	813	384	0	0	21	363	297	66
PCT9149	ED	178	248	0	0	14	234	202	32
PCT9149	TO	991	632	0	0	35	597	499	98
PCT9151	MV	693	351	0	0	25	326	282	44
PCT9151	ED	168	114	0	0	5	109	90	19
PCT9151	TO	861	465	0	0	30	435	372	63
PCT9152	MV	550	196	0	0	10	186	161	25
PCT9152	ED	187	142	0	0	9	133	119	14
PCT9152	TO	737	338	0	0	19	319	280	39
PCT9201	MV	785	357	0	0	25	332	307	25
PCT9201	ED	186	226	0	0	10	216	190	26
PCT9201	TO	971	583	0	0	35	548	497	51
PCT9202	MV	819	368	0	0	33	335	292	43
PCT9202	ED	177	223	0	0	17	206	173	33
PCT9202	TO	996	591	0	0	50	541	465	76
PCT9203	MV	847	373	0	0	52	321	246	75
PCT9203	ED	155	188	0	0	23	165	113	52
PCT9203	TO	1002	561	0	0	75	486	359	127
PCT9204	MV	686	309	0	0	30	279	211	68
PCT9204	ED	176	195	0	0	21	174	138	36
PCT9204	TO	862	504	0	0	51	453	349	104
PCT9205	MV	621	288	0	0	36	252	219	33
PCT9205	ED	115	150	0	0	19	131	101	30
PCT9205	TO	736	438	0	0	55	383	320	63
PCT9206	MV	741	350	0	0	22	328	246	82
PCT9206	ED	188	194	0	0	35	159	124	35
PCT9206	TO	929	544	0	0	57	487	370	117
PCT9207	MV	824	369	0	0	29	340	264	76
PCT9207	ED	165	192	0	0	19	173	138	35
PCT9207	TO	989	561	0	0	48	513	402	111
PCT9208	MV	808	357	0	0	26	331	271	60
PCT9208	ED	179	179	0	0	16	163	137	26
PCT9208	TO	987	536	0	0	42	494	408	86
PCT9209	MV	615	275	0	0	23	252	196	56
PCT9209	ED	156	170	0	0	30	140	114	26
PCT9209	TO	771	445	0	0	53	392	310	82
PCT9211	MV	730	314	0	0	31	283	223	60
PCT9211	ED	161	154	0	0	18	136	105	31
PCT9211	TO	891	468	0	0	49	419	328	91
PCT9212	MV	671	284	0	1	24	259	205	54
PCT9212	ED	137	170	0	0	33	137	115	22
PCT9212	TO	808	454	0	1	57	396	320	76
PCT9213	MV	776	349	0	0	35	314	247	67
PCT9213	ED	161	195	0	0	25	170	144	26
PCT9213	TO	937	544	0	0	60	484	391	93
PCT9214	MV	517	236	0	0	16	220	179	41
PCT9214	ED	110	135	0	0	16	119	93	26
PCT9214	TO	627	371	0	0	32	339	272	67
PCT9215	MV	524	246	0	0	15	231	184	47
PCT9215	ED	120	131	0	0	13	118	91	27
PCT9215	TO	644	377	0	0	28	349	275	74
PCT9216	MV	669	264	0	0	31	233	171	62
PCT9216	ED	155	172	0	0	15	157	126	31
PCT9216	TO	824	436	0	0	46	390	297	93
PCT9217	MV	588	268	0	0	11	257	207	50
PCT9217	ED	117	133	0	0	8	125	98	27
PCT9217	TO	705	401	0	0	19	382	305	77
PCT9218	MV	652	278	0	0	26	252	191	61
PCT9218	ED	164	158	0	0	12	146	119	27
PCT9218	TO	816	436	0	0	38	398	310	88
PCT9219	MV	646	288	0	0	28	260	228	32
PCT9219	ED	144	168	0	0	19	149	121	28
PCT9219	TO	790	456	0	0	47	409	349	60
PCT9221	MV	562	322	0	0	19	303	220	83
PCT9221	ED	89	140	0	0	14	126	100	26
PCT9221	TO	651	462	0	0	33	429	320	109
PCT9222	MV	773	373	0	0	29	344	277	67
PCT9222	ED	137	174	0	0	21	153	120	33
PCT9222	TO	910	547	0	0	50	497	397	100
PCT9223	MV	558	266	0	0	16	250	197	53
PCT9223	ED	109	113	0	0	11	102	76	26
PCT9223	TO	667	379	0	0	27	352	273	79
PCT9224	MV	768	380	0	0	25	355	286	69
PCT9224	ED	181	166	0	0	18	148	114	34
PCT9224	TO	949	546	0	0	43	503	400	103
PCT9225	MV	757	303	0	0	19	284	234	50
PCT9225	ED	169	219	0	0	24	195	166	29
PCT9225	TO	926	522	0	0	43	479	400	79
PCT9226	MV	741	355	0	0	36	319	276	43
PCT9226	ED	155	148	0	0	10	138	120	18
PCT9226	TO	896	503	0	0	46	457	396	61
PCT9227	MV	605	371	0	0	26	345	263	82
PCT9227	ED	124	149	0	0	6	143	114	29
PCT9227	TO	729	520	0	0	32	488	377	111
PCT9228	MV	578	314	0	3	19	292	219	73
PCT9228	ED	160	179	0	0	13	166	141	25
PCT9228	TO	738	493	0	3	32	458	360	98
PCT9229	MV	460	257	0	0	21	236	205	31
PCT9229	ED	119	122	0	0	7	115	98	17
PCT9229	TO	579	379	0	0	28	351	303	48
PCT9231	MV	726	352	0	0	21	331	267	64
PCT9231	ED	236	255	0	0	18	237	203	34
PCT9231	TO	962	607	0	0	39	568	470	98
PCT9232	MV	608	293	0	0	25	268	207	61
PCT9232	ED	126	155	0	0	12	143	110	33
PCT9232	TO	734	448	0	0	37	411	317	94
PCT9233	MV	668	330	0	0	28	302	230	72
PCT9233	ED	150	186	0	0	24	162	136	26
PCT9233	TO	818	516	0	0	52	464	366	98
PCT9234	MV	643	319	0	0	19	300	236	64
PCT9234	ED	91	144	0	0	19	125	99	26
PCT9234	TO	734	463	0	0	38	425	335	90
PCT9235	MV	703	365	0	0	26	339	243	96
PCT9235	ED	160	194	0	0	16	178	144	34
PCT9235	TO	863	559	0	0	42	517	387	130
PCT9236	MV	537	282	0	0	20	262	220	42
PCT9236	ED	136	137	0	0	18	119	97	22
PCT9236	TO	673	419	0	0	38	381	317	64
PCT9237	MV	779	395	0	0	27	368	293	75
PCT9237	ED	118	182	0	0	14	168	142	26
PCT9237	TO	897	577	0	0	41	536	435	101
PCT9238	MV	687	330	0	0	35	295	246	49
PCT9238	ED	118	174	0	0	27	147	127	20
PCT9238	TO	805	504	0	0	62	442	373	69
PCT9239	MV	740	390	0	0	41	349	291	58
PCT9239	ED	124	157	0	0	18	139	120	19
PCT9239	TO	864	547	0	0	59	488	411	77
PCT9241	MV	819	403	0	0	31	372	305	67
PCT9241	ED	141	195	0	0	18	177	157	20
PCT9241	TO	960	598	0	0	49	549	462	87
PCT9242	MV	771	348	0	0	36	312	262	50
PCT9242	ED	172	213	0	0	29	184	157	27
PCT9242	TO	943	561	0	0	65	496	419	77
PCT9243	MV	480	241	0	0	23	218	182	36
PCT9243	ED	123	138	0	0	17	121	104	17
PCT9243	TO	603	379	0	0	40	339	286	53
PCT9244	MV	756	394	0	0	42	352	299	53
PCT9244	ED	154	182	0	0	14	168	144	24
PCT9244	TO	910	576	0	0	56	520	443	77
PCT9245	MV	616	300	0	0	29	271	223	48
PCT9245	ED	98	127	0	0	16	111	88	23
PCT9245	TO	714	427	0	0	45	382	311	71
PCT9246	MV	815	430	0	0	31	399	319	80
PCT9246	ED	155	194	0	0	19	175	152	23
PCT9246	TO	970	624	0	0	50	574	471	103
PCT9247	MV	764	380	0	0	23	357	295	62
PCT9247	ED	148	204	0	0	25	179	151	28
PCT9247	TO	912	584	0	0	48	536	446	90
PCT9248	MV	757	358	0	0	29	329	287	42
PCT9248	ED	150	190	0	0	19	171	152	19
PCT9248	TO	907	548	0	0	48	500	439	61
PCT9249	MV	724	379	0	0	29	350	302	48
PCT9249	ED	191	213	0	0	16	197	160	37
PCT9249	TO	915	592	0	0	45	547	462	85
PCT9251	MV	792	392	0	0	28	364	304	60
PCT9251	ED	174	235	0	0	17	218	176	42
PCT9251	TO	966	627	0	0	45	582	480	102
PCT9252	MV	811	381	0	0	27	354	283	71
PCT9252	ED	142	175	0	0	16	159	135	24
PCT9252	TO	953	556	0	0	43	513	418	95
PCT9253	MV	599	300	0	0	16	284	239	45
PCT9253	ED	162	148	0	0	12	136	116	20
PCT9253	TO	761	448	0	0	28	420	355	65
PCT9254	MV	758	414	0	0	24	390	325	65
PCT9254	ED	163	181	0	0	23	158	138	20
PCT9254	TO	921	595	0	0	47	548	463	85
PCT9255	MV	436	196	0	0	20	176	153	23
PCT9255	ED	114	133	0	0	13	120	100	20
PCT9255	TO	550	329	0	0	33	296	253	43
PCT9256	MV	367	169	0	0	9	160	135	25
PCT9256	ED	95	114	0	0	9	105	92	13
PCT9256	TO	462	283	0	0	18	265	227	38
PCT9257	MV	359	161	0	0	14	147	129	18
PCT9257	ED	-39	6	0	0	2	4	4	0
PCT9257	TO	320	167	0	0	16	151	133	18
PCT9258	MV	583	306	0	0	29	277	229	48
PCT9258	ED	120	145	0	0	9	136	127	9
PCT9258	TO	703	451	0	0	38	413	356	57
PCT9401	MV	796	358	0	0	21	337	289	48
PCT9401	ED	242	177	0	0	11	166	150	16
PCT9401	TO	1038	535	0	0	32	503	439	64
PCT9402	MV	775	377	0	0	15	362	295	67
PCT9402	ED	242	159	0	0	11	148	126	22
PCT9402	TO	1017	536	0	0	26	510	421	89
PCT9403	MV	731	346	0	0	13	333	254	79
PCT9403	ED	190	126	0	0	8	118	110	8
PCT9403	TO	921	472	0	0	21	451	364	87
PCT9404	MV	753	345	0	0	20	325	247	78
PCT9404	ED	191	155	0	0	8	147	118	29
PCT9404	TO	944	500	0	0	28	472	365	107
PCT9405	MV	629	276	0	0	19	257	192	65
PCT9405	ED	151	104	0	0	5	99	76	23
PCT9405	TO	780	380	0	0	24	356	268	88
PCT9406	MV	695	327	0	0	20	307	232	75
PCT9406	ED	188	152	0	0	6	146	112	34
PCT9406	TO	883	479	0	0	26	453	344	109
PCT9407	MV	712	368	0	0	16	352	294	58
PCT9407	ED	201	132	0	0	13	119	97	22
PCT9407	TO	913	500	0	0	29	471	391	80
PCT9408	MV	711	321	0	0	24	297	263	34
PCT9408	ED	152	126	0	0	9	117	104	13
PCT9408	TO	863	447	0	0	33	414	367	47
PCT9409	MV	443	226	0	0	19	207	179	28
PCT9409	ED	158	127	0	0	5	122	109	13
PCT9409	TO	601	353	0	0	24	329	288	41
PCT9411	MV	816	376	0	0	24	352	300	52
PCT9411	ED	191	135	0	0	7	128	109	19
PCT9411	TO	1007	511	0	0	31	480	409	71
PCT9412	MV	668	339	0	0	16	323	240	83
PCT9412	ED	202	139	0	0	9	130	106	24
PCT9412	TO	870	478	0	0	25	453	346	107
PCT9413	MV	757	375	0	0	24	351	260	91
PCT9413	ED	179	127	0	0	6	121	99	22
PCT9413	TO	936	502	0	0	30	472	359	113
PCT9414	MV	734	360	0	1	24	335	247	88
PCT9414	ED	186	108	0	0	6	102	86	16
PCT9414	TO	920	468	0	1	30	437	333	104
PCT9415	MV	634	314	0	0	16	298	232	66
PCT9415	ED	154	98	0	0	6	92	80	12
PCT9415	TO	788	412	0	0	22	390	312	78
PCT9416	MV	769	391	0	0	31	360	273	87
PCT9416	ED	230	143	0	0	4	139	111	28
PCT9416	TO	999	534	0	0	35	499	384	115
PCT9417	MV	629	321	0	0	15	306	222	84
PCT9417	ED	145	110	0	0	4	106	80	26
PCT9417	TO	774	431	0	0	19	412	302	110
PCT9418	MV	631	310	0	0	25	285	201	84
PCT9418	ED	188	122	0	0	7	115	81	34
PCT9418	TO	819	432	0	0	32	400	282	118
PCT9419	MV	736	369	0	0	19	350	251	99
PCT9419	ED	173	108	0	0	8	100	70	30
PCT9419	TO	909	477	0	0	27	450	321	129
PCT9421	MV	752	338	0	0	21	317	214	103
PCT9421	ED	173	112	0	0	6	106	76	30
PCT9421	TO	925	450	0	0	27	423	290	133
PCT9422	MV	831	412	0	0	25	387	283	104
PCT9422	ED	270	148	0	0	8	140	116	24
PCT9422	TO	1101	560	0	0	33	527	399	128
PCT9423	MV	714	316	0	0	22	294	210	84
PCT9423	ED	190	121	0	0	9	112	90	22
PCT9423	TO	904	437	0	0	31	406	300	106
PCT9424	MV	799	384	0	0	18	366	258	108
PCT9424	ED	210	116	0	0	7	109	84	25
PCT9424	TO	1009	500	0	0	25	475	342	133
PCT9425	MV	789	346	0	0	23	323	236	87
PCT9425	ED	187	115	0	0	7	108	84	24
PCT9425	TO	976	461	0	0	30	431	320	111
PCT9426	MV	697	323	0	0	21	302	213	89
PCT9426	ED	156	104	0	0	11	93	64	29
PCT9426	TO	853	427	0	0	32	395	277	118
PCT9427	MV	799	381	0	0	18	363	227	136
PCT9427	ED	188	115	0	0	14	101	74	27
PCT9427	TO	987	496	0	0	32	464	301	163
PCT9428	MV	811	351	0	0	25	326	240	86
PCT9428	ED	179	115	0	0	8	107	88	19
PCT9428	TO	990	466	0	0	33	433	328	105
PCT9429	MV	709	343	0	1	20	322	220	102
PCT9429	ED	197	124	0	0	13	111	85	26
PCT9429	TO	906	467	0	1	33	433	305	128
PCT9431	MV	832	411	0	0	35	376	246	130
PCT9431	ED	204	125	0	0	5	120	90	30
PCT9431	TO	1036	536	0	0	40	496	336	160
PCT9432	MV	743	358	0	0	30	328	243	85
PCT9432	ED	215	118	0	0	7	111	89	22
PCT9432	TO	958	476	0	0	37	439	332	107
PCT9433	MV	794	373	0	0	28	345	225	120
PCT9433	ED	164	95	0	0	3	92	64	28
PCT9433	TO	958	468	0	0	31	437	289	148
PCT9434	MV	785	387	0	0	27	360	268	92
PCT9434	ED	227	163	0	0	18	145	120	25
PCT9434	TO	1012	550	0	0	45	505	388	117
PCT9435	MV	779	366	0	0	15	351	246	105
PCT9435	ED	225	158	0	0	7	151	110	41
PCT9435	TO	1004	524	0	0	22	502	356	146
PCT9436	MV	842	386	0	0	15	371	263	108
PCT9436	ED	226	129	0	0	10	119	89	30
PCT9436	TO	1068	515	0	0	25	490	352	138
PCT9437	MV	736	376	0	0	20	356	243	113
PCT9437	ED	191	130	0	0	3	127	98	29
PCT9437	TO	927	506	0	0	23	483	341	142
PCT9438	MV	837	416	0	0	23	393	270	123
PCT9438	ED	152	84	0	0	6	78	56	22
PCT9438	TO	989	500	0	0	29	471	326	145
PCT9439	MV	718	343	0	0	19	324	233	91
PCT9439	ED	199	112	0	0	9	103	77	26
PCT9439	TO	917	455	0	0	28	427	310	117
PCT9441	MV	778	396	0	0	25	371	265	106
PCT9441	ED	193	125	0	0	14	111	87	24
PCT9441	TO	971	521	0	0	39	482	352	130
PCT9442	MV	830	378	0	0	34	344	224	120
PCT9442	ED	210	159	0	0	9	150	118	32
PCT9442	TO	1040	537	0	0	43	494	342	152
PCT9443	MV	759	362	0	1	18	343	262	81
PCT9443	ED	196	109	0	0	4	105	79	26
PCT9443	TO	955	471	0	1	22	448	341	107
PCT9444	MV	768	340	0	0	15	325	219	106
PCT9444	ED	197	94	0	0	6	88	71	17
PCT9444	TO	965	434	0	0	21	413	290	123
PCT9445	MV	829	405	0	0	26	379	277	102
PCT9445	ED	167	114	0	0	8	106	82	24
PCT9445	TO	996	519	0	0	34	485	359	126
PCT9446	MV	900	465	0	0	29	436	287	149
PCT9446	ED	216	146	0	0	12	134	109	25
PCT9446	TO	1116	611	0	0	41	570	396	174
PCT9447	MV	729	392	0	0	19	373	261	112
PCT9447	ED	192	146	0	0	11	135	109	26
PCT9447	TO	921	538	0	0	30	508	370	138
PCT9448	MV	742	346	0	0	18	328	225	103
PCT9448	ED	198	128	0	0	7	121	102	19
PCT9448	TO	940	474	0	0	25	449	327	122
PCT9449	MV	719	340	0	0	19	321	204	117
PCT9449	ED	162	98	0	0	5	93	71	22
PCT9449	TO	881	438	0	0	24	414	275	139
PCT9451	MV	353	178	0	0	7	171	111	60
PCT9451	ED	88	55	0	0	4	51	38	13
PCT9451	TO	441	233	0	0	11	222	149	73
PCT9452	MV	647	334	0	0	18	316	226	90
PCT9452	ED	195	134	0	0	7	127	87	40
PCT9452	TO	842	468	0	0	25	443	313	130
PCT9453	MV	409	217	0	0	9	208	138	70
PCT9453	ED	115	70	0	0	5	65	48	17
PCT9453	TO	524	287	0	0	14	273	186	87
PCT9501	MV	158	92	0	2	7	83	67	16
PCT9501	ED	-8	2	0	0	1	1	1	0
PCT9501	TO	150	94	0	2	8	84	68	16
PCT9502	MV	294	136	0	0	9	127	110	17
PCT9502	ED	-43	2	0	0	0	2	2	0
PCT9502	TO	251	138	0	0	9	129	112	17
PCT9503	MV	550	260	0	0	28	232	214	18
PCT9503	ED	150	83	0	0	5	78	74	4
PCT9503	TO	700	343	0	0	33	310	288	22
PCT9505	MV	589	296	0	0	25	271	234	37
PCT9505	ED	176	113	0	0	7	106	95	11
PCT9505	TO	765	409	0	0	32	377	329	48
PCT9506	MV	547	232	0	0	15	217	196	21
PCT9506	ED	207	132	0	0	9	123	112	11
PCT9506	TO	754	364	0	0	24	340	308	32
PCT9507	MV	556	305	0	0	20	285	259	26
PCT9507	ED	160	155	0	0	14	141	124	17
PCT9507	TO	716	460	0	0	34	426	383	43
PCT9508	MV	632	317	0	0	20	297	276	21
PCT9508	ED	148	141	0	0	12	129	119	10
PCT9508	TO	780	458	0	0	32	426	395	31
PCT9509	MV	585	296	0	0	21	275	248	27
PCT9509	ED	142	134	0	0	9	125	119	6
PCT9509	TO	727	430	0	0	30	400	367	33
PCT9511	MV	458	240	0	0	16	224	198	26
PCT9511	ED	176	122	0	0	7	115	99	16
PCT9511	TO	634	362	0	0	23	339	297	42
PCT9512	MV	617	327	0	1	17	309	274	35
PCT9512	ED	160	136	0	0	3	133	123	10
PCT9512	TO	777	463	0	1	20	442	397	45
PCT9513	MV	686	334	0	0	23	311	295	16
PCT9513	ED	191	133	0	0	7	126	116	10
PCT9513	TO	877	467	0	0	30	437	411	26
PCT9514	MV	713	352	0	0	31	321	287	34
PCT9514	ED	183	172	0	0	14	158	144	14
PCT9514	TO	896	524	0	0	45	479	431	48
PCT9515	MV	543	304	0	0	20	284	244	40
PCT9515	ED	169	135	0	0	13	122	104	18
PCT9515	TO	712	439	0	0	33	406	348	58
PCT9516	MV	705	366	0	0	22	344	299	45
PCT9516	ED	184	158	0	0	7	151	118	33
PCT9516	TO	889	524	0	0	29	495	417	78
PCT9517	MV	626	335	0	0	25	310	281	29
PCT9517	ED	162	137	0	0	15	122	105	17
PCT9517	TO	788	472	0	0	40	432	386	46
PCT9518	MV	642	315	0	0	25	290	266	24
PCT9518	ED	146	149	0	0	6	143	128	15
PCT9518	TO	788	464	0	0	31	433	394	39
PCT9519	MV	693	368	0	0	17	351	313	38
PCT9519	ED	198	170	0	0	16	154	135	19
PCT9519	TO	891	538	0	0	33	505	448	57
PCT9521	MV	687	352	0	0	25	327	293	34
PCT9521	ED	214	193	0	0	12	181	164	17
PCT9521	TO	901	545	0	0	37	508	457	51
PCT9701	MV	498	269	0	0	19	250	201	49
PCT9701	ED	156	135	0	0	4	131	117	14
PCT9701	TO	654	404	0	0	23	381	318	63
PCT9702	MV	554	305	0	0	14	291	244	47
PCT9702	ED	166	148	0	0	3	145	126	19
PCT9702	TO	720	453	0	0	17	436	370	66
PCT9703	MV	809	403	0	0	30	373	261	112
PCT9703	ED	182	143	0	0	7	136	108	28
PCT9703	TO	991	546	0	0	37	509	369	140
PCT9704	MV	760	422	0	0	31	391	306	85
PCT9704	ED	199	197	0	0	12	185	154	31
PCT9704	TO	959	619	0	0	43	576	460	116
PCT9705	MV	754	421	0	0	29	392	319	73
PCT9705	ED	175	144	0	0	9	135	121	14
PCT9705	TO	929	565	0	0	38	527	440	87
PCT9706	MV	57	34	0	0	1	33	33	0
PCT9706	ED	-8	0	0	0	0	0	0	0
PCT9706	TO	49	34	0	0	1	33	33	0
PCT9707	MV	687	358	0	0	19	339	233	106
PCT9707	ED	139	102	0	0	7	95	73	22
PCT9707	TO	826	460	0	0	26	434	306	128
PCT9708	MV	786	429	0	0	40	389	315	74
PCT9708	ED	175	158	0	0	5	153	128	25
PCT9708	TO	961	587	0	0	45	542	443	99
PCT9709	MV	831	427	0	1	35	391	278	113
PCT9709	ED	209	181	0	0	5	176	128	48
PCT9709	TO	1040	608	0	1	40	567	406	161
PCT9711	MV	502	307	0	0	16	291	224	67
PCT9711	ED	144	139	0	0	6	133	97	36
PCT9711	TO	646	446	0	0	22	424	321	103
PCT9712	MV	534	335	0	0	23	312	229	83
PCT9712	ED	127	117	0	0	1	116	86	30
PCT9712	TO	661	452	0	0	24	428	315	113
PCT9713	MV	747	389	0	0	21	368	254	114
PCT9713	ED	203	137	0	0	9	128	85	43
PCT9713	TO	950	526	0	0	30	496	339	157
PCT9714	MV	795	446	0	0	31	415	291	124
PCT9714	ED	156	133	0	0	4	129	94	35
PCT9714	TO	951	579	0	0	35	544	385	159
PCT9715	MV	449	241	0	0	11	230	165	65
PCT9715	ED	130	134	0	0	4	130	101	29
PCT9715	TO	579	375	0	0	15	360	266	94
PCT9716	MV	745	398	0	0	21	377	282	95
PCT9716	ED	221	164	0	0	12	152	116	36
PCT9716	TO	966	562	0	0	33	529	398	131
PCT9717	MV	753	436	0	0	20	416	321	95
PCT9717	ED	224	145	0	0	8	137	103	34
PCT9717	TO	977	581	0	0	28	553	424	129
PCT9718	MV	749	449	0	0	24	425	334	91
PCT9718	ED	152	144	0	0	4	140	104	36
PCT9718	TO	901	593	0	0	28	565	438	127
PCT9719	MV	747	461	0	1	25	435	327	108
PCT9719	ED	173	151	0	0	6	145	108	37
PCT9719	TO	920	612	0	1	31	580	435	145
PCT9721	MV	498	288	0	0	16	272	202	70
PCT9721	ED	164	133	0	1	4	128	95	33
PCT9721	TO	662	421	0	1	20	400	297	103
PCT9722	MV	513	315	0	0	19	296	224	72
PCT9722	ED	84	76	0	0	5	71	57	14
PCT9722	TO	597	391	0	0	24	367	281	86
PCT9723	MV	436	223	0	0	9	214	111	103
PCT9723	ED	72	44	0	0	4	40	24	16
PCT9723	TO	508	267	0	0	13	254	135	119
PCT9724	MV	851	451	0	0	24	427	246	181
PCT9724	ED	169	99	0	1	4	94	65	29
PCT9724	TO	1020	550	0	1	28	521	311	210
PCT9725	MV	814	436	0	0	24	412	259	153
PCT9725	ED	157	96	0	0	7	89	54	35
PCT9725	TO	971	532	0	0	31	501	313	188
PCT9726	MV	630	216	0	0	18	198	169	29
PCT9726	ED	-14	102	0	0	6	96	83	13
PCT9726	TO	616	318	0	0	24	294	252	42
PCT9727	MV	404	227	0	2	12	213	151	62
PCT9727	ED	56	33	0	0	2	31	22	9
PCT9727	TO	460	260	0	2	14	244	173	71
PCT9728	MV	751	446	0	0	21	425	289	136
PCT9728	ED	212	137	0	0	8	129	91	38
PCT9728	TO	963	583	0	0	29	554	380	174
PCT9729	MV	654	335	0	0	18	317	215	102
PCT9729	ED	164	129	0	0	5	124	91	33
PCT9729	TO	818	464	0	0	23	441	306	135
PCT9731	MV	436	245	0	0	12	233	161	72
PCT9731	ED	143	111	0	0	3	108	82	26
PCT9731	TO	579	356	0	0	15	341	243	98
PCT9732	MV	78	47	0	0	5	42	29	13
PCT9732	ED	-5	0	0	0	0	0	0	0
PCT9732	TO	73	47	0	0	5	42	29	13
PCT9733	MV	261	161	0	0	3	158	137	21
PCT9733	ED	-21	0	0	0	0	0	0	0
PCT9733	TO	240	161	0	0	3	158	137	21
PCT9734	MV	473	285	0	0	16	269	194	75
PCT9734	ED	131	109	0	0	2	107	78	29
PCT9734	TO	604	394	0	0	18	376	272	104
PCT9735	MV	650	386	0	2	23	361	269	92
PCT9735	ED	170	133	0	0	18	115	90	25
PCT9735	TO	820	519	0	2	41	476	359	117
PCT9736	MV	586	323	0	0	18	305	228	77
PCT9736	ED	150	153	0	0	10	143	114	29
PCT9736	TO	736	476	0	0	28	448	342	106
PCT9737	MV	637	387	0	0	20	367	264	103
PCT9737	ED	154	135	0	0	5	130	109	21
PCT9737	TO	791	522	0	0	25	497	373	124
PCT9738	MV	688	319	0	0	23	296	243	53
PCT9738	ED	150	64	0	0	5	59	49	10
PCT9738	TO	838	383	0	0	28	355	292	63
PCT9739	MV	674	270	0	0	10	260	235	25
PCT9739	ED	115	88	0	0	2	86	82	4
PCT9739	TO	789	358	0	0	12	346	317	29
PCT9741	MV	837	173	0	0	15	158	149	9
PCT9741	ED	-396	10	0	0	2	8	8	0
PCT9741	TO	441	183	0	0	17	166	157	9
PCT9742	MV	530	229	0	0	6	223	148	75
PCT9742	ED	165	99	0	0	4	95	73	22
PCT9742	TO	695	328	0	0	10	318	221	97
PCT9743	MV	913	400	0	0	21	379	315	64
PCT9743	ED	227	170	0	0	13	157	139	18
PCT9743	TO	1140	570	0	0	34	536	454	82
PCT9744	MV	783	333	0	0	24	309	264	45
PCT9744	ED	160	123	0	0	12	111	96	15
PCT9744	TO	943	456	0	0	36	420	360	60
PCT9745	MV	790	317	0	0	22	295	263	32
PCT9745	ED	202	128	0	0	11	117	111	6
PCT9745	TO	992	445	0	0	33	412	374	38
PCT9746	MV	714	373	0	0	10	363	266	97
PCT9746	ED	189	119	0	0	7	112	89	23
PCT9746	TO	903	492	0	0	17	475	355	120
PCT9747	MV	772	401	0	0	18	383	280	103
PCT9747	ED	204	145	0	0	11	134	107	27
PCT9747	TO	976	546	0	0	29	517	387	130
PCT9748	MV	746	425	0	0	25	400	318	82
PCT9748	ED	167	116	0	0	6	110	81	29
PCT9748	TO	913	541	0	0	31	510	399	111
PCT9749	MV	750	289	0	0	11	278	218	60
PCT9749	ED	188	108	0	0	2	106	83	23
PCT9749	TO	938	397	0	0	13	384	301	83
PCT9751	MV	857	472	0	0	31	441	329	112
PCT9751	ED	214	153	0	0	15	138	106	32
PCT9751	TO	1071	625	0	0	46	579	435	144
PCT9752	MV	563	327	0	0	19	308	222	86
PCT9752	ED	134	108	0	0	4	104	80	24
PCT9752	TO	697	435	0	0	23	412	302	110
PCT9753	MV	617	298	0	0	13	285	228	57
PCT9753	ED	145	123	0	0	1	122	101	21
PCT9753	TO	762	421	0	0	14	407	329	78
PCT9754	MV	545	317	0	2	17	298	253	45
PCT9754	ED	162	113	0	0	6	107	93	14
PCT9754	TO	707	430	0	2	23	405	346	59
PCT9755	MV	441	238	0	0	16	222	174	48
PCT9755	ED	139	99	0	0	3	96	75	21
PCT9755	TO	580	337	0	0	19	318	249	69
PCT9756	MV	805	364	0	0	27	337	220	117
PCT9756	ED	162	106	0	0	6	100	78	22
PCT9756	TO	967	470	0	0	33	437	298	139
PCT9801	MV	320	163	0	0	12	151	119	32
PCT9801	ED	88	52	0	0	4	48	42	6
PCT9801	TO	408	215	0	0	16	199	161	38
PCT9900	MV	0	0	0	0	0	0	0	0
PCT9900	ED	0	0	0	0	0	0	0	0
PCT9900	TO	0	0	0	0	0	0	0	0
PCT9901	MV	0	0	0	0	0	0	0	0
PCT9901	ED	0	0	0	0	0	0	0	0
PCT9901	TO	0	0	0	0	0	0	0	0
PCT9902	MV	0	0	0	0	0	0	0	0
PCT9902	ED	0	0	0	0	0	0	0	0
PCT9902	TO	0	0	0	0	0	0	0	0
CONG12	MV	355594	174452	0	31	11724	162697	134194	28503
CONG12	ED	90254	71265	0	11	5313	65941	56269	9672
CONG12	TO	445848	245717	0	42	17037	228638	190463	38175
CONG14	MV	47252	22340	0	9	1200	21131	15547	5584
CONG14	ED	10799	6956	0	3	395	6558	5216	1342
CONG14	TO	58051	29296	0	12	1595	27689	20763	6926
ASSM17	MV	232787	114347	0	20	7664	106663	90063	16600
ASSM17	ED	59635	43919	0	10	3164	40745	35435	5310
ASSM17	TO	292422	158266	0	30	10828	147408	125498	21910
ASSM19	MV	170059	82445	0	20	5260	77165	59678	17487
ASSM19	ED	41418	34302	0	4	2544	31754	26050	5704
ASSM19	TO	211477	116747	0	24	7804	108919	85728	23191
SUPV1	MV	33868	16565	0	0	1020	15545	12427	3118
SUPV1	ED	9248	8530	0	1	622	7907	6648	1259
SUPV1	TO	43116	25095	0	1	1642	23452	19075	4377
SUPV2	MV	41435	19971	0	4	1623	18344	14929	3415
SUPV2	ED	8611	10149	0	0	1040	9109	7557	1552
SUPV2	TO	50046	30120	0	4	2663	27453	22486	4967
SUPV3	MV	31943	14408	0	3	1099	13306	11008	2298
SUPV3	ED	7434	6360	0	2	573	5785	5030	755
SUPV3	TO	39377	20768	0	5	1672	19091	16038	3053
SUPV4	MV	35049	16862	0	3	1003	15856	11508	4348
SUPV4	ED	9045	5910	0	0	376	5534	4379	1155
SUPV4	TO	44094	22772	0	3	1379	21390	15887	5503
SUPV5	MV	41966	21496	0	6	1522	19968	17846	2122
SUPV5	ED	10934	9272	0	2	681	8589	7715	874
SUPV5	TO	52900	30768	0	8	2203	28557	25561	2996
SUPV6	MV	35755	15225	0	7	1099	14119	12121	1998
SUPV6	ED	7940	4383	0	2	374	4007	3505	502
SUPV6	TO	43695	19608	0	9	1473	18126	15626	2500
SUPV7	MV	38887	20717	0	8	1206	19503	14793	4710
SUPV7	ED	8556	7211	0	2	373	6836	5405	1431
SUPV7	TO	47443	27928	0	10	1579	26339	20198	6141
SUPV8	MV	46370	27474	0	3	1780	25691	22315	3376
SUPV8	ED	11807	11114	0	3	701	10410	9098	1312
SUPV8	TO	58177	38588	0	6	2481	36101	31413	4688
SUPV9	MV	33165	16755	0	1	977	15777	13318	2459
SUPV9	ED	10098	7086	0	1	410	6675	5878	797
SUPV9	TO	43263	23841	0	2	1387	22452	19196	3256
SUPV10	MV	33765	13891	0	2	894	12995	10248	2747
SUPV10	ED	9348	4201	0	0	308	3893	3253	640
SUPV10	TO	43113	18092	0	2	1202	16888	13501	3387
SUPV11	MV	30643	13428	0	3	701	12724	9228	3496
SUPV11	ED	8032	4005	0	1	250	3754	3017	737
SUPV11	TO	38675	17433	0	4	951	16478	12245	4233
NEIG1	MV	15464	5936	0	2	397	5537	4260	1277
NEIG1	ED	5021	1551	0	0	114	1437	1184	253
NEIG1	TO	20485	7487	0	2	511	6974	5444	1530
NEIG2	MV	14029	6273	0	0	528	5745	4675	1070
NEIG2	ED	3238	2776	0	1	283	2492	2142	350
NEIG2	TO	17267	9049	0	1	811	8237	6817	1420
NEIG3	MV	22050	9495	0	4	707	8784	7616	1168
NEIG3	ED	5969	3742	0	3	300	3439	3033	406
NEIG3	TO	28019	13237	0	7	1007	12223	10649	1574
NEIG4	MV	5630	3491	0	0	207	3284	2713	571
NEIG4	ED	1430	1237	0	1	89	1147	938	209
NEIG4	TO	7060	4728	0	1	296	4431	3651	780
NEIG5	MV	22700	10117	0	1	553	9563	6917	2646
NEIG5	ED	5893	2969	0	0	186	2783	2210	573
NEIG5	TO	28593	13086	0	1	739	12346	9127	3219
NEIG6	MV	11526	5963	0	1	407	5555	5007	548
NEIG6	ED	2336	2800	0	1	196	2603	2355	248
NEIG6	TO	13862	8763	0	2	603	8158	7362	796
NEIG7	MV	9818	4127	0	2	198	3927	2868	1059
NEIG7	ED	2577	1302	0	1	76	1225	1010	215
NEIG7	TO	12395	5429	0	3	274	5152	3878	1274
NEIG8	MV	7628	4025	0	1	273	3751	3298	453
NEIG8	ED	2030	1847	0	0	125	1722	1516	206
NEIG8	TO	9658	5872	0	1	398	5473	4814	659
NEIG9	MV	7416	3138	0	0	190	2948	2254	694
NEIG9	ED	842	924	0	1	66	857	711	146
NEIG9	TO	8258	4062	0	1	256	3805	2965	840
NEIG10	MV	8172	3949	0	0	273	3676	3094	582
NEIG10	ED	1850	1947	0	0	143	1804	1545	259
NEIG10	TO	10022	5896	0	0	416	5480	4639	841
NEIG11	MV	33509	15520	0	1	1313	14206	11593	2613
NEIG11	ED	5931	7800	0	0	858	6942	5741	1201
NEIG11	TO	39440	23320	0	1	2171	21148	17334	3814
NEIG12	MV	23572	11845	0	2	686	11157	9971	1186
NEIG12	ED	7433	5298	0	0	332	4966	4508	458
NEIG12	TO	31005	17143	0	2	1018	16123	14479	1644
NEIG14	MV	6791	3984	0	0	258	3726	3281	445
NEIG14	ED	1942	1788	0	1	93	1694	1513	181
NEIG14	TO	8733	5772	0	1	351	5420	4794	626
NEIG15	MV	5779	2672	0	0	162	2510	2006	504
NEIG15	ED	1309	1165	0	0	94	1071	922	149
NEIG15	TO	7088	3837	0	0	256	3581	2928	653
NEIG13	MV	13553	8149	0	0	546	7603	6530	1073
NEIG13	ED	3435	3370	0	0	197	3173	2749	424
NEIG13	TO	16988	11519	0	0	743	10776	9279	1497
NEIG26	MV	7830	3522	0	0	204	3318	2249	1069
NEIG26	ED	1802	947	0	0	58	889	664	225
NEIG26	TO	9632	4469	0	0	262	4207	2913	1294
NEIG16	MV	14623	6798	0	1	480	6317	5412	905
NEIG16	ED	2733	2413	0	0	189	2224	1932	292
NEIG16	TO	17356	9211	0	1	669	8541	7344	1197
NEIG17	MV	29447	14398	0	0	896	13502	10751	2751
NEIG17	ED	8178	7475	0	1	547	6927	5807	1120
NEIG17	TO	37625	21873	0	1	1443	20429	16558	3871
NEIG19	MV	7165	4013	0	0	236	3777	3256	521
NEIG19	ED	2406	1869	0	0	108	1761	1523	238
NEIG19	TO	9571	5882	0	0	344	5538	4779	759
NEIG18	MV	6458	3411	0	3	229	3179	2491	688
NEIG18	ED	1563	1828	0	0	152	1676	1397	279
NEIG18	TO	8021	5239	0	3	381	4855	3888	967
NEIG20	MV	20910	8905	0	5	628	8272	7050	1222
NEIG20	ED	4167	2452	0	0	212	2240	1953	287
NEIG20	TO	25077	11357	0	5	840	10512	9003	1509
NEIG21	MV	34606	16636	0	3	984	15649	11329	4320
NEIG21	ED	8887	5783	0	0	371	5412	4270	1142
NEIG21	TO	43493	22419	0	3	1355	21061	15599	5462
NEIG22	MV	15381	9289	0	2	610	8677	7618	1059
NEIG22	ED	3512	3613	0	2	221	3390	2999	391
NEIG22	TO	18893	12902	0	4	831	12067	10617	1450
NEIG23	MV	6638	2508	0	0	136	2372	1628	744
NEIG23	ED	1850	598	0	0	45	553	428	125
NEIG23	TO	8488	3106	0	0	181	2925	2056	869
NEIG24	MV	28439	16094	0	8	934	15152	11454	3698
NEIG24	ED	6935	5684	0	1	285	5398	4208	1190
NEIG24	TO	35374	21778	0	9	1219	20550	15662	4888
NEIG25	MV	23712	12534	0	4	889	11641	10420	1221
NEIG25	ED	7784	5043	0	1	368	4674	4227	447
NEIG25	TO	31496	17577	0	5	1257	16315	14647	1668
