area_id	subtotal_type	RSReg	RSCst	RSRej	RSOvr	RSUnd	RSTot	050:Yes	051:No
ALL	TO	500516	372848	942	332	19912	351662	60002	291660
ALL	ED	500516	127886	135	105	7068	120578	20509	100069
ALL	MV	500516	244962	807	227	12844	231084	39493	191591
PCT1101	ED	553	126	0	0	7	119	28	91
PCT1101	MV	553	266	1	0	10	255	49	206
PCT1102	ED	995	266	0	0	12	254	44	210
PCT1102	MV	995	480	-1	0	29	452	89	363
PCT1103	ED	951	246	1	0	14	231	51	180
PCT1103	MV	951	445	0	0	18	427	103	324
PCT1104	ED	993	249	0	0	14	235	41	194
PCT1104	MV	993	414	-2	0	19	397	95	302
PCT1106	ED	765	191	-1	0	11	181	47	134
PCT1106	MV	765	343	1	0	26	316	90	226
PCT1107	ED	746	163	1	0	6	156	28	128
PCT1107	MV	746	336	3	0	23	310	80	230
PCT1108	ED	909	232	-1	0	21	212	45	167
PCT1108	MV	909	438	-1	0	24	415	66	349
PCT1109	ED	798	166	0	0	8	158	35	123
PCT1109	MV	798	365	1	0	20	344	81	263
PCT1111	ED	1002	205	0	0	14	191	47	144
PCT1111	MV	1002	460	-1	0	33	428	113	315
PCT1112	ED	769	151	0	1	12	138	38	100
PCT1112	MV	769	344	0	0	29	315	78	237
PCT1113	ED	746	135	2	0	7	126	30	96
PCT1113	MV	746	360	0	0	14	346	93	253
PCT1114	ED	957	226	0	1	30	195	45	150
PCT1114	MV	957	404	2	1	17	384	114	270
PCT1115	ED	895	174	1	0	7	166	36	130
PCT1115	MV	895	371	-2	0	22	351	109	242
PCT1116	ED	895	225	0	0	22	203	38	165
PCT1116	MV	895	376	2	0	24	350	89	261
PCT1117	ED	858	185	1	0	16	168	27	141
PCT1117	MV	858	357	1	0	17	339	78	261
PCT1118	ED	1043	213	-2	0	13	202	36	166
PCT1118	MV	1043	476	-3	0	22	457	100	357
PCT1119	ED	791	165	0	0	9	156	34	122
PCT1119	MV	791	386	1	0	26	359	76	283
PCT1121	ED	691	160	0	0	8	152	32	120
PCT1121	MV	691	313	4	1	25	283	86	197
PCT1122	ED	632	110	0	0	9	101	20	81
PCT1122	MV	632	310	0	1	19	290	70	220
PCT1123	ED	915	179	0	0	13	166	42	124
PCT1123	MV	915	364	0	0	35	329	86	243
PCT1124	ED	819	152	-1	0	7	146	33	113
PCT1124	MV	819	302	-2	1	15	288	66	222
PCT1125	ED	1047	159	1	0	8	150	35	115
PCT1125	MV	1047	466	-3	2	30	437	142	295
PCT1126	ED	922	191	0	0	14	177	45	132
PCT1126	MV	922	400	-1	0	21	380	94	286
PCT1127	ED	920	200	0	0	13	187	50	137
PCT1127	MV	920	382	0	0	22	360	108	252
PCT1128	ED	838	154	0	0	16	138	35	103
PCT1128	MV	838	362	0	0	29	333	102	231
PCT1129	ED	980	227	1	0	18	208	53	155
PCT1129	MV	980	416	5	0	28	383	103	280
PCT1131	ED	797	132	0	0	13	119	35	84
PCT1131	MV	797	371	-1	0	22	350	103	247
PCT1132	ED	969	179	2	0	13	164	36	128
PCT1132	MV	969	427	0	0	33	394	125	269
PCT1133	ED	863	161	1	0	11	149	43	106
PCT1133	MV	863	410	0	1	23	386	87	299
PCT1134	ED	759	170	2	0	11	157	43	114
PCT1134	MV	759	318	-1	3	16	300	73	227
PCT1135	ED	540	87	1	0	2	84	17	67
PCT1135	MV	540	295	0	0	21	274	69	205
PCT1136	ED	829	144	0	0	12	132	38	94
PCT1136	MV	829	412	1	0	30	381	95	286
PCT1141	ED	1041	223	0	0	11	212	48	164
PCT1141	MV	1041	484	0	0	21	463	107	356
PCT1142	ED	861	175	0	0	15	160	25	135
PCT1142	MV	861	393	0	0	28	365	82	283
PCT1143	ED	1034	229	1	0	7	221	48	173
PCT1143	MV	1034	440	4	0	29	407	98	309
PCT1144	ED	907	205	1	0	9	195	42	153
PCT1144	MV	907	387	-1	0	23	365	95	270
PCT1145	ED	888	189	0	0	9	180	40	140
PCT1145	MV	888	461	0	0	20	441	91	350
PCT1146	ED	1011	186	0	0	6	180	35	145
PCT1146	MV	1011	454	2	1	30	421	92	329
PCT1147	ED	877	210	1	0	13	196	37	159
PCT1147	MV	877	396	1	0	30	365	87	278
PCT1148	ED	962	196	0	1	13	182	38	144
PCT1148	MV	962	444	0	1	26	417	133	284
PCT1149	ED	907	210	2	0	11	197	40	157
PCT1149	MV	907	407	-8	0	31	384	83	301
PCT1152	ED	864	198	0	0	16	182	43	139
PCT1152	MV	864	388	0	0	20	368	102	266
PCT1153	ED	951	210	0	2	19	189	46	143
PCT1153	MV	951	415	-1	0	23	393	105	288
PCT7001	ED	776	176	2	1	8	165	23	142
PCT7001	MV	776	429	3	0	18	408	37	371
PCT7002	ED	706	176	0	0	11	165	16	149
PCT7002	MV	706	332	-3	0	11	324	40	284
PCT7003	ED	884	238	0	0	12	226	35	191
PCT7003	MV	884	498	5	0	12	481	49	432
PCT7004	ED	881	241	1	0	5	235	26	209
PCT7004	MV	881	496	1	0	13	482	41	441
PCT7005	ED	847	253	0	0	8	245	28	217
PCT7005	MV	847	480	-1	0	18	463	36	427
PCT7006	ED	917	254	1	0	8	245	22	223
PCT7006	MV	917	442	1	0	18	423	39	384
PCT7007	ED	949	283	0	1	4	278	29	249
PCT7007	MV	949	516	2	0	16	498	56	442
PCT7008	ED	932	264	1	0	3	260	24	236
PCT7008	MV	932	546	5	1	19	521	55	466
PCT7009	ED	905	185	0	0	12	173	30	143
PCT7009	MV	905	513	1	1	18	493	61	432
PCT7011	ED	985	204	0	0	15	189	33	156
PCT7011	MV	985	294	0	0	17	277	38	239
PCT7012	ED	1109	313	0	0	7	306	44	262
PCT7012	MV	1109	594	4	0	18	572	55	517
PCT7013	ED	956	267	0	0	7	260	37	223
PCT7013	MV	956	501	4	2	21	474	46	428
PCT7014	ED	1460	367	0	0	10	357	40	317
PCT7014	MV	1460	802	3	0	27	772	74	698
PCT7015	MV	95	44	0	0	3	41	2	39
PCT7016	ED	918	171	0	0	14	157	40	117
PCT7016	MV	918	280	0	0	20	260	57	203
PCT7017	ED	754	149	0	0	12	137	37	100
PCT7017	MV	754	252	2	0	17	233	38	195
PCT7018	ED	977	155	0	0	20	135	36	99
PCT7018	MV	977	448	-1	0	36	413	107	306
PCT7019	ED	899	182	0	1	10	171	35	136
PCT7019	MV	899	413	0	1	27	385	80	305
PCT7021	ED	947	184	1	0	12	171	28	143
PCT7021	MV	947	305	0	0	16	289	72	217
PCT7022	ED	945	215	0	2	11	202	33	169
PCT7022	MV	945	352	0	0	30	322	62	260
PCT7023	ED	928	178	-1	0	6	173	37	136
PCT7023	MV	928	400	0	1	26	373	63	310
PCT7024	ED	414	70	0	0	4	66	16	50
PCT7024	MV	414	78	0	0	6	72	21	51
PCT7025	ED	477	85	0	0	9	76	21	55
PCT7025	MV	477	128	-1	1	8	120	28	92
PCT7026	ED	1011	149	0	0	9	140	36	104
PCT7026	MV	1011	455	1	0	26	428	119	309
PCT7027	ED	869	195	0	0	18	177	45	132
PCT7027	MV	869	353	-1	0	22	332	81	251
PCT7028	ED	850	213	-1	1	16	197	35	162
PCT7028	MV	850	282	0	0	18	264	58	206
PCT7029	ED	901	184	1	0	17	166	44	122
PCT7029	MV	901	251	1	2	14	234	46	188
PCT7030	ED	759	119	0	1	6	112	37	75
PCT7030	MV	759	357	0	0	22	335	103	232
PCT7031	ED	641	91	0	0	12	79	18	61
PCT7031	MV	641	309	-2	1	23	287	72	215
PCT7032	ED	904	173	-1	0	13	161	38	123
PCT7032	MV	904	316	2	0	30	284	71	213
PCT7033	ED	798	191	3	0	16	172	49	123
PCT7033	MV	798	247	-1	1	12	235	44	191
PCT7034	ED	958	197	0	0	21	176	53	123
PCT7034	MV	958	201	2	0	11	188	42	146
PCT7035	ED	606	122	0	0	10	112	27	85
PCT7035	MV	606	262	0	1	10	251	50	201
PCT7036	ED	921	117	0	0	8	109	31	78
PCT7036	MV	921	342	2	0	15	325	87	238
PCT7037	ED	735	135	-4	0	14	125	28	97
PCT7037	MV	735	98	-1	0	8	91	29	62
PCT7038	ED	911	135	0	0	14	121	38	83
PCT7038	MV	911	351	-2	1	23	329	107	222
PCT7039	ED	784	178	0	0	9	169	50	119
PCT7039	MV	784	306	3	0	13	290	97	193
PCT7041	MV	61	33	0	0	0	33	13	20
PCT7042	ED	639	118	0	0	7	111	33	78
PCT7042	MV	639	258	-1	0	15	244	60	184
PCT7043	ED	957	176	0	1	6	169	43	126
PCT7043	MV	957	404	0	1	23	380	98	282
PCT7044	ED	827	167	1	0	17	149	51	98
PCT7044	MV	827	193	-1	1	19	174	44	130
PCT7045	ED	779	120	0	0	15	105	29	76
PCT7045	MV	779	344	3	0	22	319	107	212
PCT7046	ED	402	94	0	0	5	89	27	62
PCT7046	MV	402	175	3	0	7	165	30	135
PCT7047	ED	823	119	0	0	9	110	26	84
PCT7047	MV	823	388	1	0	22	365	104	261
PCT7048	ED	858	150	4	0	13	133	34	99
PCT7048	MV	858	318	1	0	23	294	88	206
PCT7049	ED	792	173	-1	0	20	154	44	110
PCT7049	MV	792	305	2	1	15	287	88	199
PCT7051	ED	861	114	1	0	13	100	26	74
PCT7051	MV	861	380	1	0	35	344	101	243
PCT7052	ED	852	161	1	0	9	151	42	109
PCT7052	MV	852	402	0	1	25	376	109	267
PCT7053	ED	548	102	1	0	5	96	13	83
PCT7053	MV	548	278	0	1	14	263	63	200
PCT7054	ED	1073	215	1	0	10	204	37	167
PCT7054	MV	1073	410	3	1	19	387	77	310
PCT7055	ED	808	190	0	0	11	179	17	162
PCT7055	MV	808	440	0	0	23	417	67	350
PCT7101	MV	155	120	1	0	5	114	9	105
PCT7201	ED	936	245	1	1	12	231	33	198
PCT7201	MV	936	518	2	1	29	486	103	383
PCT7202	ED	850	227	-1	0	11	217	29	188
PCT7202	MV	850	431	4	0	20	407	87	320
PCT7203	ED	921	291	3	0	9	279	34	245
PCT7203	MV	921	423	-1	0	19	405	55	350
PCT7204	ED	918	233	0	0	16	217	38	179
PCT7204	MV	918	531	3	2	23	503	70	433
PCT7205	ED	875	251	1	0	17	233	32	201
PCT7205	MV	875	485	0	0	11	474	78	396
PCT7206	ED	378	135	1	0	6	128	20	108
PCT7206	MV	378	191	2	0	9	180	35	145
PCT7207	ED	812	196	-2	0	18	180	33	147
PCT7207	MV	812	434	6	0	22	406	63	343
PCT7208	ED	600	111	-1	0	10	102	11	91
PCT7208	MV	600	328	-1	0	24	305	38	267
PCT7209	ED	626	107	0	0	2	105	18	87
PCT7209	MV	626	423	2	0	33	388	44	344
PCT7301	ED	1016	228	0	0	20	208	43	165
PCT7301	MV	1016	435	1	3	33	398	76	322
PCT7302	ED	814	188	0	0	18	170	30	140
PCT7302	MV	814	458	2	0	46	410	73	337
PCT7303	ED	1042	281	0	0	14	267	46	221
PCT7303	MV	1042	482	2	0	27	453	74	379
PCT7304	ED	1002	278	0	0	14	264	39	225
PCT7304	MV	1002	493	1	0	25	467	67	400
PCT7305	ED	871	240	0	0	13	227	42	185
PCT7305	MV	871	460	0	0	21	439	71	368
PCT7306	ED	1056	317	0	0	16	301	62	239
PCT7306	MV	1056	498	0	1	30	467	83	384
PCT7307	ED	767	210	0	0	8	202	32	170
PCT7307	MV	767	346	3	0	26	317	47	270
PCT7308	ED	603	177	0	1	8	168	27	141
PCT7308	MV	603	313	4	0	15	294	44	250
PCT7309	ED	884	263	0	0	18	245	41	204
PCT7309	MV	884	439	4	0	28	407	73	334
PCT7311	ED	917	268	2	0	10	256	36	220
PCT7311	MV	917	448	-3	1	19	431	69	362
PCT7312	ED	821	203	0	0	14	189	35	154
PCT7312	MV	821	470	3	0	36	431	78	353
PCT7313	ED	968	225	1	0	17	207	27	180
PCT7313	MV	968	485	5	0	33	447	81	366
PCT7314	ED	787	125	0	0	17	108	22	86
PCT7314	MV	787	271	-2	0	60	213	58	155
PCT7315	ED	760	220	-2	0	17	205	39	166
PCT7315	MV	760	282	2	0	20	260	41	219
PCT7316	ED	853	205	0	0	15	190	31	159
PCT7316	MV	853	367	1	0	35	331	70	261
PCT7317	ED	904	189	0	1	16	172	31	141
PCT7317	MV	904	454	0	1	28	425	88	337
PCT7318	ED	727	179	0	0	12	167	33	134
PCT7318	MV	727	390	0	1	34	355	80	275
PCT7319	ED	1079	301	1	1	20	279	38	241
PCT7319	MV	1079	516	4	2	42	468	85	383
PCT7321	ED	671	149	0	0	12	137	30	107
PCT7321	MV	671	286	1	0	25	260	63	197
PCT7322	ED	874	65	0	1	9	55	12	43
PCT7322	MV	874	337	0	0	58	279	102	177
PCT7323	ED	950	234	0	0	14	220	42	178
PCT7323	MV	950	455	2	1	35	417	63	354
PCT7324	ED	755	190	1	2	18	169	28	141
PCT7324	MV	755	364	2	0	28	334	48	286
PCT7325	ED	904	243	0	0	22	221	39	182
PCT7325	MV	904	436	3	0	26	407	50	357
PCT7326	ED	876	200	0	0	18	182	26	156
PCT7326	MV	876	430	2	1	31	396	85	311
PCT7327	ED	699	71	0	0	8	63	11	52
PCT7327	MV	699	276	-1	0	46	231	68	163
PCT7328	ED	973	94	-2	0	18	78	18	60
PCT7328	MV	973	394	0	0	77	317	100	217
PCT7329	ED	640	112	0	0	7	105	20	85
PCT7329	MV	640	321	5	0	26	290	67	223
PCT7331	ED	852	213	-1	0	20	194	58	136
PCT7331	MV	852	461	3	0	28	430	75	355
PCT7332	ED	834	225	0	1	10	214	35	179
PCT7332	MV	834	364	1	0	28	335	45	290
PCT7333	ED	1044	298	0	0	16	282	52	230
PCT7333	MV	1044	543	5	2	27	509	96	413
PCT7334	ED	881	199	0	0	16	183	33	150
PCT7334	MV	881	462	5	0	29	428	83	345
PCT7335	ED	970	225	0	0	14	211	33	178
PCT7335	MV	970	523	3	1	24	495	81	414
PCT7336	ED	955	238	-1	0	12	227	30	197
PCT7336	MV	955	523	3	0	27	493	97	396
PCT7337	ED	851	179	0	0	11	168	33	135
PCT7337	MV	851	464	3	0	30	431	81	350
PCT7338	ED	915	153	1	0	19	133	20	113
PCT7338	MV	915	426	1	2	56	367	107	260
PCT7339	ED	669	174	0	0	6	168	26	142
PCT7339	MV	669	309	0	0	20	289	57	232
PCT7341	ED	908	260	0	0	20	240	38	202
PCT7341	MV	908	401	3	1	22	375	71	304
PCT7342	ED	947	334	-1	0	23	312	52	260
PCT7342	MV	947	414	1	2	12	399	59	340
PCT7343	ED	731	234	1	0	14	219	31	188
PCT7343	MV	731	316	6	0	11	299	30	269
PCT7344	ED	1110	291	1	0	17	273	43	230
PCT7344	MV	1110	538	-4	0	23	519	84	435
PCT7345	ED	1141	329	-1	0	18	312	52	260
PCT7345	MV	1141	521	3	0	21	497	68	429
PCT7346	ED	920	250	1	0	15	234	26	208
PCT7346	MV	920	384	-2	0	24	362	56	306
PCT7347	ED	1040	241	1	0	19	221	39	182
PCT7347	MV	1040	480	6	0	23	451	49	402
PCT7348	ED	861	210	1	0	14	195	31	164
PCT7348	MV	861	353	-1	0	23	331	63	268
PCT7349	ED	957	248	0	0	12	236	36	200
PCT7349	MV	957	427	3	0	31	393	81	312
PCT7501	ED	565	172	-1	0	9	164	14	150
PCT7501	MV	565	308	4	0	14	290	38	252
PCT7502	ED	784	180	1	0	7	172	34	138
PCT7502	MV	784	447	2	1	36	408	61	347
PCT7503	ED	764	208	1	0	16	191	24	167
PCT7503	MV	764	388	4	0	21	363	63	300
PCT7504	ED	503	112	0	0	12	100	21	79
PCT7504	MV	503	222	2	0	21	199	34	165
PCT7505	ED	869	158	2	1	11	144	23	121
PCT7505	MV	869	532	5	4	37	486	84	402
PCT7506	ED	999	226	0	1	15	210	34	176
PCT7506	MV	999	473	3	0	27	443	69	374
PCT7507	ED	955	211	0	0	15	196	44	152
PCT7507	MV	955	344	-2	0	21	325	51	274
PCT7508	ED	727	154	0	1	9	144	30	114
PCT7508	MV	727	427	3	0	35	389	58	331
PCT7509	ED	932	235	3	0	13	219	34	185
PCT7509	MV	932	470	4	0	29	437	59	378
PCT7512	ED	612	150	0	0	15	135	44	91
PCT7512	MV	612	283	-1	0	21	263	78	185
PCT7513	ED	818	225	0	1	22	202	46	156
PCT7513	MV	818	315	3	0	19	293	74	219
PCT7514	ED	874	140	0	0	17	123	39	84
PCT7514	MV	874	305	1	2	35	267	76	191
PCT7515	ED	869	212	0	0	13	199	27	172
PCT7515	MV	869	389	-1	1	18	371	62	309
PCT7516	ED	922	172	1	0	11	160	22	138
PCT7516	MV	922	538	-1	1	40	498	83	415
PCT7517	ED	863	289	0	1	14	274	35	239
PCT7517	MV	863	410	0	1	15	394	23	371
PCT7518	ED	950	309	0	0	11	298	38	260
PCT7518	MV	950	480	2	0	29	449	32	417
PCT7519	ED	737	224	0	0	7	217	24	193
PCT7519	MV	737	355	1	2	14	338	34	304
PCT7521	ED	812	292	6	0	20	266	22	244
PCT7521	MV	812	354	0	1	19	334	19	315
PCT7522	ED	764	207	0	0	11	196	17	179
PCT7522	MV	764	397	2	0	9	386	31	355
PCT7523	ED	747	275	-1	0	14	262	29	233
PCT7523	MV	747	359	3	0	13	343	24	319
PCT7524	ED	615	181	1	0	8	172	29	143
PCT7524	MV	615	262	3	1	11	247	23	224
PCT7525	ED	800	205	0	0	15	190	28	162
PCT7525	MV	800	341	-1	0	23	319	38	281
PCT7526	ED	1011	292	0	0	15	277	24	253
PCT7526	MV	1011	552	2	1	34	515	57	458
PCT7527	ED	725	211	0	0	14	197	29	168
PCT7527	MV	725	339	0	0	24	315	44	271
PCT7529	ED	948	295	-3	1	20	277	32	245
PCT7529	MV	948	486	1	1	21	463	44	419
PCT7531	ED	865	228	-1	0	11	218	29	189
PCT7531	MV	865	442	1	0	12	429	33	396
PCT7532	ED	852	246	3	0	14	229	34	195
PCT7532	MV	852	398	0	0	19	379	42	337
PCT7533	ED	1015	357	0	1	9	347	27	320
PCT7533	MV	1015	490	0	0	20	470	41	429
PCT7534	ED	936	322	0	1	9	312	33	279
PCT7534	MV	936	415	0	0	15	400	44	356
PCT7535	ED	767	262	2	0	7	253	25	228
PCT7535	MV	767	387	3	0	24	360	28	332
PCT7536	ED	863	291	-1	0	13	279	24	255
PCT7536	MV	863	421	0	1	14	406	23	383
PCT7537	ED	752	240	-1	0	10	231	24	207
PCT7537	MV	752	363	0	1	9	353	25	328
PCT7538	ED	771	246	0	0	18	228	23	205
PCT7538	MV	771	400	2	0	23	375	23	352
PCT7539	ED	922	330	0	0	16	314	22	292
PCT7539	MV	922	428	2	0	15	411	23	388
PCT7541	ED	805	248	0	0	12	236	32	204
PCT7541	MV	805	400	0	0	10	390	31	359
PCT7542	ED	821	272	0	0	10	262	19	243
PCT7542	MV	821	389	0	0	7	382	32	350
PCT7543	ED	909	216	0	2	16	198	12	186
PCT7543	MV	909	467	3	0	12	452	35	417
PCT7544	ED	898	258	0	0	14	244	18	226
PCT7544	MV	898	479	4	0	13	462	35	427
PCT7545	ED	918	273	0	0	12	261	31	230
PCT7545	MV	918	480	-1	0	25	456	47	409
PCT7546	ED	982	304	0	0	12	292	31	261
PCT7546	MV	982	517	5	0	16	496	26	470
PCT7547	ED	1029	315	0	0	11	304	19	285
PCT7547	MV	1029	505	2	0	18	485	24	461
PCT7548	ED	1073	319	1	0	16	302	22	280
PCT7548	MV	1073	512	1	0	19	492	37	455
PCT7549	ED	811	215	0	0	17	198	19	179
PCT7549	MV	811	431	-3	1	26	407	41	366
PCT7551	ED	741	239	0	0	7	232	20	212
PCT7551	MV	741	394	1	0	16	377	18	359
PCT7552	ED	727	241	1	0	12	228	21	207
PCT7552	MV	727	361	1	0	12	348	20	328
PCT7553	MV	180	126	1	0	5	120	13	107
PCT7554	ED	808	247	0	0	8	239	24	215
PCT7554	MV	808	442	4	0	16	422	38	384
PCT7555	ED	886	290	-6	0	12	284	27	257
PCT7555	MV	886	459	1	0	18	440	33	407
PCT7556	ED	969	275	1	0	6	268	37	231
PCT7556	MV	969	573	0	1	12	560	45	515
PCT7601	ED	767	191	0	0	14	177	27	150
PCT7601	MV	767	290	1	0	15	274	57	217
PCT7602	ED	901	213	0	0	18	195	36	159
PCT7602	MV	901	379	3	0	19	357	55	302
PCT7603	ED	830	250	0	1	15	234	27	207
PCT7603	MV	830	376	0	1	13	362	42	320
PCT7604	ED	954	266	0	0	16	250	52	198
PCT7604	MV	954	352	2	0	21	329	54	275
PCT7605	ED	648	120	0	0	13	107	18	89
PCT7605	MV	648	203	-1	0	22	182	45	137
PCT7606	ED	924	205	3	0	25	177	33	144
PCT7606	MV	924	330	1	0	18	311	61	250
PCT7607	ED	960	215	-1	2	23	191	33	158
PCT7607	MV	960	407	3	0	17	387	71	316
PCT7608	ED	392	70	0	0	13	57	15	42
PCT7608	MV	392	136	0	0	13	123	37	86
PCT7609	ED	926	120	-1	0	22	99	31	68
PCT7609	MV	926	352	5	0	58	289	88	201
PCT7611	ED	755	126	0	0	14	112	24	88
PCT7611	MV	755	269	2	0	39	228	61	167
PCT7612	ED	583	97	1	0	11	85	17	68
PCT7612	MV	583	265	0	0	33	232	43	189
PCT7613	ED	908	204	-1	1	16	188	45	143
PCT7613	MV	908	340	1	0	25	314	71	243
PCT7614	ED	1029	223	2	0	33	188	36	152
PCT7614	MV	1029	375	1	0	21	353	51	302
PCT7615	ED	762	162	2	0	33	127	44	83
PCT7615	MV	762	237	-2	0	28	211	64	147
PCT7616	ED	1203	324	0	1	23	300	47	253
PCT7616	MV	1203	686	0	0	22	664	62	602
PCT7617	ED	768	102	1	0	14	87	19	68
PCT7617	MV	768	261	0	0	27	234	55	179
PCT7618	ED	862	168	0	1	10	157	22	135
PCT7618	MV	862	407	4	0	13	390	48	342
PCT7619	ED	1063	219	0	0	8	211	30	181
PCT7619	MV	1063	563	-1	2	33	529	90	439
PCT7621	ED	1320	287	1	2	16	268	48	220
PCT7621	MV	1320	668	4	0	36	628	98	530
PCT7622	ED	988	170	0	0	21	149	34	115
PCT7622	MV	988	301	4	0	25	272	63	209
PCT7623	ED	746	184	0	0	14	170	30	140
PCT7623	MV	746	297	2	0	15	280	44	236
PCT7624	ED	859	142	0	0	9	133	35	98
PCT7624	MV	859	290	1	0	24	265	48	217
PCT7625	ED	822	66	0	0	7	59	10	49
PCT7625	MV	822	475	1	0	78	396	132	264
PCT7626	ED	1114	227	0	1	16	210	35	175
PCT7626	MV	1114	612	0	1	29	582	76	506
PCT7627	ED	1187	267	0	0	17	250	49	201
PCT7627	MV	1187	582	5	1	36	540	96	444
PCT7628	ED	960	241	0	0	6	235	35	200
PCT7628	MV	960	428	2	0	19	407	46	361
PCT7629	ED	809	208	1	0	9	198	22	176
PCT7629	MV	809	343	3	0	10	330	48	282
PCT7631	ED	1155	270	0	1	18	251	45	206
PCT7631	MV	1155	577	2	1	30	544	86	458
PCT7632	ED	1124	289	3	0	14	272	34	238
PCT7632	MV	1124	561	1	0	14	546	63	483
PCT7633	ED	741	137	0	0	10	127	24	103
PCT7633	MV	741	392	1	1	33	357	62	295
PCT7634	ED	900	195	0	0	19	176	38	138
PCT7634	MV	900	421	2	1	32	386	84	302
PCT7635	ED	840	158	0	0	8	150	17	133
PCT7635	MV	840	382	2	0	21	359	49	310
PCT7636	ED	938	251	1	1	15	234	41	193
PCT7636	MV	938	465	3	0	26	436	62	374
PCT7637	ED	809	193	-1	1	13	180	32	148
PCT7637	MV	809	404	1	1	13	389	61	328
PCT7638	ED	1467	295	0	0	21	274	52	222
PCT7638	MV	1467	871	10	2	38	821	124	697
PCT7639	ED	1011	242	0	0	13	229	36	193
PCT7639	MV	1011	559	1	0	23	535	79	456
PCT7641	ED	972	205	-1	1	14	191	43	148
PCT7641	MV	972	549	3	1	21	524	88	436
PCT7642	ED	937	153	0	0	10	143	20	123
PCT7642	MV	937	394	2	0	55	337	59	278
PCT7643	ED	920	169	0	1	14	154	28	126
PCT7643	MV	920	507	1	1	24	481	101	380
PCT7644	ED	1175	330	1	0	16	313	49	264
PCT7644	MV	1175	554	4	0	28	522	59	463
PCT7645	ED	640	120	-1	0	8	113	14	99
PCT7645	MV	640	377	2	0	18	357	56	301
PCT7646	ED	1100	267	0	0	15	252	40	212
PCT7646	MV	1100	592	5	1	22	564	78	486
PCT7647	ED	1075	205	-1	0	25	181	48	133
PCT7647	MV	1075	283	-1	0	14	270	52	218
PCT7648	MV	1	0	0	0	0	0	0	0
PCT7649	ED	891	178	1	1	11	165	31	134
PCT7649	MV	891	395	5	0	27	363	63	300
PCT7651	ED	677	166	1	0	14	151	24	127
PCT7651	MV	677	351	4	1	15	331	58	273
PCT7652	ED	628	135	0	0	10	125	18	107
PCT7652	MV	628	301	6	0	16	279	35	244
PCT7653	ED	1280	300	1	0	25	274	41	233
PCT7653	MV	1280	673	4	0	30	639	87	552
PCT7701	ED	1064	296	0	0	13	283	34	249
PCT7701	MV	1064	597	3	0	33	561	90	471
PCT7702	ED	748	180	-1	0	13	168	37	131
PCT7702	MV	748	415	3	1	16	395	77	318
PCT7703	MV	171	79	0	0	10	69	20	49
PCT7704	ED	1008	257	0	0	10	247	55	192
PCT7704	MV	1008	557	3	2	25	527	114	413
PCT7705	ED	568	149	-2	0	5	146	27	119
PCT7705	MV	568	335	0	0	19	316	64	252
PCT7706	ED	840	252	1	0	7	244	32	212
PCT7706	MV	840	467	4	0	21	442	95	347
PCT7707	ED	857	241	1	0	8	232	40	192
PCT7707	MV	857	495	1	0	25	469	73	396
PCT7708	ED	871	205	-1	0	6	200	43	157
PCT7708	MV	871	540	2	1	24	513	87	426
PCT7709	ED	391	102	0	0	2	100	18	82
PCT7709	MV	391	222	1	0	11	210	39	171
PCT7711	ED	766	198	-1	0	5	194	32	162
PCT7711	MV	766	422	-3	1	17	407	55	352
PCT7712	ED	529	149	0	0	5	144	14	130
PCT7712	MV	529	296	0	0	10	286	42	244
PCT7801	ED	1001	264	2	0	5	257	21	236
PCT7801	MV	1001	596	2	1	19	574	61	513
PCT7802	ED	788	230	1	0	10	219	24	195
PCT7802	MV	788	458	2	0	25	431	39	392
PCT7803	ED	828	174	0	0	9	165	16	149
PCT7803	MV	828	552	1	0	17	534	54	480
PCT7804	ED	893	257	1	0	12	244	23	221
PCT7804	MV	893	533	1	1	21	510	46	464
PCT7805	ED	825	228	0	0	10	218	19	199
PCT7805	MV	825	484	1	0	18	465	32	433
PCT7806	ED	716	208	1	0	1	206	12	194
PCT7806	MV	716	407	1	0	9	397	30	367
PCT7807	ED	844	276	0	0	5	271	17	254
PCT7807	MV	844	417	2	0	16	399	31	368
PCT7808	ED	655	211	-2	0	8	205	19	186
PCT7808	MV	655	333	1	0	19	313	17	296
PCT7809	ED	781	238	1	0	10	227	26	201
PCT7809	MV	781	405	3	0	14	388	34	354
PCT7811	ED	783	249	0	0	5	244	18	226
PCT7811	MV	783	404	6	0	12	386	27	359
PCT7812	ED	877	257	0	1	19	237	30	207
PCT7812	MV	877	454	-1	1	15	439	34	405
PCT7813	ED	1064	308	1	1	11	295	31	264
PCT7813	MV	1064	585	3	1	25	556	44	512
PCT7814	ED	936	228	-1	1	12	216	43	173
PCT7814	MV	936	341	-2	1	12	330	47	283
PCT7815	ED	954	238	0	1	9	228	18	210
PCT7815	MV	954	573	1	1	19	552	46	506
PCT7816	ED	865	236	0	0	5	231	12	219
PCT7816	MV	865	531	4	3	19	505	33	472
PCT7817	ED	823	277	0	0	11	266	22	244
PCT7817	MV	823	439	4	0	11	424	27	397
PCT7818	ED	860	234	1	0	7	226	26	200
PCT7818	MV	860	452	1	0	11	440	39	401
PCT7819	ED	793	191	0	0	8	183	24	159
PCT7819	MV	793	420	1	1	26	392	34	358
PCT7821	ED	985	248	0	0	11	237	19	218
PCT7821	MV	985	630	5	1	12	612	52	560
PCT7822	ED	908	275	0	0	7	268	31	237
PCT7822	MV	908	480	1	0	20	459	36	423
PCT7823	ED	879	270	7	0	9	254	14	240
PCT7823	MV	879	501	3	0	25	473	31	442
PCT7824	ED	768	247	0	0	9	238	18	220
PCT7824	MV	768	383	1	0	18	364	30	334
PCT7825	ED	597	191	0	0	7	184	13	171
PCT7825	MV	597	302	-1	1	16	286	13	273
PCT7826	ED	684	258	1	0	13	244	21	223
PCT7826	MV	684	319	0	0	14	305	22	283
PCT7827	ED	831	261	0	0	12	249	24	225
PCT7827	MV	831	361	0	0	13	348	35	313
PCT7828	ED	1018	261	0	0	13	248	34	214
PCT7828	MV	1018	549	1	0	16	532	59	473
PCT7829	ED	907	237	1	0	12	224	29	195
PCT7829	MV	907	557	1	0	15	541	67	474
PCT7831	ED	882	233	0	0	11	222	14	208
PCT7831	MV	882	544	15	0	13	516	44	472
PCT7832	ED	780	188	0	0	1	187	20	167
PCT7832	MV	780	488	0	2	9	477	35	442
PCT7833	ED	747	230	2	0	6	222	19	203
PCT7833	MV	747	412	2	2	12	396	20	376
PCT7834	ED	867	277	1	0	13	263	29	234
PCT7834	MV	867	439	2	0	14	423	13	410
PCT7835	ED	847	211	0	0	9	202	25	177
PCT7835	MV	847	505	6	0	18	481	66	415
PCT7836	ED	1023	260	0	0	11	249	39	210
PCT7836	MV	1023	623	-2	0	25	600	89	511
PCT7837	ED	911	260	1	0	8	251	22	229
PCT7837	MV	911	509	3	1	25	480	43	437
PCT7838	ED	926	239	0	0	8	231	24	207
PCT7838	MV	926	546	6	0	13	527	42	485
PCT7839	ED	842	205	0	0	10	195	16	179
PCT7839	MV	842	515	-5	0	22	498	48	450
PCT7841	ED	937	291	0	0	15	276	18	258
PCT7841	MV	937	526	4	0	12	510	36	474
PCT7842	ED	903	283	0	0	8	275	23	252
PCT7842	MV	903	434	-2	0	13	423	32	391
PCT7843	ED	767	232	0	0	9	223	23	200
PCT7843	MV	767	380	0	0	8	372	39	333
PCT7844	ED	663	196	0	0	9	187	23	164
PCT7844	MV	663	329	2	0	11	316	28	288
PCT7845	ED	849	241	-1	0	12	230	31	199
PCT7845	MV	849	469	-2	0	16	455	31	424
PCT7846	ED	904	262	0	0	15	247	30	217
PCT7846	MV	904	509	1	0	19	489	48	441
PCT7847	ED	929	261	1	0	15	245	25	220
PCT7847	MV	929	529	1	1	23	504	33	471
PCT7848	ED	834	233	0	0	9	224	22	202
PCT7848	MV	834	491	-2	1	17	475	40	435
PCT7849	ED	929	264	0	0	11	253	19	234
PCT7849	MV	929	522	1	2	29	490	44	446
PCT7851	ED	513	136	0	0	4	132	24	108
PCT7851	MV	513	298	-1	0	11	288	41	247
PCT7852	ED	647	143	0	0	5	138	29	109
PCT7852	MV	647	394	0	1	18	375	59	316
PCT7853	ED	850	214	-2	0	11	205	26	179
PCT7853	MV	850	479	7	0	26	446	49	397
PCT7854	ED	894	248	0	0	9	239	24	215
PCT7854	MV	894	500	0	0	20	480	59	421
PCT7855	ED	986	301	0	0	17	284	21	263
PCT7855	MV	986	522	-3	0	22	503	57	446
PCT7856	ED	800	265	0	0	11	254	22	232
PCT7856	MV	800	425	1	0	18	406	39	367
PCT7857	ED	933	276	1	0	14	261	31	230
PCT7857	MV	933	517	-2	0	19	500	53	447
PCT7858	ED	775	245	0	0	6	239	22	217
PCT7858	MV	775	394	1	0	12	381	27	354
PCT7859	ED	891	250	0	0	9	241	30	211
PCT7859	MV	891	513	1	0	13	499	53	446
PCT7861	ED	859	217	0	0	7	210	19	191
PCT7861	MV	859	510	3	0	12	495	63	432
PCT7862	ED	866	302	1	1	11	289	36	253
PCT7862	MV	866	472	0	0	20	452	49	403
PCT7863	ED	907	311	0	0	11	300	30	270
PCT7863	MV	907	440	0	0	18	422	36	386
PCT7864	ED	807	232	0	0	8	224	25	199
PCT7864	MV	807	427	-2	0	14	415	45	370
PCT7865	ED	823	241	0	0	9	232	22	210
PCT7865	MV	823	463	4	0	17	442	52	390
PCT7866	ED	836	209	-1	0	5	205	31	174
PCT7866	MV	836	491	3	0	11	477	76	401
PCT7867	ED	955	266	0	1	5	260	42	218
PCT7867	MV	955	512	8	2	20	482	66	416
PCT7868	ED	881	242	1	0	19	222	30	192
PCT7868	MV	881	449	1	0	12	436	69	367
PCT7869	ED	867	239	0	0	8	231	22	209
PCT7869	MV	867	489	1	1	17	470	55	415
PCT7871	ED	900	259	0	0	14	245	37	208
PCT7871	MV	900	502	2	0	20	480	51	429
PCT7872	ED	862	288	0	0	12	276	26	250
PCT7872	MV	862	472	3	0	15	454	61	393
PCT7873	ED	861	257	1	0	7	249	22	227
PCT7873	MV	861	502	-1	0	14	489	47	442
PCT7874	ED	477	137	1	0	3	133	19	114
PCT7874	MV	477	256	2	0	10	244	21	223
PCT7875	ED	623	180	0	0	11	169	30	139
PCT7875	MV	623	285	0	0	15	270	46	224
PCT7876	ED	498	154	10	0	10	134	20	114
PCT7876	MV	498	269	1	0	18	250	23	227
PCT7901	ED	522	136	0	0	10	126	17	109
PCT7901	MV	522	198	1	0	10	187	22	165
PCT7902	ED	968	258	0	1	20	237	28	209
PCT7902	MV	968	401	1	0	9	391	38	353
PCT7903	ED	840	201	0	0	18	183	27	156
PCT7903	MV	840	350	-2	1	21	330	42	288
PCT7904	ED	877	212	1	0	10	201	24	177
PCT7904	MV	877	403	2	0	18	383	51	332
PCT7905	ED	851	254	0	1	10	243	29	214
PCT7905	MV	851	409	5	1	13	390	40	350
PCT7906	ED	787	245	0	0	16	229	21	208
PCT7906	MV	787	335	0	2	14	319	33	286
PCT7907	ED	950	278	0	0	11	267	27	240
PCT7907	MV	950	425	-4	0	18	411	36	375
PCT7908	ED	949	284	1	2	21	260	42	218
PCT7908	MV	949	408	2	0	31	375	51	324
PCT7909	ED	733	251	0	0	14	237	23	214
PCT7909	MV	733	303	-1	0	14	290	26	264
PCT7911	ED	860	244	-1	0	16	229	32	197
PCT7911	MV	860	395	-1	0	16	380	43	337
PCT7912	ED	1065	291	0	0	19	272	31	241
PCT7912	MV	1065	463	2	0	18	443	31	412
PCT7913	ED	913	312	1	0	10	301	28	273
PCT7913	MV	913	378	-1	0	13	366	41	325
PCT7914	ED	883	278	-1	0	14	265	31	234
PCT7914	MV	883	425	3	0	13	409	37	372
PCT7915	ED	831	266	0	0	9	257	35	222
PCT7915	MV	831	351	0	0	15	336	38	298
PCT7916	ED	888	284	1	0	6	277	31	246
PCT7916	MV	888	421	0	1	15	405	29	376
PCT7917	ED	1015	315	0	0	17	298	31	267
PCT7917	MV	1015	428	3	0	15	410	43	367
PCT7918	ED	836	253	0	0	12	241	24	217
PCT7918	MV	836	379	0	2	20	357	29	328
PCT7919	ED	895	309	1	1	10	297	34	263
PCT7919	MV	895	376	-1	0	18	359	39	320
PCT7921	ED	917	232	1	0	12	219	29	190
PCT7921	MV	917	366	1	0	22	343	69	274
PCT7922	ED	831	250	1	0	9	240	27	213
PCT7922	MV	831	383	0	1	22	360	36	324
PCT7923	ED	885	262	0	1	4	257	33	224
PCT7923	MV	885	403	-1	0	17	387	35	352
PCT7924	ED	842	238	0	0	9	229	40	189
PCT7924	MV	842	382	0	0	22	360	59	301
PCT7925	ED	567	156	0	0	3	153	12	141
PCT7925	MV	567	293	0	0	7	286	35	251
PCT7926	ED	795	229	0	0	8	221	24	197
PCT7926	MV	795	390	4	1	10	375	36	339
PCT7927	ED	747	241	1	0	9	231	24	207
PCT7927	MV	747	392	4	0	12	376	27	349
PCT7928	ED	931	284	1	0	12	271	20	251
PCT7928	MV	931	489	0	0	19	470	45	425
PCT7929	ED	864	248	0	0	8	240	27	213
PCT7929	MV	864	509	1	1	13	494	40	454
PCT7931	ED	738	219	0	0	8	211	21	190
PCT7931	MV	738	408	2	0	6	400	32	368
PCT7932	ED	551	157	1	0	5	151	19	132
PCT7932	MV	551	285	1	0	7	277	30	247
PCT7933	MV	6	4	0	0	1	3	0	3
PCT7934	ED	890	250	-1	0	10	241	26	215
PCT7934	MV	890	472	0	0	19	453	30	423
PCT7935	ED	970	305	0	0	10	295	23	272
PCT7935	MV	970	519	-2	0	13	508	42	466
PCT7936	ED	856	287	2	0	10	275	20	255
PCT7936	MV	856	428	-1	1	18	410	30	380
PCT7937	ED	886	267	1	0	12	254	19	235
PCT7937	MV	886	435	3	2	13	417	39	378
PCT7938	ED	788	213	0	1	13	199	27	172
PCT7938	MV	788	337	2	1	12	322	33	289
PCT7939	ED	688	254	-2	0	12	244	26	218
PCT7939	MV	688	326	0	1	23	302	20	282
PCT7941	ED	751	218	-1	1	11	207	28	179
PCT7941	MV	751	348	0	0	24	324	26	298
PCT7942	ED	914	259	1	0	12	246	37	209
PCT7942	MV	914	412	-1	0	29	384	62	322
PCT7943	ED	872	258	4	0	8	246	41	205
PCT7943	MV	872	439	0	2	28	409	70	339
PCT7944	ED	801	243	0	0	8	235	24	211
PCT7944	MV	801	381	2	0	14	365	23	342
PCT7945	ED	915	186	0	0	10	176	32	144
PCT7945	MV	915	414	1	1	19	393	62	331
PCT7946	ED	945	183	0	0	6	177	43	134
PCT7946	MV	945	451	0	0	35	416	113	303
PCT7947	ED	946	182	1	0	14	167	37	130
PCT7947	MV	946	430	2	0	24	404	117	287
PCT7948	ED	928	210	0	0	7	203	49	154
PCT7948	MV	928	422	-5	0	27	400	92	308
PCT7949	ED	569	100	1	0	7	92	26	66
PCT7949	MV	569	292	1	0	16	275	64	211
PCT7951	ED	854	166	0	0	15	151	40	111
PCT7951	MV	854	425	2	0	20	403	115	288
PCT7952	ED	866	167	0	0	20	147	39	108
PCT7952	MV	866	359	1	0	32	326	96	230
PCT7953	ED	824	186	2	0	12	172	46	126
PCT7953	MV	824	402	0	1	16	385	110	275
PCT7955	ED	902	199	4	1	16	178	44	134
PCT7955	MV	902	435	1	0	33	401	106	295
PCT7956	ED	823	136	0	0	13	123	32	91
PCT7956	MV	823	353	0	0	24	329	98	231
PCT7957	ED	646	147	0	1	14	132	24	108
PCT7957	MV	646	298	1	1	17	279	53	226
PCT7958	MV	290	141	1	0	10	130	34	96
PCT7959	ED	727	160	1	0	4	155	21	134
PCT7959	MV	727	326	1	0	21	304	36	268
PCT9001	MV	273	142	-2	0	4	140	28	112
PCT9101	ED	888	260	0	0	12	248	47	201
PCT9101	MV	888	438	4	0	22	412	90	322
PCT9102	ED	985	257	0	0	16	241	42	199
PCT9102	MV	985	471	2	0	26	443	94	349
PCT9103	ED	954	273	0	0	14	259	57	202
PCT9103	MV	954	431	7	0	20	404	90	314
PCT9104	ED	988	239	0	0	11	228	38	190
PCT9104	MV	988	465	3	0	25	437	99	338
PCT9105	ED	919	247	1	0	14	232	42	190
PCT9105	MV	919	488	-4	0	27	465	91	374
PCT9106	ED	937	268	1	0	12	255	34	221
PCT9106	MV	937	497	4	1	25	467	76	391
PCT9107	ED	849	219	0	0	5	214	37	177
PCT9107	MV	849	372	-1	0	24	349	68	281
PCT9108	ED	790	247	0	0	15	232	41	191
PCT9108	MV	790	373	2	1	23	347	59	288
PCT9109	ED	884	263	0	1	11	251	47	204
PCT9109	MV	884	428	1	0	29	398	65	333
PCT9111	ED	779	229	0	0	8	221	45	176
PCT9111	MV	779	346	2	0	22	322	53	269
PCT9112	ED	976	284	-1	0	14	271	45	226
PCT9112	MV	976	467	1	0	21	445	78	367
PCT9113	ED	999	311	0	0	14	297	50	247
PCT9113	MV	999	505	4	0	25	476	73	403
PCT9114	ED	877	263	-1	1	14	249	43	206
PCT9114	MV	877	405	-1	1	21	384	82	302
PCT9115	ED	911	258	1	0	19	238	37	201
PCT9115	MV	911	429	3	0	26	400	51	349
PCT9116	ED	944	281	0	1	11	269	55	214
PCT9116	MV	944	473	2	1	31	439	66	373
PCT9117	ED	783	222	0	0	9	213	38	175
PCT9117	MV	783	398	0	0	17	381	75	306
PCT9118	ED	974	286	-2	0	18	270	62	208
PCT9118	MV	974	426	3	0	31	392	87	305
PCT9119	ED	891	237	-1	0	13	225	45	180
PCT9119	MV	891	447	1	0	24	422	95	327
PCT9121	ED	930	256	-1	0	17	240	62	178
PCT9121	MV	930	434	-1	1	27	407	91	316
PCT9122	ED	953	210	0	0	23	187	28	159
PCT9122	MV	953	454	0	0	28	426	113	313
PCT9123	ED	858	232	0	1	22	209	46	163
PCT9123	MV	858	418	1	0	14	403	94	309
PCT9124	ED	874	202	0	0	11	191	37	154
PCT9124	MV	874	438	2	0	24	412	98	314
PCT9125	ED	861	210	-2	0	16	196	29	167
PCT9125	MV	861	437	2	1	27	407	89	318
PCT9126	ED	1015	245	-2	0	19	228	35	193
PCT9126	MV	1015	533	-2	0	27	508	89	419
PCT9127	ED	960	269	0	0	13	256	46	210
PCT9127	MV	960	498	0	1	27	470	81	389
PCT9128	ED	828	248	-1	0	13	236	43	193
PCT9128	MV	828	412	3	1	25	383	86	297
PCT9129	ED	741	243	1	0	16	226	35	191
PCT9129	MV	741	348	0	0	18	330	67	263
PCT9131	ED	759	193	1	0	10	182	34	148
PCT9131	MV	759	403	3	2	26	372	77	295
PCT9132	ED	837	248	0	0	12	236	38	198
PCT9132	MV	837	371	0	0	21	350	46	304
PCT9133	ED	1021	271	0	0	15	256	35	221
PCT9133	MV	1021	503	2	0	28	473	80	393
PCT9134	ED	893	210	0	0	19	191	30	161
PCT9134	MV	893	469	0	0	24	445	88	357
PCT9135	ED	808	215	0	0	6	209	42	167
PCT9135	MV	808	389	2	0	20	367	98	269
PCT9136	ED	929	253	1	0	17	235	50	185
PCT9136	MV	929	439	-2	0	20	421	85	336
PCT9137	ED	1006	260	-1	0	10	251	63	188
PCT9137	MV	1006	467	1	0	29	437	90	347
PCT9138	ED	943	226	2	1	14	209	40	169
PCT9138	MV	943	477	1	0	30	446	115	331
PCT9139	ED	975	243	0	1	12	230	49	181
PCT9139	MV	975	510	6	1	34	469	101	368
PCT9141	ED	953	252	-1	0	10	243	55	188
PCT9141	MV	953	477	4	0	29	444	93	351
PCT9142	ED	966	276	0	0	22	254	41	213
PCT9142	MV	966	459	-1	0	26	434	72	362
PCT9143	ED	920	251	0	0	12	239	49	190
PCT9143	MV	920	463	7	1	27	428	82	346
PCT9144	ED	962	293	0	0	12	281	43	238
PCT9144	MV	962	482	3	0	22	457	88	369
PCT9145	ED	861	249	2	0	6	241	50	191
PCT9145	MV	861	423	2	0	23	398	66	332
PCT9146	ED	885	245	-1	0	13	233	37	196
PCT9146	MV	885	464	2	1	26	435	52	383
PCT9147	ED	971	281	0	0	13	268	39	229
PCT9147	MV	971	492	-2	1	17	476	71	405
PCT9148	ED	1034	325	0	0	11	314	42	272
PCT9148	MV	1034	513	1	0	22	490	60	430
PCT9149	ED	948	264	0	0	14	250	35	215
PCT9149	MV	948	478	4	1	22	451	62	389
PCT9151	ED	872	227	0	1	13	213	37	176
PCT9151	MV	872	418	4	1	24	389	56	333
PCT9152	ED	721	270	-2	1	9	262	61	201
PCT9152	MV	721	279	-2	1	18	262	38	224
PCT9201	ED	1004	300	0	0	13	287	48	239
PCT9201	MV	1004	475	-1	0	19	457	63	394
PCT9202	ED	971	294	0	1	17	276	44	232
PCT9202	MV	971	426	2	2	27	395	75	320
PCT9203	ED	1002	239	0	0	14	225	60	165
PCT9203	MV	1002	536	3	0	37	496	119	377
PCT9204	ED	873	273	5	0	10	258	68	190
PCT9204	MV	873	393	4	0	17	372	91	281
PCT9205	ED	728	208	0	0	13	195	48	147
PCT9205	MV	728	376	7	1	25	343	49	294
PCT9206	ED	931	249	-1	0	18	232	67	165
PCT9206	MV	931	479	3	0	20	456	118	338
PCT9207	ED	981	262	0	2	15	245	60	185
PCT9207	MV	981	502	3	0	34	465	100	365
PCT9208	ED	1002	287	0	1	16	270	56	214
PCT9208	MV	1002	491	3	2	31	455	94	361
PCT9209	ED	711	245	0	0	11	234	58	176
PCT9209	MV	711	327	4	1	19	303	50	253
PCT9211	ED	889	234	0	0	18	216	45	171
PCT9211	MV	889	432	1	0	28	403	88	315
PCT9212	ED	803	234	0	0	14	220	40	180
PCT9212	MV	803	400	4	1	22	373	79	294
PCT9213	ED	951	264	0	0	16	248	53	195
PCT9213	MV	951	508	3	0	28	477	90	387
PCT9214	ED	640	166	0	0	5	161	44	117
PCT9214	MV	640	334	0	1	21	312	60	252
PCT9215	ED	652	194	0	0	12	182	49	133
PCT9215	MV	652	327	1	0	21	305	66	239
PCT9216	ED	845	246	-1	0	13	234	45	189
PCT9216	MV	845	379	2	0	19	358	73	285
PCT9217	ED	698	194	0	0	9	185	39	146
PCT9217	MV	698	349	4	0	22	323	83	240
PCT9218	ED	841	249	1	0	18	230	47	183
PCT9218	MV	841	412	2	0	27	383	88	295
PCT9219	ED	802	242	-1	0	17	226	45	181
PCT9219	MV	802	399	2	0	25	372	60	312
PCT9221	ED	651	145	-1	1	6	139	27	112
PCT9221	MV	651	399	3	0	26	370	77	293
PCT9222	ED	883	249	-2	0	20	231	53	178
PCT9222	MV	883	449	5	0	24	420	65	355
PCT9223	ED	638	160	0	0	14	146	34	112
PCT9223	MV	638	338	6	0	12	320	69	251
PCT9224	ED	960	263	1	0	19	243	56	187
PCT9224	MV	960	506	7	0	25	474	89	385
PCT9225	ED	958	299	0	0	22	277	66	211
PCT9225	MV	958	469	4	0	26	439	82	357
PCT9226	ED	926	271	2	0	22	247	54	193
PCT9226	MV	926	486	1	0	27	458	90	368
PCT9227	ED	738	188	0	0	6	182	46	136
PCT9227	MV	738	404	4	0	12	388	81	307
PCT9228	ED	747	189	-1	0	9	181	34	147
PCT9228	MV	747	424	2	1	12	409	101	308
PCT9229	ED	598	162	0	0	14	148	28	120
PCT9229	MV	598	316	0	0	8	308	59	249
PCT9231	ED	953	313	1	0	18	294	40	254
PCT9231	MV	953	488	-3	0	25	466	55	411
PCT9232	ED	735	212	0	1	17	194	36	158
PCT9232	MV	735	396	3	1	18	374	67	307
PCT9233	ED	793	209	0	1	11	197	35	162
PCT9233	MV	793	434	3	1	18	412	85	327
PCT9234	ED	746	187	0	0	10	177	32	145
PCT9234	MV	746	438	3	0	25	410	82	328
PCT9235	ED	884	239	0	0	15	224	40	184
PCT9235	MV	884	488	2	2	23	461	93	368
PCT9236	ED	683	201	0	0	12	189	37	152
PCT9236	MV	683	358	5	0	17	336	53	283
PCT9237	ED	936	229	5	1	11	212	40	172
PCT9237	MV	936	539	0	0	24	515	82	433
PCT9238	ED	842	230	3	0	17	210	51	159
PCT9238	MV	842	456	2	3	20	431	78	353
PCT9239	ED	881	200	-1	2	9	190	31	159
PCT9239	MV	881	499	3	3	28	465	76	389
PCT9241	ED	1005	255	-2	0	16	241	39	202
PCT9241	MV	1005	578	1	2	22	553	91	462
PCT9242	ED	972	277	0	0	14	263	46	217
PCT9242	MV	972	513	3	1	16	493	79	414
PCT9243	ED	594	193	0	0	10	183	40	143
PCT9243	MV	594	307	-2	0	15	294	42	252
PCT9244	ED	903	255	-1	0	11	245	36	209
PCT9244	MV	903	485	2	0	24	459	53	406
PCT9245	ED	742	209	1	0	9	199	28	171
PCT9245	MV	742	375	5	0	27	343	45	298
PCT9246	ED	929	257	1	0	12	244	34	210
PCT9246	MV	929	528	4	1	28	495	79	416
PCT9247	ED	927	264	0	0	14	250	41	209
PCT9247	MV	927	515	3	0	28	484	87	397
PCT9248	ED	907	258	0	0	7	251	45	206
PCT9248	MV	907	487	1	1	22	463	78	385
PCT9249	ED	917	271	0	0	19	252	33	219
PCT9249	MV	917	495	5	1	18	471	71	400
PCT9251	ED	995	287	0	1	14	272	46	226
PCT9251	MV	995	530	6	1	29	494	77	417
PCT9252	ED	944	219	0	0	8	211	43	168
PCT9252	MV	944	550	3	0	20	527	94	433
PCT9253	ED	772	187	0	0	9	178	41	137
PCT9253	MV	772	397	-1	1	20	377	77	300
PCT9254	ED	935	230	0	1	11	218	39	179
PCT9254	MV	935	538	1	0	28	509	62	447
PCT9255	ED	553	183	0	0	10	173	32	141
PCT9255	MV	553	263	2	0	13	248	32	216
PCT9256	ED	474	130	0	0	4	126	23	103
PCT9256	MV	474	233	0	0	6	227	35	192
PCT9257	MV	321	235	0	0	10	225	23	202
PCT9258	ED	712	193	0	0	6	187	33	154
PCT9258	MV	712	373	-2	1	14	360	63	297
PCT9401	ED	1012	293	-1	0	18	276	45	231
PCT9401	MV	1012	484	0	2	22	460	73	387
PCT9402	ED	977	290	-1	0	20	271	50	221
PCT9402	MV	977	458	-1	0	30	429	92	337
PCT9403	ED	897	240	0	0	12	228	48	180
PCT9403	MV	897	419	1	0	14	404	81	323
PCT9404	ED	930	200	0	0	15	185	33	152
PCT9404	MV	930	462	0	0	34	428	89	339
PCT9405	ED	786	210	6	0	13	191	49	142
PCT9405	MV	786	364	-1	0	27	338	71	267
PCT9406	ED	868	244	-1	1	12	232	55	177
PCT9406	MV	868	421	2	0	12	407	92	315
PCT9407	ED	889	253	0	1	5	247	48	199
PCT9407	MV	889	409	1	0	20	388	78	310
PCT9408	ED	886	265	0	0	13	252	40	212
PCT9408	MV	886	415	3	0	22	390	45	345
PCT9409	ED	590	201	-3	0	8	196	14	182
PCT9409	MV	590	252	2	2	18	230	40	190
PCT9411	ED	956	271	2	0	13	256	30	226
PCT9411	MV	956	431	7	0	12	412	54	358
PCT9412	ED	848	245	-1	0	16	230	48	182
PCT9412	MV	848	380	2	0	20	358	84	274
PCT9413	ED	894	229	-1	0	15	215	40	175
PCT9413	MV	894	461	2	1	27	431	93	338
PCT9414	ED	916	216	-1	1	12	204	36	168
PCT9414	MV	916	463	4	1	24	434	107	327
PCT9415	ED	784	187	1	1	9	176	40	136
PCT9415	MV	784	392	4	0	14	374	87	287
PCT9416	ED	1008	282	0	0	19	263	54	209
PCT9416	MV	1008	480	2	1	41	436	76	360
PCT9417	ED	752	175	0	0	6	169	36	133
PCT9417	MV	752	402	4	0	22	376	94	282
PCT9418	ED	790	211	0	0	10	201	56	145
PCT9418	MV	790	376	4	0	22	350	76	274
PCT9419	ED	924	222	1	0	14	207	56	151
PCT9419	MV	924	468	-1	1	37	431	124	307
PCT9421	ED	906	238	0	0	18	220	61	159
PCT9421	MV	906	446	3	1	24	418	107	311
PCT9422	ED	1056	283	0	0	14	269	58	211
PCT9422	MV	1056	513	4	1	21	487	126	361
PCT9423	ED	889	219	0	1	16	202	37	165
PCT9423	MV	889	440	-1	1	26	414	83	331
PCT9424	ED	952	224	0	0	5	219	57	162
PCT9424	MV	952	496	2	0	23	471	110	361
PCT9425	ED	933	199	0	0	18	181	46	135
PCT9425	MV	933	465	-1	0	35	431	108	323
PCT9426	ED	823	198	0	0	10	188	43	145
PCT9426	MV	823	408	5	0	32	371	117	254
PCT9427	ED	948	210	0	0	11	199	50	149
PCT9427	MV	948	447	-3	0	28	422	126	296
PCT9428	ED	961	183	0	0	17	166	37	129
PCT9428	MV	961	518	4	1	28	485	106	379
PCT9429	ED	899	228	1	0	19	208	60	148
PCT9429	MV	899	432	2	1	26	403	106	297
PCT9431	ED	973	235	3	0	14	218	48	170
PCT9431	MV	973	464	1	1	35	427	116	311
PCT9432	ED	945	214	-1	0	15	200	39	161
PCT9432	MV	945	468	2	0	35	431	87	344
PCT9433	ED	945	195	0	0	15	180	56	124
PCT9433	MV	945	487	3	0	37	447	128	319
PCT9434	ED	979	261	0	0	17	244	55	189
PCT9434	MV	979	481	2	0	28	451	86	365
PCT9435	ED	969	251	0	0	14	237	51	186
PCT9435	MV	969	448	1	0	31	416	114	302
PCT9436	ED	1006	232	0	0	17	215	44	171
PCT9436	MV	1006	495	-2	0	39	458	119	339
PCT9437	ED	897	219	-2	0	19	202	42	160
PCT9437	MV	897	435	3	0	22	410	114	296
PCT9438	ED	948	202	2	0	10	190	36	154
PCT9438	MV	948	496	1	0	22	473	133	340
PCT9439	ED	879	173	0	0	10	163	32	131
PCT9439	MV	879	425	0	2	23	400	105	295
PCT9441	ED	980	261	-2	0	18	245	51	194
PCT9441	MV	980	462	0	0	23	439	116	323
PCT9442	ED	1008	280	1	0	10	269	58	211
PCT9442	MV	1008	461	3	0	37	421	122	299
PCT9443	ED	937	220	-1	1	15	205	51	154
PCT9443	MV	937	442	-1	2	20	421	93	328
PCT9444	ED	937	190	1	0	13	176	49	127
PCT9444	MV	937	442	0	0	24	418	115	303
PCT9445	ED	981	230	0	0	10	220	59	161
PCT9445	MV	981	493	0	0	18	475	117	358
PCT9446	ED	1090	240	0	1	11	228	42	186
PCT9446	MV	1090	564	3	0	29	532	163	369
PCT9447	ED	906	236	0	0	12	224	53	171
PCT9447	MV	906	448	-1	0	23	426	95	331
PCT9448	ED	909	232	1	0	12	219	49	170
PCT9448	MV	909	429	-1	0	31	399	88	311
PCT9449	ED	830	177	4	0	11	162	35	127
PCT9449	MV	830	428	5	1	16	406	111	295
PCT9451	ED	420	97	0	0	6	91	31	60
PCT9451	MV	420	218	-1	1	13	205	64	141
PCT9452	ED	840	259	0	0	12	247	62	185
PCT9452	MV	840	412	0	1	17	394	100	294
PCT9453	ED	500	135	0	0	12	123	33	90
PCT9453	MV	500	244	3	0	16	225	56	169
PCT9501	MV	148	110	1	1	5	103	16	87
PCT9502	MV	245	177	2	1	4	170	18	152
PCT9503	ED	729	198	0	0	12	186	24	162
PCT9503	MV	729	315	3	1	13	298	34	264
PCT9505	ED	784	177	0	0	9	168	27	141
PCT9505	MV	784	383	2	1	18	362	63	299
PCT9506	ED	766	177	0	0	4	173	28	145
PCT9506	MV	766	313	0	0	17	296	34	262
PCT9507	ED	766	231	0	0	7	224	25	199
PCT9507	MV	766	406	0	0	20	386	37	349
PCT9508	ED	798	237	0	0	13	224	21	203
PCT9508	MV	798	429	3	0	14	412	22	390
PCT9509	ED	759	230	0	1	6	223	21	202
PCT9509	MV	759	386	-1	1	15	371	32	339
PCT9511	ED	622	190	0	0	12	178	21	157
PCT9511	MV	622	296	0	1	11	284	29	255
PCT9512	ED	809	240	1	1	10	228	24	204
PCT9512	MV	809	399	0	0	16	383	35	348
PCT9513	ED	902	275	0	1	14	260	31	229
PCT9513	MV	902	390	2	0	16	372	45	327
PCT9514	ED	928	304	0	0	15	289	37	252
PCT9514	MV	928	456	4	0	16	436	41	395
PCT9515	ED	705	222	0	0	14	208	22	186
PCT9515	MV	705	368	1	1	15	351	49	302
PCT9516	ED	866	254	-1	0	12	243	49	194
PCT9516	MV	866	427	3	0	17	407	71	336
PCT9517	ED	801	228	0	0	15	213	22	191
PCT9517	MV	801	397	1	0	12	384	40	344
PCT9518	ED	802	229	0	0	6	223	18	205
PCT9518	MV	802	431	4	0	8	419	46	373
PCT9519	ED	910	262	1	0	9	252	23	229
PCT9519	MV	910	486	0	0	16	470	46	424
PCT9521	ED	939	316	-2	0	13	305	38	267
PCT9521	MV	939	442	-1	1	23	419	29	390
PCT9701	ED	671	201	-1	0	10	192	24	168
PCT9701	MV	671	340	2	0	20	318	55	263
PCT9702	ED	723	210	0	0	4	206	18	188
PCT9702	MV	723	364	1	0	12	351	51	300
PCT9703	ED	986	232	0	0	15	217	52	165
PCT9703	MV	986	530	2	0	39	489	85	404
PCT9704	ED	950	279	0	0	16	263	38	225
PCT9704	MV	950	505	1	1	32	471	82	389
PCT9705	ED	919	261	3	0	6	252	29	223
PCT9705	MV	919	483	2	0	25	456	66	390
PCT9706	MV	49	39	-1	0	1	39	2	37
PCT9707	ED	821	173	0	0	11	162	48	114
PCT9707	MV	821	491	3	0	36	452	99	353
PCT9708	ED	948	250	1	0	6	243	33	210
PCT9708	MV	948	500	0	0	29	471	60	411
PCT9709	ED	1028	281	6	0	14	261	63	198
PCT9709	MV	1028	517	4	1	26	486	104	382
PCT9711	ED	641	195	0	0	10	185	44	141
PCT9711	MV	641	336	2	0	13	321	63	258
PCT9712	ED	649	160	0	0	3	157	36	121
PCT9712	MV	649	398	7	0	11	380	69	311
PCT9713	ED	960	225	1	0	21	203	63	140
PCT9713	MV	960	489	-2	1	21	469	97	372
PCT9714	ED	931	208	1	1	11	195	50	145
PCT9714	MV	931	538	6	0	23	509	118	391
PCT9715	ED	569	180	0	0	13	167	28	139
PCT9715	MV	569	309	2	0	15	292	56	236
PCT9716	ED	947	239	-1	0	9	231	40	191
PCT9716	MV	947	481	0	0	37	444	90	354
PCT9717	ED	972	265	-1	1	13	252	52	200
PCT9717	MV	972	532	1	0	28	503	100	403
PCT9718	ED	862	227	0	0	13	214	51	163
PCT9718	MV	862	496	0	1	22	473	100	373
PCT9719	ED	901	245	0	0	13	232	40	192
PCT9719	MV	901	524	7	0	22	495	94	401
PCT9721	ED	662	198	0	0	12	186	50	136
PCT9721	MV	662	357	3	1	23	330	78	252
PCT9722	ED	605	119	1	0	4	114	29	85
PCT9722	MV	605	355	0	0	22	333	79	254
PCT9723	ED	481	98	0	0	3	95	32	63
PCT9723	MV	481	275	0	0	24	251	83	168
PCT9724	ED	991	205	0	1	13	191	71	120
PCT9724	MV	991	565	1	0	39	525	177	348
PCT9725	ED	970	214	1	0	15	198	60	138
PCT9725	MV	970	499	0	0	30	469	133	336
PCT9726	ED	655	263	2	0	9	252	65	187
PCT9726	MV	655	241	-1	0	24	218	43	175
PCT9727	ED	459	79	0	0	3	76	21	55
PCT9727	MV	459	271	1	0	12	258	80	178
PCT9728	ED	926	231	-1	0	8	224	61	163
PCT9728	MV	926	503	4	0	23	476	119	357
PCT9729	ED	800	191	0	1	11	179	57	122
PCT9729	MV	800	442	4	0	23	415	101	314
PCT9731	ED	556	167	0	0	7	160	40	120
PCT9731	MV	556	282	-1	1	11	271	72	199
PCT9732	MV	70	56	0	0	5	51	11	40
PCT9733	MV	235	191	0	0	4	187	18	169
PCT9734	ED	603	154	0	1	2	151	39	112
PCT9734	MV	603	341	0	1	15	325	75	250
PCT9735	ED	809	206	0	0	8	198	51	147
PCT9735	MV	809	449	0	1	31	417	87	330
PCT9736	ED	713	173	0	0	7	166	35	131
PCT9736	MV	713	410	1	0	23	386	74	312
PCT9737	ED	818	208	0	0	14	194	34	160
PCT9737	MV	818	476	2	1	19	454	85	369
PCT9738	ED	848	185	0	0	8	177	41	136
PCT9738	MV	848	404	-1	0	29	376	84	292
PCT9739	ED	828	220	1	2	15	202	49	153
PCT9739	MV	828	335	0	0	15	320	71	249
PCT9741	ED	552	232	-1	0	6	227	54	173
PCT9741	MV	552	105	0	0	6	99	19	80
PCT9742	ED	677	180	4	0	12	164	62	102
PCT9742	MV	677	289	1	0	15	273	66	207
PCT9743	ED	1163	310	0	1	11	298	59	239
PCT9743	MV	1163	501	4	0	28	469	79	390
PCT9744	ED	911	247	2	1	17	227	55	172
PCT9744	MV	911	391	2	0	16	373	76	297
PCT9745	ED	991	282	-2	0	19	265	68	197
PCT9745	MV	991	346	1	0	10	335	65	270
PCT9746	ED	884	232	1	0	14	217	68	149
PCT9746	MV	884	452	2	1	23	426	89	337
PCT9747	ED	973	246	1	1	12	232	44	188
PCT9747	MV	973	470	2	1	23	444	95	349
PCT9748	ED	931	229	1	0	4	224	53	171
PCT9748	MV	931	475	1	2	27	445	100	345
PCT9749	ED	913	225	2	1	14	208	46	162
PCT9749	MV	913	384	-1	0	43	342	85	257
PCT9751	ED	1016	253	0	0	20	233	41	192
PCT9751	MV	1016	523	0	0	32	491	110	381
PCT9752	ED	710	175	3	0	2	170	43	127
PCT9752	MV	710	392	0	0	15	377	80	297
PCT9753	ED	756	186	0	1	6	179	35	144
PCT9753	MV	756	388	0	0	22	366	73	293
PCT9754	ED	707	47	2	0	2	43	10	33
PCT9754	MV	707	377	1	0	13	363	63	300
PCT9755	ED	582	172	-1	0	6	167	33	134
PCT9755	MV	582	285	2	1	13	269	51	218
PCT9756	ED	941	185	0	0	11	174	32	142
PCT9756	MV	941	477	-2	1	35	443	119	324
PCT9801	ED	408	104	0	1	6	97	24	73
PCT9801	MV	408	181	0	0	6	175	38	137
CONG12	TO	443570	332491	863	296	17606	313726	50993	262733
CONG14	TO	56946	40357	79	36	2306	37936	9009	28927
ASSM17	TO	291063	214827	537	188	11311	202791	29674	173117
ASSM19	TO	209453	158021	405	144	8601	148871	30328	118543
BART7	TO	38460	24736	71	32	1477	23156	4388	18768
BART8	TO	223735	166386	444	148	9671	156123	32831	123292
BART9	TO	238321	181726	427	152	8764	172383	22783	149600
SUPV1	TO	42767	32743	69	25	1781	30868	5765	25103
SUPV2	TO	50394	40402	156	44	2118	38084	6994	31090
SUPV3	TO	39799	28571	83	26	2038	26424	4735	21689
SUPV4	TO	42953	31699	79	28	1831	29761	6890	22871
SUPV5	TO	53744	42036	98	41	2001	39896	4453	35443
SUPV6	TO	43321	29158	111	30	1938	27079	4641	22438
SUPV7	TO	47076	36587	99	32	1873	34583	7267	27316
SUPV8	TO	58122	48632	131	32	1816	46653	4676	41977
SUPV9	TO	42988	31769	51	30	1513	30175	4083	26092
SUPV10	TO	41862	26459	50	27	1460	24922	4862	20060
SUPV11	TO	37490	24792	15	17	1543	23217	5636	17581
NEIG1	TO	19914	11270	10	19	762	10479	2458	8021
NEIG2	TO	17446	12440	37	14	965	11424	2125	9299
NEIG3	TO	28644	19045	55	12	1435	17543	3201	14342
NEIG4	TO	7002	5802	19	4	218	5561	769	4792
NEIG5	TO	27634	18420	15	17	1126	17262	4251	13011
NEIG6	TO	14982	12240	22	10	491	11717	983	10734
NEIG7	TO	12118	7928	-1	3	532	7394	1729	5665
NEIG8	TO	9734	7857	13	5	336	7503	869	6634
NEIG9	TO	8390	5918	9	5	337	5567	1384	4183
NEIG10	TO	10097	8010	18	13	377	7602	1183	6419
NEIG11	TO	40622	32395	146	32	1783	30434	5583	24851
NEIG12	TO	31129	23295	37	23	1007	22228	2356	19872
NEIG13	TO	16964	14420	20	6	567	13827	1410	12417
NEIG14	TO	8795	7263	17	5	232	7009	621	6388
NEIG15	TO	7019	5232	13	6	332	4881	830	4051
NEIG26	TO	9293	6104	11	4	403	5686	1488	4198
NEIG16	TO	16814	13081	41	8	518	12514	1521	10993
NEIG17	TO	37322	28503	61	19	1553	26870	5106	21764
NEIG18	TO	8050	6587	16	8	319	6244	1157	5087
NEIG19	TO	9419	7393	13	8	335	7037	860	6177
NEIG20	TO	24674	17045	69	20	1047	15909	2667	13242
NEIG21	TO	42363	31246	80	26	1805	29335	6836	22499
NEIG22	TO	18966	16190	56	13	578	15543	1340	14203
NEIG23	TO	8139	4488	11	2	307	4168	1200	2968
NEIG24	TO	34909	27838	89	25	1372	26352	5397	20955
NEIG25	TO	30077	22838	65	25	1175	21573	2678	18895
